"","Division","Season","Date","Covid19","Home","Away","HG","AG","HS","AS","HST","AST","HF","AF","HY","AY","HR","AR","AvgH","AvgD","AvgA","Avg.2.5","Avg.2.5.1","HP","AP","ProbH","ProbD","ProbA","HEP","AEP","goalsDiff","shotsDiff","shotsTargetDiff","pointsDiff","expPointsDiff","foulsDiff","yellowDiff","redDiff","Season_c"
"1","D1",10,"16.08.2019","Yes","Bayern Munich","Hertha",2,2,17,6,7,3,6,17,3,3,0,0,1.18,7.55,15.04,1.34,3.24,1,1,0.809881305087719,0.126577475497154,0.0635412194151269,2.55622139076031,0.317201133742534,0,11,4,0,2.23902025701778,-11,0,0,0
"2","D1",10,"17.08.2019","Yes","Dortmund","Augsburg",5,1,23,5,10,1,8,6,0,0,0,0,1.22,6.62,13.38,1.43,2.79,3,0,0.784024160969271,0.144487836311558,0.0714880027191712,2.49656031921937,0.358951844469071,4,18,9,3,2.1376084747503,2,0,0,0
"3","D1",10,"17.08.2019","Yes","Freiburg","Mainz",3,0,19,19,8,5,6,15,1,3,0,0,2.2,3.37,3.36,1.93,1.88,3,0,0.433354255009721,0.282901887543438,0.283743857446841,1.5829646525726,1.13413345988396,3,0,3,3,0.44883119268864,-9,-2,0,0
"4","D1",10,"17.08.2019","Yes","Leverkusen","Paderborn",3,2,13,11,4,6,8,9,2,0,0,0,1.28,5.97,10.27,1.38,3.03,3,0,0.746803558138883,0.160118685832122,0.0930777560289942,2.40052936024877,0.439351953919105,1,2,-2,3,1.96117740632967,-1,2,0,0
"5","D1",10,"17.08.2019","Yes","Werder Bremen","Fortuna Dusseldorf",1,3,23,12,10,7,8,13,0,2,0,0,1.74,3.93,4.57,1.67,2.21,0,3,0.548398325501296,0.242802312054009,0.208799362444695,1.8879972885579,0.869200399388093,-2,11,3,-3,1.0187968891698,-5,-2,0,0
"6","D1",10,"17.08.2019","Yes","Wolfsburg","FC Koln",2,1,14,11,5,2,14,18,1,3,0,0,1.91,3.74,3.91,1.67,2.21,3,0,0.500203523870443,0.255451532243996,0.244344943885561,1.75606210385532,0.98848636390068,1,3,3,3,0.767575739954643,-4,-2,0,0
"7","D1",10,"17.08.2019","Yes","M'gladbach","Schalke 04",0,0,16,8,4,1,8,10,3,2,0,0,2.06,3.49,3.6,1.78,2.04,1,1,0.462432000706677,0.272954132222279,0.264613867071043,1.66025013434231,1.06679573343541,0,8,3,0,0.593454400906903,-2,1,0,0
"8","D1",10,"18.08.2019","Yes","Ein Frankfurt","Hoffenheim",1,0,17,10,8,1,16,9,3,1,0,0,2.32,3.65,2.92,1.54,2.46,3,0,0.411499436302142,0.261555806087937,0.326944757609921,1.49605411499436,1.2423900789177,1,7,7,3,0.253664036076663,7,2,0,0
"9","D1",10,"18.08.2019","Yes","Union Berlin","RB Leipzig",0,4,13,14,2,8,14,5,1,0,0,0,4.63,4.02,1.72,1.71,2.13,0,3,0.206457931479281,0.237786125061958,0.555755943458762,0.8571599194998,1.90505395543824,-4,-1,-6,-3,-1.04789403593844,9,1,0,0
"10","D1",10,"23.08.2019","Yes","FC Koln","Dortmund",1,3,13,14,1,6,11,10,2,1,0,0,6.18,4.74,1.48,1.45,2.73,0,3,0.1543335357322,0.20121967316983,0.64444679109797,0.66422028036643,2.13456004646374,-2,-1,-5,-3,-1.47033976609731,1,1,0,0
"11","D1",10,"24.08.2019","Yes","Augsburg","Union Berlin",1,1,12,13,4,1,16,19,3,1,0,1,2.24,3.32,3.31,1.95,1.86,1,1,0.425272054612158,0.286930542870853,0.287797402516989,1.56274670670733,1.15032275042182,0,-1,3,0,0.412423956285506,-3,2,-1,0
"12","D1",10,"24.08.2019","Yes","Fortuna Dusseldorf","Leverkusen",1,3,11,11,6,7,14,10,3,2,0,0,4.36,4.2,1.72,1.46,2.69,0,3,0.218675836683295,0.227006344747421,0.554317818569284,0.883033854797307,1.88995980045527,-2,0,-1,-3,-1.00692594565797,4,1,0,0
"13","D1",10,"24.08.2019","Yes","Hoffenheim","Werder Bremen",3,2,10,18,3,6,13,15,2,5,0,1,1.88,3.92,3.83,1.49,2.62,3,0,0.50749739720656,0.243391608864371,0.249110993929069,1.76588380048405,0.990724590651577,1,-8,-3,3,0.775159209832475,-2,-3,-1,0
"14","D1",10,"24.08.2019","Yes","Mainz","M'gladbach",1,3,21,15,4,6,12,14,2,2,0,0,2.86,3.42,2.46,1.8,2.03,0,3,0.33346016646849,0.278858501783591,0.387681331747919,1.27923900118906,1.44190249702735,-2,6,-2,-3,-0.162663495838288,-2,0,0,0
"15","D1",10,"24.08.2019","Yes","Paderborn","Freiburg",1,3,15,9,2,4,20,6,3,1,0,0,2.38,3.6,2.84,1.61,2.31,0,3,0.400137762609975,0.264535520836595,0.33532671655343,1.46494880866652,1.27051567049688,-2,6,-2,-3,0.194433138169636,14,2,0,0
"16","D1",10,"24.08.2019","Yes","Schalke 04","Bayern Munich",0,3,9,10,2,6,11,10,0,0,0,0,8.12,4.93,1.38,1.59,2.35,0,3,0.117217947436794,0.193064854601779,0.689717197961427,0.544718696912161,2.26221644848606,-3,-1,-4,-3,-1.7174977515739,1,0,0,0
"17","D1",10,"25.08.2019","Yes","RB Leipzig","Ein Frankfurt",2,1,13,11,5,5,10,13,2,3,0,0,1.49,4.63,6.06,1.5,2.59,3,0,0.637881684812633,0.205279419086571,0.156838896100796,2.11892447352447,0.675796107388959,1,2,0,3,1.44312836613551,-3,-1,0,0
"18","D1",10,"25.08.2019","Yes","Hertha","Wolfsburg",0,3,8,9,2,4,15,11,1,0,0,0,2.42,3.46,2.87,1.75,2.09,0,3,0.39329393872184,0.275078419568455,0.331627641709705,1.45496023573398,1.26996134469757,-3,-1,-2,-3,0.184998891036406,4,1,0,0
"19","D1",10,"30.08.2019","Yes","M'gladbach","RB Leipzig",1,3,11,14,3,6,17,19,3,2,0,0,3.28,3.76,2.11,1.6,2.35,0,3,0.29181379472693,0.254560969868173,0.453625235404896,1.13000235404896,1.61543667608286,-2,-3,-3,-3,-0.485434322033898,-2,1,0,0
"20","D1",10,"31.08.2019","Yes","Bayern Munich","Mainz",6,1,19,7,10,4,16,12,3,3,0,0,1.09,11.05,28.84,1.24,3.93,3,0,0.879942986855886,0.0867998059432503,0.0332572072008639,2.72662876651091,0.186571427545842,5,12,6,3,2.54005733896507,4,0,0,0
"21","D1",10,"31.08.2019","Yes","Freiburg","FC Koln",1,2,14,9,1,3,6,15,0,2,0,0,2.45,3.45,2.87,1.73,2.11,0,3,0.390045498414449,0.276988832207362,0.332965669378188,1.44712532745071,1.27588584034193,-1,5,-2,-3,0.171239487108783,-9,-2,0,0
"22","D1",10,"31.08.2019","Yes","Leverkusen","Hoffenheim",0,0,20,6,2,1,7,11,2,2,0,0,1.55,4.88,5.08,1.35,3.17,1,1,0.616241262391743,0.195732368177705,0.188026369430552,2.04445615535293,0.75981147646936,0,14,1,0,1.28464467888357,-4,0,0,0
"23","D1",10,"31.08.2019","Yes","Schalke 04","Hertha",3,0,9,9,2,3,13,9,1,1,0,0,2.12,3.45,3.51,1.83,1.98,3,0,0.450758802443355,0.276988017733308,0.272253179823337,1.62926442506337,1.09374755720332,3,0,-1,3,0.535516867860054,4,0,0,0
"24","D1",10,"31.08.2019","Yes","Wolfsburg","Paderborn",1,1,15,7,5,3,8,12,0,3,0,0,1.46,4.85,6.46,1.39,2.96,1,1,0.654862928374955,0.197133994933492,0.148003076691553,2.16172278005836,0.641143225008152,0,8,2,0,1.52057955505021,-4,-3,0,0
"25","D1",10,"31.08.2019","Yes","Union Berlin","Dortmund",3,1,15,13,7,2,13,2,0,0,0,0,8.99,5.56,1.32,1.46,2.7,3,0,0.106072518730922,0.171509342336509,0.722418138932569,0.489726898529276,2.33876375913422,2,2,5,3,-1.84903686060494,11,0,0,0
"26","D1",10,"01.09.2019","Yes","Werder Bremen","Augsburg",3,2,15,12,5,6,9,11,1,4,0,1,1.7,4.03,4.77,1.59,2.36,3,0,0.562356837150522,0.237222487135456,0.200420675714022,1.92429299858702,0.838484514277523,1,3,-1,3,1.0858084843095,-2,-3,-1,0
"27","D1",10,"01.09.2019","Yes","Ein Frankfurt","Fortuna Dusseldorf",2,1,15,14,8,4,13,15,2,4,0,0,1.69,4.08,4.77,1.55,2.43,3,0,0.565446669049134,0.234216880071823,0.200336450879043,1.93055688721922,0.835226232708953,1,1,4,3,1.09533065451027,-2,-2,0,0
"28","D1",10,"13.09.2019","Yes","Fortuna Dusseldorf","Wolfsburg",1,1,12,15,3,6,7,14,0,2,0,0,3.03,3.62,2.28,1.65,2.24,1,1,0.315859566944502,0.264379692773989,0.419760740281509,1.21195839360749,1.52366191361852,0,-3,-3,0,-0.311703520011022,-7,-2,0,0
"29","D1",10,"14.09.2019","Yes","Augsburg","Ein Frankfurt",2,1,9,23,6,3,8,8,2,1,0,0,3.48,3.69,2.05,1.61,2.32,3,0,0.27467619472979,0.259044216167932,0.466279589102278,1.0830728003573,1.65788298347477,1,-14,3,3,-0.574810183117463,0,1,0,0
"30","D1",10,"14.09.2019","Yes","Dortmund","Leverkusen",4,0,11,22,9,12,9,11,0,3,0,0,1.82,4.01,4.04,1.43,2.81,3,0,0.525110691897288,0.238329540960864,0.236559767141848,1.81366161665273,0.948008842386407,4,-11,-3,3,0.865652774266322,-2,-3,0,0
"31","D1",10,"14.09.2019","Yes","FC Koln","M'gladbach",0,1,14,15,7,4,22,17,2,2,0,0,2.57,3.53,2.66,1.65,2.24,0,3,0.371166214063507,0.270225827236037,0.358607958700456,1.38372446942656,1.3460497033374,-1,-1,3,-3,0.037674766089153,5,0,0,0
"32","D1",10,"14.09.2019","Yes","Mainz","Hertha",2,1,14,16,5,8,16,11,2,2,0,0,2.38,3.44,2.98,1.78,2.05,3,0,0.401522866498504,0.277797797170476,0.32067933633102,1.48236639666599,1.23983580616354,1,-2,-3,3,0.242530590502452,5,0,0,0
"33","D1",10,"14.09.2019","Yes","Union Berlin","Werder Bremen",1,2,12,16,5,7,23,10,3,4,1,1,2.79,3.5,2.48,1.67,2.21,0,3,0.342214617452945,0.272793937912491,0.384991444634564,1.29943779027133,1.42776827181618,-1,-4,-2,-3,-0.128330481544855,13,-1,0,0
"34","D1",10,"14.09.2019","Yes","RB Leipzig","Bayern Munich",1,1,12,14,6,7,11,4,4,2,0,0,3.78,4.04,1.87,1.47,2.68,1,1,0.252714537073585,0.236450730232216,0.510834732694199,0.994594341452971,1.76895492831481,0,-2,-1,0,-0.774360586861841,7,2,0,0
"35","D1",10,"15.09.2019","Yes","Hoffenheim","Freiburg",0,3,22,16,5,8,10,6,0,2,0,0,1.69,4.2,4.6,1.55,2.45,0,3,0.565044454843238,0.227363125877398,0.207592419279364,1.92249649040711,0.850140383715489,-3,6,-3,-3,1.07235610669162,4,-2,0,0
"36","D1",10,"15.09.2019","Yes","Paderborn","Schalke 04",1,5,9,18,1,11,17,12,2,1,0,0,3.04,3.64,2.26,1.54,2.45,0,3,0.314435984466257,0.262605877136654,0.422958138397089,1.20591383053543,1.53148029232792,-4,-9,-10,-3,-0.325566461792496,5,1,0,0
"37","D1",10,"20.09.2019","Yes","Schalke 04","Mainz",2,1,19,14,6,3,7,15,1,1,0,0,1.66,4.07,5.11,1.67,2.22,3,0,0.577128744467415,0.235389119365088,0.187482136167497,1.96677535276733,0.797835527867579,1,5,3,3,1.16893982489975,-8,0,0,0
"38","D1",10,"21.09.2019","Yes","Bayern Munich","FC Koln",4,0,24,16,5,2,15,20,4,0,0,1,1.12,9.25,21.04,1.25,3.83,3,0,0.851561706938858,0.103108012083408,0.0453302809777339,2.65779313289998,0.239098855016609,4,8,3,3,2.41869427788337,-5,4,-1,0
"39","D1",10,"21.09.2019","Yes","Freiburg","Augsburg",1,1,17,12,5,2,13,13,1,1,0,0,1.9,3.77,3.92,1.67,2.21,1,1,0.502847965593037,0.253424704145032,0.243727330261931,1.76196860092414,0.984606694930826,0,5,3,0,0.777361905993317,0,0,0,0
"40","D1",10,"21.09.2019","Yes","Hertha","Paderborn",2,1,6,17,4,8,13,15,4,4,0,0,1.73,4.02,4.54,1.48,2.64,3,0,0.552057496158453,0.237576982177643,0.210365521663904,1.893749470653,0.868673547169355,1,-11,-4,3,1.02507592348365,-2,0,0,0
"41","D1",10,"21.09.2019","Yes","Leverkusen","Union Berlin",2,0,20,4,7,0,10,10,0,1,0,1,1.36,5.31,7.82,1.44,2.74,3,0,0.699284282851417,0.17910105926138,0.121614657887203,2.27695390781563,0.543945032922989,2,16,7,3,1.73300887489264,0,-1,-1,0
"42","D1",10,"21.09.2019","Yes","Werder Bremen","RB Leipzig",0,3,11,14,1,7,11,13,0,3,0,1,4.19,4.25,1.75,1.46,2.69,0,3,0.228301741999847,0.225078658583378,0.546619599416775,0.909983884582918,1.8649374568337,-3,-3,-6,-3,-0.954953572250786,-2,-3,-1,0
"43","D1",10,"22.09.2019","Yes","M'gladbach","Fortuna Dusseldorf",2,1,23,18,11,4,14,11,2,3,0,0,1.69,4.09,4.77,1.54,2.46,3,0,0.565770661810125,0.233778097422766,0.200451240767109,1.93109008285314,0.835131819724094,1,5,7,3,1.09595826312905,3,-1,0,0
"44","D1",10,"22.09.2019","Yes","Ein Frankfurt","Dortmund",2,2,17,15,3,7,18,10,2,2,0,0,4.29,4.22,1.74,1.46,2.7,1,1,0.223109458178371,0.22681032596806,0.55008021585357,0.896138700503172,1.87705097352877,0,2,-4,0,-0.980912273025596,8,0,0,0
"45","D1",10,"23.09.2019","Yes","Wolfsburg","Hoffenheim",1,1,12,11,4,5,11,18,2,4,0,0,1.95,3.81,3.7,1.53,2.48,1,1,0.490475444914149,0.251030739522989,0.258493815562862,1.72245707426544,1.02651218621158,0,1,-1,0,0.69594488805386,-7,-2,0,0
"46","D1",10,"27.09.2019","Yes","Union Berlin","Ein Frankfurt",1,2,12,14,5,6,11,12,1,1,0,0,2.99,3.64,2.3,1.58,2.39,0,3,0.320366132723112,0.263157894736842,0.416475972540046,1.22425629290618,1.51258581235698,-1,-2,-1,-3,-0.288329519450801,-1,0,0,0
"47","D1",10,"28.09.2019","Yes","Augsburg","Leverkusen",0,3,8,11,1,5,16,9,4,0,0,0,4.71,4.52,1.63,1.39,2.99,0,3,0.202773702940213,0.211297376293895,0.585928920765892,0.819618485114534,1.96908413859157,-3,-3,-4,-3,-1.14946565347704,7,4,0,0
"48","D1",10,"28.09.2019","Yes","Hoffenheim","M'gladbach",0,3,17,11,4,5,10,11,2,2,0,0,2.43,3.61,2.79,1.58,2.38,0,3,0.393066629201644,0.264585016332408,0.342348354465948,1.44378490393734,1.29163007973025,-3,6,-1,-3,0.152154824207088,-1,0,0,0
"49","D1",10,"28.09.2019","Yes","Mainz","Wolfsburg",0,1,15,4,5,3,9,15,2,3,0,0,2.89,3.52,2.4,1.73,2.1,0,3,0.330557816315032,0.271395479872284,0.398046703812684,1.26306892881738,1.46553559131034,-1,11,2,-3,-0.202466662492957,-6,-1,0,0
"50","D1",10,"28.09.2019","Yes","Paderborn","Bayern Munich",2,3,10,18,5,6,7,6,1,1,0,0,15.89,9.07,1.14,1.19,4.65,0,3,0.0599142294411702,0.104965502295501,0.835120268263329,0.284708190619012,2.61032630708549,-1,-8,-1,-3,-2.32561811646648,1,0,0,0
"51","D1",10,"28.09.2019","Yes","RB Leipzig","Schalke 04",1,3,17,13,6,8,13,11,1,1,0,0,1.56,4.41,5.57,1.5,2.56,0,3,0.612065034572977,0.216512801345543,0.17142216408148,2.05270790506447,0.730779293589983,-2,4,-2,-3,1.32192861147449,2,0,0,0
"52","D1",10,"28.09.2019","Yes","Dortmund","Werder Bremen",2,2,19,11,7,5,8,10,1,0,0,0,1.27,6.3,10.09,1.32,3.36,1,1,0.753321490407349,0.151860046478942,0.0948184631137099,2.41182451770099,0.436315435820071,0,8,2,0,1.97550908188092,-2,1,0,0
"53","D1",10,"29.09.2019","Yes","Fortuna Dusseldorf","Freiburg",1,2,17,9,7,3,9,9,2,2,0,0,2.44,3.58,2.78,1.64,2.26,0,3,0.390737628971214,0.266312797399375,0.342949573629411,1.43852568431302,1.29516151828761,-1,8,4,-3,0.143364166025409,0,0,0,0
"54","D1",10,"29.09.2019","Yes","FC Koln","Hertha",0,4,8,10,3,6,11,13,1,0,1,0,2.15,3.66,3.23,1.61,2.32,0,3,0.443839566289848,0.26072542828502,0.295435005425131,1.59224412715457,1.14703044456041,-4,-2,-3,-3,0.445213682594151,-2,1,1,0
"55","D1",10,"04.10.2019","Yes","Hertha","Fortuna Dusseldorf",3,1,16,9,3,3,17,18,3,3,0,0,1.68,4.09,4.88,1.6,2.35,3,0,0.569793998081579,0.234047412414927,0.196158589503494,1.94342940665966,0.82252318092541,2,7,0,3,1.12090622573425,-1,0,0,0
"56","D1",10,"05.10.2019","Yes","Bayern Munich","Hoffenheim",1,2,20,8,4,5,8,12,2,0,0,0,1.11,10.03,23.32,1.21,4.31,0,3,0.863359074199915,0.0955462185804492,0.0410947072196358,2.68562344118019,0.218830340239356,-1,12,-1,-3,2.46679310094084,-4,2,0,0
"57","D1",10,"05.10.2019","Yes","Freiburg","Dortmund",2,2,6,8,1,4,10,8,0,3,0,0,5.3,4.32,1.59,1.45,2.72,1,1,0.17985012489592,0.220649458784346,0.599500416319733,0.760199833472107,2.01915070774355,0,-2,-3,0,-1.25895087427144,2,-3,0,0
"58","D1",10,"05.10.2019","Yes","Leverkusen","RB Leipzig",1,1,11,11,8,5,11,12,2,2,0,0,2.33,3.73,2.86,1.51,2.56,1,1,0.409945239696417,0.256078393697762,0.333976366605822,1.48591411278701,1.25800749351523,0,0,3,0,0.227906619271784,-1,0,0,0
"59","D1",10,"05.10.2019","Yes","Paderborn","Mainz",1,2,16,18,7,7,8,18,1,4,0,0,2.49,3.75,2.64,1.44,2.76,0,3,0.383555911991353,0.254681125562258,0.361762962446389,1.40534886153632,1.33997001290143,-1,-2,0,-3,0.0653788486348896,-10,-3,0,0
"60","D1",10,"05.10.2019","Yes","Schalke 04","FC Koln",1,1,15,9,3,5,15,15,4,4,0,0,1.64,4.15,5.08,1.59,2.35,1,1,0.582066970004859,0.230021645977824,0.187911384017317,1.9762225559924,0.793755798029774,0,6,-2,0,1.18246675796263,0,0,0,0
"61","D1",10,"06.10.2019","Yes","M'gladbach","Augsburg",5,1,13,13,9,3,9,9,1,2,0,0,1.53,4.53,5.75,1.5,2.59,3,0,0.623505418195658,0.210587922701845,0.165906659102497,2.08110417728882,0.708307900009335,4,0,6,3,1.37279627727948,0,-1,0,0
"62","D1",10,"06.10.2019","Yes","Wolfsburg","Union Berlin",1,0,13,14,4,3,17,15,2,2,0,0,1.67,3.89,5.22,1.71,2.15,3,0,0.571680344599445,0.24542575205169,0.182893903348865,1.96046678585003,0.794107462098284,1,-1,1,3,1.16635932375174,2,0,0,0
"63","D1",10,"06.10.2019","Yes","Ein Frankfurt","Werder Bremen",2,2,24,11,7,5,12,8,2,1,0,0,2.17,3.65,3.18,1.49,2.59,1,1,0.439191618012646,0.261108441393819,0.299699940593535,1.57868329543176,1.16020826317442,0,13,2,0,0.418475032257332,4,1,0,0
"64","D1",10,"18.10.2019","Yes","Ein Frankfurt","Leverkusen",3,0,10,19,5,10,11,12,1,1,0,0,2.85,3.79,2.32,1.52,2.52,3,0,0.335522374390891,0.252305743275472,0.412171882333637,1.25887286644814,1.48882139027638,3,-9,-5,3,-0.22994852382824,-1,0,0,0
"65","D1",10,"19.10.2019","Yes","Augsburg","Bayern Munich",2,2,9,24,7,9,10,6,3,3,0,0,16.44,8.18,1.16,1.28,3.64,1,1,0.0581997860626699,0.116968763187077,0.824831450750253,0.291568121375087,2.59146311543784,0,-15,-2,0,-2.29989499406275,4,0,0,0
"66","D1",10,"19.10.2019","Yes","Fortuna Dusseldorf","Mainz",1,0,20,7,4,1,10,17,2,4,0,1,2.57,3.55,2.65,1.66,2.22,3,0,0.371229011700176,0.268748890160409,0.360022098139416,1.38243592526094,1.34881518457866,1,13,3,3,0.0336207406822799,-7,-2,-1,0
"67","D1",10,"19.10.2019","Yes","RB Leipzig","Wolfsburg",1,1,13,14,5,6,10,9,1,3,0,0,1.54,4.35,5.9,1.61,2.32,1,1,0.619179734620024,0.219203860072376,0.161616405307599,2.07674306393245,0.704053075995175,0,-1,-1,0,1.37268998793727,1,-2,0,0
"68","D1",10,"19.10.2019","Yes","Union Berlin","Freiburg",2,0,18,12,5,4,21,13,3,0,0,0,2.58,3.45,2.69,1.85,1.97,3,0,0.369421655381602,0.276263150981024,0.354315193637373,1.38452811712583,1.33920873189314,2,6,1,3,0.0453193852326872,8,3,0,0
"69","D1",10,"19.10.2019","Yes","Werder Bremen","Hertha",1,1,15,11,5,2,8,11,1,1,0,0,2.14,3.68,3.25,1.52,2.51,1,1,0.446431904203776,0.259609857335891,0.293958238460333,1.59890556994722,1.14148457271689,0,4,3,0,0.45742099723033,-3,0,0,0
"70","D1",10,"19.10.2019","Yes","Dortmund","M'gladbach",1,0,20,13,7,3,13,15,1,2,0,0,1.47,4.83,6.25,1.37,3.07,3,0,0.649541367312819,0.197686503095206,0.152772129591975,2.14631060503366,0.656002891871131,1,7,4,3,1.49030771316253,-2,-1,0,0
"71","D1",10,"20.10.2019","Yes","FC Koln","Paderborn",3,0,16,9,6,1,6,7,0,0,0,0,1.68,4.36,4.5,1.38,3.02,3,0,0.568616540307435,0.219099951311122,0.212283508381443,1.92494957223343,0.85595047645545,3,7,5,3,1.06899909577798,-1,0,0,0
"72","D1",10,"20.10.2019","Yes","Hoffenheim","Schalke 04",2,0,9,11,3,1,12,14,2,2,0,0,2.69,3.52,2.55,1.71,2.15,3,0,0.354722319921911,0.271080409258505,0.374197270819584,1.33524736902424,1.39367222171726,2,-2,2,3,-0.0584248526930207,-2,0,0,0
"73","D1",10,"25.10.2019","Yes","Mainz","FC Koln",3,1,18,16,6,8,20,9,2,2,0,0,2.55,3.54,2.7,1.58,2.39,3,0,0.375265017667845,0.270318021201413,0.354416961130742,1.39611307420495,1.33356890459364,2,2,-2,3,0.0625441696113076,11,0,0,0
"74","D1",10,"26.10.2019","Yes","Bayern Munich","Union Berlin",2,1,21,6,10,4,9,15,0,1,0,0,1.11,10.24,20.85,1.2,4.43,3,0,0.860854976273507,0.0933153343421478,0.045829689384345,2.67588026316267,0.230804402495183,1,15,6,3,2.44507586066749,-6,-1,0,0
"75","D1",10,"26.10.2019","Yes","Freiburg","RB Leipzig",2,1,14,25,3,6,10,9,3,1,0,0,3.96,3.74,1.9,1.63,2.27,3,0,0.241369003138544,0.255567179793753,0.503063817067703,0.979674189209386,1.76475863099686,1,-11,-3,3,-0.785084441787475,1,2,0,0
"76","D1",10,"26.10.2019","Yes","Hertha","Hoffenheim",2,3,13,17,4,8,17,12,3,3,1,0,2.1,3.66,3.37,1.62,2.31,0,3,0.455183561401178,0.261170895885922,0.2836455427129,1.62672158008946,1.11210752402462,-1,-4,-4,-3,0.514614056064834,5,0,1,0
"77","D1",10,"26.10.2019","Yes","Paderborn","Fortuna Dusseldorf",2,0,14,18,6,4,21,17,5,4,0,0,2.38,3.85,2.73,1.39,2.97,3,0,0.401610185358547,0.248268114585284,0.350121700056169,1.45309867066093,1.29863321475379,2,-4,2,3,0.154465455907133,4,1,0,0
"78","D1",10,"26.10.2019","Yes","Schalke 04","Dortmund",0,0,13,8,3,3,8,7,3,2,0,0,3.07,3.51,2.29,1.69,2.18,1,1,0.311017300020508,0.272029376371213,0.416953323608279,1.20508127643274,1.52288934719605,0,5,0,0,-0.317808070763314,1,1,0,0
"79","D1",10,"26.10.2019","Yes","Leverkusen","Werder Bremen",2,2,21,10,4,3,12,13,2,1,0,0,1.62,4.29,5.1,1.43,2.78,1,1,0.589876734931573,0.222750655148986,0.187372609919441,1.99238085994371,0.784868484907309,0,11,1,0,1.2075123750364,-1,1,0,0
"80","D1",10,"27.10.2019","Yes","Wolfsburg","Augsburg",0,0,14,10,3,5,12,13,0,0,0,0,1.59,4.19,5.6,1.62,2.29,1,1,0.601177040284293,0.22813162149213,0.170691338223576,2.03166274234501,0.740205636162859,0,4,-2,0,1.29145710618215,-1,0,0,0
"81","D1",10,"27.10.2019","Yes","M'gladbach","Ein Frankfurt",4,2,12,15,7,3,12,11,1,1,0,0,1.91,3.93,3.69,1.5,2.58,3,0,0.499096569027289,0.242563472478911,0.2583399584938,1.73985317956078,1.01758334796031,2,-3,4,3,0.722269831600467,1,0,0,0
"82","D1",10,"01.11.2019","Yes","Hoffenheim","Paderborn",3,0,12,9,7,2,7,12,0,1,0,0,1.44,4.94,6.59,1.31,3.42,3,0,0.662246886557169,0.193043626850673,0.144709486592158,2.17978428652218,0.627172086627148,3,3,5,3,1.55261219989503,-5,-1,0,0
"83","D1",10,"02.11.2019","Yes","Dortmund","Wolfsburg",3,0,17,12,8,3,12,18,1,3,0,0,1.53,4.25,6.31,1.64,2.28,3,0,0.624035760908264,0.224652873926975,0.151311365164761,2.09676015665177,0.678586969421259,3,5,5,3,1.41817318723051,-6,-2,0,0
"84","D1",10,"02.11.2019","Yes","Ein Frankfurt","Bayern Munich",5,1,17,7,11,3,12,7,1,2,0,1,6.7,5.19,1.42,1.31,3.39,3,0,0.142668535410633,0.184177107370182,0.673154357219185,0.612182713602081,2.20364017902774,4,10,8,3,-1.59145746542566,5,-1,-1,0
"85","D1",10,"02.11.2019","Yes","Leverkusen","M'gladbach",1,2,23,11,6,6,13,8,2,1,1,0,2,3.82,3.5,1.5,2.57,0,3,0.477329525169582,0.249910746162085,0.272759728668333,1.68189932167083,1.06818993216708,-1,12,0,-3,0.613709389503749,5,1,1,0
"86","D1",10,"02.11.2019","Yes","RB Leipzig","Mainz",8,0,19,10,12,2,10,7,0,1,0,0,1.35,5.32,8.32,1.42,2.87,3,0,0.706205206425385,0.179206208397419,0.114588585177196,2.29782182767357,0.522971963929007,8,9,10,3,1.77484986374457,3,-1,0,0
"87","D1",10,"02.11.2019","Yes","Werder Bremen","Freiburg",2,2,20,13,10,3,17,9,3,4,0,1,1.95,3.73,3.74,1.65,2.25,1,1,0.489194051205083,0.25574487931633,0.255061069478586,1.72332703293158,1.02092808775209,0,7,7,0,0.702398945179492,8,-1,-1,0
"88","D1",10,"02.11.2019","Yes","Union Berlin","Hertha",1,0,16,8,6,3,14,9,1,1,0,0,2.81,3.34,2.53,1.9,1.91,3,0,0.338754615171839,0.285000140309242,0.37624524451892,1.30126398582476,1.413735873866,1,8,3,3,-0.112471888041243,5,0,0,0
"89","D1",10,"03.11.2019","Yes","Fortuna Dusseldorf","FC Koln",2,0,9,8,3,1,10,20,1,3,0,0,2.72,3.63,2.46,1.57,2.4,3,0,0.350262408510037,0.262455578828458,0.387282012661505,1.31324280435857,1.42430161681297,2,1,2,3,-0.111058812454402,-10,-2,0,0
"90","D1",10,"03.11.2019","Yes","Augsburg","Schalke 04",2,3,12,11,4,3,12,10,3,5,0,0,3.75,3.79,1.93,1.71,2.14,0,3,0.254294326031559,0.251610480901939,0.494095193066502,1.01449345899662,1.73389606010144,-1,1,1,-3,-0.719402601104826,2,-2,0,0
"91","D1",10,"08.11.2019","Yes","FC Koln","Hoffenheim",1,2,11,15,3,5,21,14,4,3,0,0,2.58,3.59,2.64,1.61,2.33,0,3,0.370928730773747,0.266572736879183,0.362498532347071,1.37935892920042,1.35406833392039,-1,-4,-2,-3,0.025290595280028,7,1,0,0
"92","D1",10,"09.11.2019","Yes","Hertha","RB Leipzig",2,4,7,10,3,7,12,12,2,1,0,0,4.06,3.88,1.84,1.59,2.36,0,3,0.235132927568308,0.246041156166838,0.518825916264854,0.951439938871762,1.8025189049614,-2,-3,-4,-3,-0.851078966089637,0,1,0,0
"93","D1",10,"09.11.2019","Yes","Mainz","Union Berlin",2,3,18,14,5,4,15,15,1,4,0,0,2.2,3.39,3.36,1.85,1.97,0,3,0.434078748799561,0.281703022819774,0.284218228380665,1.58393926921846,1.13435770796177,-1,4,1,-3,0.449581561256688,0,-3,0,0
"94","D1",10,"09.11.2019","Yes","Paderborn","Augsburg",0,1,12,13,4,5,15,12,1,3,0,0,2.59,3.75,2.54,1.44,2.77,0,3,0.36895580664779,0.25482547712474,0.37621871622747,1.36169289706811,1.38348162580715,-1,-1,-1,-3,-0.0217887287390428,3,-2,0,0
"95","D1",10,"09.11.2019","Yes","Schalke 04","Fortuna Dusseldorf",3,3,12,9,5,5,9,15,2,4,0,0,1.52,4.31,6.29,1.71,2.15,1,1,0.627226012738912,0.221202677346438,0.15157130991465,2.10288071556317,0.675916607090387,0,3,0,0,1.42696410847279,-6,-2,0,0
"96","D1",10,"09.11.2019","Yes","Bayern Munich","Dortmund",4,0,17,2,5,0,11,12,2,1,0,0,1.56,4.57,5.32,1.41,2.87,3,0,0.611774297447459,0.208833239391255,0.179392463161285,2.04415613173363,0.747010628875111,4,15,5,3,1.29714550285852,-1,1,0,0
"97","D1",10,"10.11.2019","Yes","M'gladbach","Werder Bremen",3,1,17,16,7,7,17,11,5,4,1,0,1.73,4.12,4.35,1.5,2.56,3,0,0.550174826784876,0.231020012217921,0.218805160997203,1.88154449257255,0.887435495209531,2,1,0,3,0.994108997363017,6,1,1,0
"98","D1",10,"10.11.2019","Yes","Wolfsburg","Leverkusen",0,2,9,9,1,4,8,9,2,2,0,0,2.96,3.47,2.36,1.78,2.04,0,3,0.321826613220152,0.274526448164741,0.403646938615107,1.2400062878252,1.48546726401006,-2,0,-3,-3,-0.245460976184862,-1,0,0,0
"99","D1",10,"10.11.2019","Yes","Freiburg","Ein Frankfurt",1,0,13,17,7,6,7,13,1,3,1,2,2.74,3.54,2.48,1.66,2.23,3,0,0.347360924270001,0.268861280367176,0.383777795362823,1.31094405317718,1.42019466645565,1,-4,1,3,-0.109250613278468,-6,-2,-1,0
"100","D1",10,"22.11.2019","Yes","Dortmund","Paderborn",3,3,18,10,7,4,8,7,3,1,0,0,1.15,8.57,16.15,1.22,4.19,1,1,0.829602567829603,0.111323565111324,0.0590738670590739,2.60013126860013,0.288545166288545,0,8,3,0,2.31158610231159,1,2,0,0
"101","D1",10,"23.11.2019","Yes","Ein Frankfurt","Wolfsburg",0,2,17,9,9,6,13,22,3,5,0,1,2.02,3.67,3.55,1.65,2.25,0,3,0.471826573811516,0.25969746024503,0.268475965943454,1.67517718167958,1.06512535807539,-2,8,3,-3,0.610051823604185,-9,-2,-1,0
"102","D1",10,"23.11.2019","Yes","Fortuna Dusseldorf","Bayern Munich",0,4,12,18,1,5,8,6,1,1,0,0,13.56,7.57,1.19,1.29,3.5,0,3,0.0704908450246843,0.12626893771925,0.803240217256066,0.337741472793302,2.53598958948745,-4,-6,-4,-3,-2.19824811669415,2,0,0,0
"103","D1",10,"23.11.2019","Yes","Leverkusen","Freiburg",1,1,27,7,9,2,9,14,0,3,0,0,1.5,4.57,6.15,1.53,2.48,1,1,0.636079709406932,0.208778898054792,0.155141392538276,2.11701802627559,0.67420307566962,0,20,7,0,1.44281495060597,-5,-3,0,0
"104","D1",10,"23.11.2019","Yes","Union Berlin","M'gladbach",2,0,11,12,6,2,12,7,1,1,0,0,3.4,3.63,2.09,1.69,2.17,3,0,0.280628229645604,0.262847377629491,0.456524392724905,1.1047320665663,1.63242055580421,2,-1,4,3,-0.527688489237906,5,0,0,0
"105","D1",10,"23.11.2019","Yes","Werder Bremen","Schalke 04",1,2,16,10,5,5,12,15,3,2,0,0,2.45,3.62,2.74,1.59,2.36,0,3,0.388960346342075,0.263246643242565,0.34779301041536,1.43012768226879,1.30662567448864,-1,6,0,-3,0.123502007780148,-3,1,0,0
"106","D1",10,"23.11.2019","Yes","RB Leipzig","FC Koln",4,1,20,6,8,1,9,15,0,3,0,0,1.35,5.46,8.08,1.39,2.97,3,0,0.707047589741617,0.174819459002048,0.118132951256335,2.2959622282269,0.529218312771052,3,14,7,3,1.76674391545585,-6,-3,0,0
"107","D1",10,"24.11.2019","Yes","Augsburg","Hertha",4,0,14,5,5,1,8,18,0,2,0,1,2.59,3.53,2.61,1.68,2.18,3,0,0.366831369769748,0.269148228811231,0.364020401419021,1.36964233812047,1.3612094330683,4,9,4,3,0.00843290505217809,-10,-2,-1,0
"108","D1",10,"24.11.2019","Yes","Hoffenheim","Mainz",1,5,22,11,8,5,10,13,1,3,0,1,1.66,4.07,4.88,1.53,2.46,0,3,0.572073758734511,0.233327380712356,0.194598860553133,1.94954865691589,0.817123962371755,-4,11,3,-3,1.13242469454413,-3,-2,-1,0
"109","D1",10,"29.11.2019","Yes","Schalke 04","Union Berlin",2,1,17,17,8,7,12,13,1,4,0,0,1.71,3.87,4.93,1.76,2.07,3,0,0.559060101795933,0.247026556607505,0.193913341596561,1.92420686199531,0.828766581397189,1,0,1,3,1.09544028059812,-1,-3,0,0
"110","D1",10,"30.11.2019","Yes","FC Koln","Augsburg",1,1,13,11,6,4,15,17,8,3,1,1,1.92,3.76,3.82,1.64,2.26,1,1,0.496707796160018,0.253638023571073,0.249654180268909,1.74376141205113,1.0026005643778,0,2,2,0,0.741160847673325,-2,5,0,0
"111","D1",10,"30.11.2019","Yes","Hertha","Dortmund",1,2,13,7,3,5,13,8,3,2,0,1,4.1,3.9,1.83,1.61,2.32,0,3,0.233006856023506,0.244955925563173,0.52203721841332,0.943976493633693,1.81106758080313,-1,6,-2,-3,-0.867091087169441,5,1,-1,0
"112","D1",10,"30.11.2019","Yes","Hoffenheim","Fortuna Dusseldorf",1,1,12,11,6,3,11,16,2,4,0,0,1.7,3.97,4.79,1.6,2.32,1,1,0.560815493551726,0.24014769245288,0.199036813995393,1.92259417310806,0.837258134439061,0,1,3,0,1.085336038669,-5,-2,0,0
"113","D1",10,"30.11.2019","Yes","Paderborn","RB Leipzig",2,3,8,18,4,6,10,13,3,3,0,0,7.46,5.46,1.37,1.33,3.29,0,3,0.128015470974808,0.174907584884995,0.697076944140197,0.55895399780942,2.26613841730559,-1,-10,-2,-3,-1.70718441949617,-3,0,0,0
"114","D1",10,"30.11.2019","Yes","Bayern Munich","Leverkusen",1,2,24,11,11,7,9,16,1,3,0,1,1.29,6.04,9.37,1.31,3.4,0,3,0.740055731578307,0.158058260552321,0.101886007869372,2.37822545528724,0.463716284160437,-1,13,4,-3,1.91450917112681,-7,-2,-1,0
"115","D1",10,"01.12.2019","Yes","M'gladbach","Freiburg",4,2,22,13,13,5,13,15,3,2,0,0,1.56,4.41,5.44,1.55,2.42,3,0,0.609567948287953,0.215629478305943,0.174802573406104,2.0443333231698,0.740037198524255,2,9,8,3,1.30429612464555,-2,1,0,0
"116","D1",10,"01.12.2019","Yes","Wolfsburg","Werder Bremen",2,3,19,10,6,3,14,14,1,4,0,0,2.17,3.64,3.17,1.7,2.16,0,3,0.438462561510839,0.261391142439154,0.300146296050007,1.57677882697167,1.16183003058917,-1,9,3,-3,0.414948796382498,0,-3,0,0
"117","D1",10,"02.12.2019","Yes","Mainz","Ein Frankfurt",2,1,18,14,8,4,13,10,1,2,0,1,2.81,3.59,2.4,1.57,2.37,3,0,0.338574106311326,0.265012044215829,0.396413849472845,1.28073436314981,1.45425359263436,1,4,4,3,-0.173519229484555,3,-1,-1,0
"118","D1",10,"06.12.2019","Yes","Ein Frankfurt","Hertha",2,2,25,9,6,3,11,15,3,4,0,0,1.83,3.91,4.11,1.59,2.37,1,1,0.52266096849418,0.244621374001112,0.232717657504708,1.81260427948365,0.942774346515236,0,16,3,0,0.869829932968416,-4,-1,0,0
"119","D1",10,"07.12.2019","Yes","Augsburg","Mainz",2,1,18,12,5,3,13,14,2,2,0,0,2.28,3.62,2.99,1.62,2.3,3,0,0.417994485336711,0.263267244908205,0.318738269755084,1.51725070091834,1.21948205417346,1,6,2,3,0.297768646744881,-1,0,0,0
"120","D1",10,"07.12.2019","Yes","Dortmund","Fortuna Dusseldorf",5,0,23,2,10,0,8,10,0,3,0,0,1.3,5.75,9.24,1.41,2.88,3,0,0.731646859550794,0.165415811724527,0.102937328724679,2.36035639037691,0.474227797898564,5,21,10,3,1.88612859247835,-2,-3,0,0
"121","D1",10,"07.12.2019","Yes","Freiburg","Wolfsburg",1,0,10,10,3,0,13,20,0,2,0,0,2.88,3.36,2.46,1.88,1.93,3,0,0.330264672036824,0.283084004602992,0.386651323360184,1.27387802071346,1.44303797468354,1,0,3,3,-0.169159953970081,-7,-2,0,0
"122","D1",10,"07.12.2019","Yes","M'gladbach","Bayern Munich",2,1,7,17,3,5,12,17,3,5,0,1,5.24,4.61,1.56,1.35,3.15,3,0,0.181962633848147,0.206829544764488,0.611207821387365,0.752717446308929,2.04045300892658,1,-10,-2,3,-1.28773556261766,-5,-2,-1,0
"123","D1",10,"07.12.2019","Yes","RB Leipzig","Hoffenheim",3,1,25,11,14,1,14,5,3,1,0,0,1.44,4.98,6.48,1.42,2.82,3,0,0.661647475642161,0.191319751992914,0.147032772364925,2.1762621789194,0.632418069087688,2,14,13,3,1.54384410983171,9,2,0,0
"124","D1",10,"07.12.2019","Yes","Leverkusen","Schalke 04",2,1,19,5,9,3,11,11,2,2,0,0,1.94,3.66,3.85,1.72,2.13,3,0,0.491653989476769,0.26060348076091,0.24774252976232,1.73556544919122,1.00383107004787,1,14,6,3,0.731734379143348,0,0,0,0
"125","D1",10,"08.12.2019","Yes","Union Berlin","FC Koln",2,0,11,14,5,4,21,19,1,3,0,0,2.18,3.47,3.29,1.81,2,3,0,0.436518041838252,0.274239000347951,0.289242957813796,1.58379312586271,1.14196787378934,2,-3,1,3,0.441825252073368,2,-2,0,0
"126","D1",10,"08.12.2019","Yes","Werder Bremen","Paderborn",0,1,12,18,3,5,10,13,1,4,0,0,1.53,4.63,5.49,1.33,3.29,0,3,0.621449160560653,0.205360089774903,0.173190749664444,2.06970757145686,0.724932338768235,-1,-6,-2,-3,1.34477523268863,-3,-3,0,0
"127","D1",10,"13.12.2019","Yes","Hoffenheim","Augsburg",2,4,19,6,8,4,10,7,1,0,0,0,1.84,3.98,4.02,1.56,2.42,0,3,0.520827094102788,0.240784385213349,0.238388520683863,1.80326566752171,0.955949947264938,-2,13,4,-3,0.847315720256774,3,1,0,0
"128","D1",10,"14.12.2019","Yes","Bayern Munich","Werder Bremen",6,1,29,11,14,2,13,12,2,2,0,0,1.15,8.74,16.7,1.22,4.16,3,0,0.833027041218168,0.109608821212917,0.0573641375689157,2.60868994486742,0.281701233919664,5,18,12,3,2.32698871094776,1,0,0,0
"129","D1",10,"14.12.2019","Yes","FC Koln","Leverkusen",2,0,13,6,5,2,12,9,2,3,0,2,4.13,3.9,1.83,1.59,2.35,3,0,0.231706485638873,0.245371227099627,0.5229222872615,0.940490684016246,1.81413808888413,2,7,3,3,-0.873647404867881,3,-1,-2,0
"130","D1",10,"14.12.2019","Yes","Hertha","Freiburg",1,0,14,15,4,2,9,5,2,0,0,0,2.03,3.63,3.59,1.79,2.04,3,0,0.470657281234312,0.263205036062163,0.266137682703525,1.6751768797651,1.06161808417274,1,-1,2,3,0.613558795592362,4,2,0,0
"131","D1",10,"14.12.2019","Yes","Mainz","Dortmund",0,4,9,18,0,7,8,10,1,0,0,0,4.95,4.19,1.65,1.46,2.7,0,3,0.192998618148319,0.228005527406725,0.578995854444956,0.807001381851681,1.96499309074159,-4,-9,-7,-3,-1.15799170888991,-2,1,0,0
"132","D1",10,"14.12.2019","Yes","Paderborn","Union Berlin",1,1,14,15,3,2,19,16,2,4,0,0,2.8,3.58,2.43,1.64,2.26,1,1,0.340786762459162,0.266537132649624,0.392676104891215,1.28889742002711,1.44456544732327,0,-1,1,0,-0.15566802729616,3,-2,0,0
"133","D1",10,"14.12.2019","Yes","Fortuna Dusseldorf","RB Leipzig",0,3,4,21,1,7,11,7,2,1,0,0,6.52,4.93,1.44,1.46,2.7,0,3,0.14597915758478,0.193059656684131,0.660961185731088,0.630997129438472,2.1759432138774,-3,-17,-6,-3,-1.54494608443892,4,1,0,0
"134","D1",10,"15.12.2019","Yes","Wolfsburg","M'gladbach",2,1,17,6,7,5,20,15,3,3,0,0,2.6,3.41,2.68,1.74,2.09,3,0,0.365950153767299,0.279023577652486,0.355026268580215,1.37687403895438,1.34410238339313,1,11,2,3,0.0327716555612505,5,0,0,0
"135","D1",10,"15.12.2019","Yes","Schalke 04","Ein Frankfurt",1,0,11,17,5,3,15,12,1,4,1,0,1.96,3.79,3.61,1.66,2.22,3,0,0.485416467098798,0.251033318077478,0.263550214823724,1.70728271937387,1.04168396254865,1,-6,2,3,0.665598756825221,3,-3,1,0
"136","D1",10,"17.12.2019","Yes","Werder Bremen","Mainz",0,5,15,19,5,8,13,13,2,2,0,0,1.82,4,4.08,1.43,2.8,0,3,0.526017224485586,0.239337837140942,0.234644938373472,1.8173895105977,0.943272652261358,-5,-4,-3,-3,0.874116858336342,0,0,0,0
"137","D1",10,"17.12.2019","Yes","Augsburg","Fortuna Dusseldorf",3,0,12,6,7,2,10,15,3,4,0,0,1.78,4.04,4.21,1.65,2.25,3,0,0.536654319195795,0.236446704992207,0.226898975811999,1.84640966257959,0.917143632428203,3,6,5,3,0.929266030151388,-5,-1,0,0
"138","D1",10,"17.12.2019","Yes","Dortmund","RB Leipzig",3,3,14,12,6,8,9,5,0,0,0,0,2.19,3.76,3.11,1.44,2.76,1,1,0.437325394836736,0.254718780503312,0.307955824659952,1.56669496501352,1.17858625448317,0,2,-2,0,0.388108710530351,4,0,0,0
"139","D1",10,"17.12.2019","Yes","Union Berlin","Hoffenheim",0,2,16,7,2,4,16,13,2,6,0,0,2.44,3.48,2.86,1.79,2.03,0,3,0.391497262256907,0.274498080433004,0.334004657310089,1.44898986720373,1.27651205236327,-2,9,-2,-3,0.172477814840456,3,-4,0,0
"140","D1",10,"18.12.2019","Yes","Leverkusen","Hertha",0,1,17,10,7,5,12,16,2,3,0,0,1.54,4.33,5.97,1.51,2.53,0,3,0.619726650060774,0.220410863993901,0.159862485945325,2.07959081417622,0.699998321829877,-1,7,2,-3,1.37959249234635,-4,-1,0,0
"141","D1",10,"18.12.2019","Yes","Ein Frankfurt","FC Koln",2,4,17,21,6,9,12,10,2,4,0,0,1.75,3.85,4.59,1.58,2.37,0,3,0.544718955658647,0.247599525299385,0.207681519041968,1.88175639227533,0.870644082425289,-2,-4,-3,-3,1.01111230985004,2,-2,0,0
"142","D1",10,"18.12.2019","Yes","Freiburg","Bayern Munich",1,3,15,22,5,10,5,8,0,3,0,0,11.08,6.88,1.23,1.28,3.6,0,3,0.0860689251148277,0.138611001493066,0.775320073392107,0.396817776837549,2.46457122166939,-2,-7,-5,-3,-2.06775344483184,-3,-3,0,0
"143","D1",10,"18.12.2019","Yes","M'gladbach","Paderborn",2,0,17,12,6,2,6,14,2,3,0,0,1.3,5.89,8.74,1.28,3.63,3,0,0.730217766278568,0.161168607158258,0.108613626563174,2.35182190599396,0.487009486847779,2,5,4,3,1.86481241914618,-8,-1,0,0
"144","D1",10,"18.12.2019","Yes","Wolfsburg","Schalke 04",1,1,29,8,11,2,13,11,1,1,0,0,2.38,3.33,3.04,1.99,1.82,1,1,0.400382853843172,0.286159517161186,0.313457628995642,1.4873080786907,1.22653240414811,0,21,9,0,0.260775674542592,2,0,0,0
"145","D1",10,"20.12.2019","Yes","Hoffenheim","Dortmund",2,1,11,12,3,5,8,12,0,1,0,0,3.76,3.94,1.9,1.46,2.69,3,0,0.25424189319531,0.242626781323444,0.503131325481246,1.00535246090937,1.75202075776718,1,-1,-2,3,-0.746668296857807,-4,-1,0,0
"146","D1",10,"21.12.2019","Yes","Bayern Munich","Wolfsburg",2,0,18,10,8,3,7,7,2,2,0,0,1.16,7.96,16.49,1.31,3.39,3,0,0.822318170883285,0.11983531133475,0.0578465177819655,2.5867898239846,0.293374864680646,2,8,5,3,2.29341495930396,0,0,0,0
"147","D1",10,"21.12.2019","Yes","FC Koln","Werder Bremen",1,0,7,6,1,1,11,18,1,4,0,0,2.08,3.74,3.32,1.55,2.42,3,0,0.458157451958556,0.254804144404758,0.287038403636686,1.62927650028043,1.11591935531482,1,1,0,3,0.513357144965611,-7,-3,0,0
"148","D1",10,"21.12.2019","Yes","Mainz","Leverkusen",0,1,17,14,2,4,8,8,0,2,0,1,3.86,3.99,1.86,1.47,2.65,0,3,0.247360211183105,0.239300855931525,0.513338932885369,0.981381489480842,1.77931765458763,-1,3,-2,-3,-0.797936165106791,0,-2,-1,0
"149","D1",10,"21.12.2019","Yes","RB Leipzig","Augsburg",3,1,22,6,7,2,7,9,1,3,0,0,1.26,6.17,10.65,1.33,3.27,3,0,0.756130061205679,0.154412297750268,0.0894576410440522,2.42280248136731,0.422785220882425,2,16,5,3,2.00001726048488,-2,-2,0,0
"150","D1",10,"21.12.2019","Yes","Schalke 04","Freiburg",2,2,19,19,6,7,9,12,1,1,0,0,1.68,3.91,5.06,1.69,2.17,1,1,0.567638907219216,0.243896001055827,0.188465091724957,1.94681272271348,0.809291276230698,0,0,-1,0,1.13752144648278,-3,0,0,0
"151","D1",10,"21.12.2019","Yes","Hertha","M'gladbach",0,0,8,11,0,5,11,11,2,2,0,0,3.1,3.6,2.22,1.62,2.28,1,1,0.306983175846969,0.264346623646001,0.428670200507029,1.18529615118691,1.55035722516709,0,-3,-5,0,-0.36506107398018,0,0,0,0
"152","D1",10,"22.12.2019","Yes","Fortuna Dusseldorf","Union Berlin",2,1,22,17,8,6,8,18,2,4,0,0,2.77,3.28,2.6,1.94,1.86,3,0,0.343654797788488,0.290220667644546,0.366124534566966,1.32118506101001,1.38859427134544,1,5,2,3,-0.067409210335434,-10,-2,0,0
"153","D1",10,"22.12.2019","Yes","Paderborn","Ein Frankfurt",2,1,19,20,5,5,11,11,3,2,0,0,3.47,3.88,1.99,1.43,2.77,3,0,0.274872641962827,0.245826821549229,0.479300536487944,1.07044474743771,1.68372843101306,1,-1,0,3,-0.613283683575352,0,1,0,0
"154","D1",10,"17.01.2020","Yes","Schalke 04","M'gladbach",2,0,13,14,7,5,13,17,3,4,0,0,2.68,3.49,2.57,1.71,2.13,3,0,0.355782008004728,0.273207960301625,0.371010031693647,1.34055398431581,1.38623805538256,2,-1,2,3,-0.045684071066755,-4,-1,0,0
"155","D1",10,"18.01.2020","Yes","Augsburg","Dortmund",3,5,13,17,5,8,4,5,0,1,0,0,4.73,4.29,1.65,1.43,2.79,0,3,0.201238390092879,0.2218782249742,0.576883384932921,0.825593395252838,1.95252837977296,-2,-4,-3,-3,-1.12693498452012,-1,-1,0,0
"156","D1",10,"18.01.2020","Yes","FC Koln","Wolfsburg",3,1,12,17,7,8,11,18,3,3,0,0,2.77,3.32,2.57,1.93,1.86,3,0,0.34338791920379,0.286501366323644,0.370110714472567,1.31666512393501,1.39683350974134,2,-5,-1,3,-0.080168385806332,-7,0,0,0
"157","D1",10,"18.01.2020","Yes","Fortuna Dusseldorf","Werder Bremen",0,1,17,13,2,4,16,12,4,5,0,1,2.71,3.53,2.5,1.65,2.23,0,3,0.350667360716514,0.269209220266785,0.380123419016701,1.32121130241633,1.40957947731689,-1,4,-2,-3,-0.0883681749005616,4,-1,-1,0
"158","D1",10,"18.01.2020","Yes","Hoffenheim","Ein Frankfurt",1,2,12,13,5,3,10,13,2,2,0,0,2.37,3.68,2.81,1.54,2.43,0,3,0.402020052795067,0.258909653566388,0.339070293638544,1.46496981195159,1.27612053448202,-1,-1,2,-3,0.188849277469569,-3,0,0,0
"159","D1",10,"18.01.2020","Yes","Mainz","Freiburg",1,2,24,13,8,5,15,10,4,2,0,0,2.21,3.48,3.21,1.66,2.21,0,3,0.430379454223928,0.273315687883586,0.296304857892486,1.56445405055537,1.16223026156104,-1,11,3,-3,0.402223788994325,5,2,0,0
"160","D1",10,"18.01.2020","Yes","RB Leipzig","Union Berlin",3,1,19,15,8,5,6,18,1,3,0,0,1.28,5.89,10.31,1.43,2.79,3,0,0.745451554653157,0.16199965873617,0.0925487866106732,2.39835432269564,0.43964601856819,2,4,3,3,1.95870830412745,-12,-2,0,0
"161","D1",10,"19.01.2020","Yes","Hertha","Bayern Munich",0,4,6,20,1,10,7,14,3,1,0,0,8.48,5.43,1.34,1.4,2.92,0,3,0.112485274975342,0.175667611747864,0.711847113276793,0.513123436673891,2.31120895157824,-4,-14,-9,-3,-1.79808551490435,-7,2,0,0
"162","D1",10,"19.01.2020","Yes","Paderborn","Leverkusen",1,4,13,12,7,7,8,12,4,1,0,0,4.84,4.42,1.62,1.42,2.83,0,3,0.196746716491729,0.215442105841622,0.587811177666648,0.805682255316811,1.97887563884157,-3,1,0,-3,-1.17319338352476,-4,3,0,0
"163","D1",10,"24.01.2020","Yes","Dortmund","FC Koln",5,1,14,11,9,5,6,7,1,1,0,0,1.28,6.22,9.42,1.32,3.35,3,0,0.745340382335431,0.153381943631729,0.10127767403284,2.38940309063802,0.457214965730249,4,3,4,3,1.93218812490777,-1,0,0,0
"164","D1",10,"25.01.2020","Yes","Ein Frankfurt","RB Leipzig",2,0,7,22,5,4,8,10,1,2,0,0,4.04,4.21,1.77,1.42,2.85,3,0,0.235731978526394,0.22621311003483,0.538054911438776,0.933409045614013,1.84037784435116,2,-15,1,3,-0.906968798737144,-2,-1,0,0
"165","D1",10,"25.01.2020","Yes","Freiburg","Paderborn",0,2,19,15,5,3,11,7,4,4,0,1,1.76,4.01,4.3,1.48,2.62,0,3,0.541065500210238,0.23747513226185,0.221459367527911,1.86067163289256,0.901853234845585,-2,4,2,-3,0.95881839804698,4,0,-1,0
"166","D1",10,"25.01.2020","Yes","M'gladbach","Mainz",3,1,15,12,5,9,7,14,2,3,0,0,1.53,4.53,5.8,1.38,3.01,3,0,0.624398451480433,0.210889543215246,0.164712005304321,2.08408489765654,0.705025559128209,2,3,-4,3,1.37905933852834,-7,-1,0,0
"167","D1",10,"25.01.2020","Yes","Union Berlin","Augsburg",2,0,12,25,3,7,18,9,4,1,0,0,2.12,3.53,3.4,1.82,1.99,3,0,0.449620882908263,0.270027272454821,0.280351844636917,1.61888992117961,1.11108280636557,2,-13,-4,3,0.507807114814038,9,3,0,0
"168","D1",10,"25.01.2020","Yes","Wolfsburg","Hertha",1,2,20,9,7,4,8,8,0,1,0,0,1.77,3.8,4.56,1.89,1.91,0,3,0.539389638041164,0.251242015613911,0.209368346344925,1.8694109297374,0.879347054648687,-1,11,3,-3,0.990063875088715,0,-1,0,0
"169","D1",10,"25.01.2020","Yes","Bayern Munich","Schalke 04",5,0,24,7,14,1,3,4,0,0,0,0,1.17,7.84,14.64,1.29,3.56,3,0,0.813568548730075,0.121412653318136,0.0650187979517888,2.56211829950836,0.316469047173502,5,17,13,3,2.24564925233486,-1,0,0,0
"170","D1",10,"26.01.2020","Yes","Werder Bremen","Hoffenheim",0,3,16,9,3,4,14,15,2,2,0,0,2.41,3.62,2.77,1.52,2.5,0,3,0.394355672839822,0.262540655122644,0.343103672037534,1.44560767364211,1.29185167123525,-3,7,-1,-3,0.153756002406862,-1,0,0,0
"171","D1",10,"26.01.2020","Yes","Leverkusen","Fortuna Dusseldorf",3,0,25,12,11,3,11,10,0,3,0,0,1.38,5.15,7.45,1.47,2.63,3,0,0.688138389934625,0.184394364681511,0.127467245383863,2.24880953448539,0.566796100833102,3,13,8,3,1.68201343365229,1,-3,0,0
"172","D1",10,"31.01.2020","Yes","Hertha","Schalke 04",0,0,9,13,0,5,9,9,1,1,0,0,2.71,3.34,2.64,1.96,1.85,1,1,0.352374177769608,0.285908389747197,0.361717432483196,1.34303092305602,1.37106068719678,0,-4,-5,0,-0.0280297641407641,0,0,0,0
"173","D1",10,"01.02.2020","Yes","Augsburg","Werder Bremen",2,1,14,7,4,1,8,17,2,5,0,0,2.07,3.71,3.37,1.56,2.39,3,0,0.46036386666323,0.256860701884875,0.282775431451895,1.63795230187456,1.10518699624056,1,7,3,3,0.532765305634005,-9,-3,0,0
"174","D1",10,"01.02.2020","Yes","Dortmund","Union Berlin",5,0,13,5,7,0,7,8,0,1,0,0,1.24,6.36,11.2,1.38,3.02,3,0,0.765882777959366,0.14932305733799,0.0847941647026441,2.44697139121609,0.403705551445922,5,8,7,3,2.04326583977017,-1,-1,0,0
"175","D1",10,"01.02.2020","Yes","Fortuna Dusseldorf","Ein Frankfurt",1,1,8,6,1,4,6,12,2,1,0,0,3.35,3.71,2.08,1.61,2.31,1,1,0.284613086566372,0.256995644204136,0.458391269229493,1.11083490390325,1.63216945189261,0,2,-3,0,-0.521334547989363,-6,1,0,0
"176","D1",10,"01.02.2020","Yes","Hoffenheim","Leverkusen",2,1,14,22,6,11,8,10,3,3,0,1,3.24,3.75,2.11,1.52,2.5,3,0,0.294157010137961,0.254151656759198,0.451691333102841,1.13662268717308,1.60922565606772,1,-8,-5,3,-0.472602968894639,-2,0,-1,0
"177","D1",10,"01.02.2020","Yes","Mainz","Bayern Munich",1,3,8,13,3,5,12,9,3,1,0,0,13.65,7.43,1.19,1.25,3.82,0,3,0.0698922648723723,0.128402343944533,0.801705391183094,0.33807913856165,2.53351851749382,-2,-5,-2,-3,-2.19543937893217,3,2,0,0
"178","D1",10,"01.02.2020","Yes","RB Leipzig","M'gladbach",2,2,18,7,8,4,12,13,1,6,0,1,1.53,4.57,5.64,1.45,2.73,1,1,0.622638364483611,0.208454419619239,0.16890721589715,2.07636951307007,0.715176067310689,0,11,4,0,1.36119344575938,-1,-5,-1,0
"179","D1",10,"02.02.2020","Yes","FC Koln","Freiburg",4,0,24,9,9,2,13,9,3,1,0,0,2.05,3.6,3.48,1.68,2.17,3,0,0.463279343243843,0.263811848236077,0.27290880852008,1.65364987796761,1.08253827379632,4,15,7,3,0.571111604171289,4,2,0,0
"180","D1",10,"02.02.2020","Yes","Paderborn","Wolfsburg",2,4,10,9,7,5,15,17,3,3,1,0,3.79,3.96,1.87,1.63,2.25,0,3,0.251016070696148,0.240240128267273,0.508743801036578,0.993288340355718,1.76647153137701,-2,1,2,-3,-0.773183191021291,-2,0,1,0
"181","D1",10,"07.02.2020","Yes","Ein Frankfurt","Augsburg",5,0,13,8,9,5,7,5,1,0,0,0,1.93,3.63,3.93,1.79,2.02,3,0,0.494370458160497,0.262847103099107,0.242782438740397,1.7459584775806,0.991194419320297,5,5,4,3,0.7547640582603,2,1,0,0
"182","D1",10,"08.02.2020","Yes","Freiburg","Hoffenheim",1,0,12,21,6,6,10,13,3,3,0,0,2.55,3.53,2.67,1.6,2.31,3,0,0.373491684201767,0.269802774706659,0.356705541091575,1.39027782731196,1.33991939798138,1,-9,0,3,0.0503584293305752,-3,0,0,0
"183","D1",10,"08.02.2020","Yes","Hertha","Mainz",1,3,13,10,3,3,13,16,4,1,1,0,2.03,3.6,3.58,1.67,2.21,0,3,0.4692791132926,0.264621277773327,0.266099608934072,1.67245861765113,1.06292010457554,-2,3,0,-3,0.609538513075584,-3,3,1,0
"184","D1",10,"08.02.2020","Yes","Schalke 04","Paderborn",1,1,15,15,4,4,6,8,2,3,0,0,1.5,4.47,6.24,1.49,2.59,1,1,0.634535850292781,0.212931493386839,0.15253265632038,2.11653904426518,0.670529462347979,0,0,0,0,1.4460095819172,-2,-1,0,0
"185","D1",10,"08.02.2020","Yes","Werder Bremen","Union Berlin",0,2,14,11,3,5,7,16,4,3,0,0,2.08,3.57,3.48,1.74,2.09,0,3,0.458645284189075,0.267221902272627,0.274132813538298,1.64315775483985,1.08962034288752,-2,3,-2,-3,0.553537411952332,-9,1,0,0
"186","D1",10,"08.02.2020","Yes","Wolfsburg","Fortuna Dusseldorf",1,1,9,10,5,2,10,14,0,1,1,0,1.56,4.18,5.96,1.72,2.11,1,1,0.611639234788074,0.228267274227128,0.160093490984798,2.06318497859135,0.708547747181522,0,-1,3,0,1.35463723140983,-4,-1,1,0
"187","D1",10,"08.02.2020","Yes","Leverkusen","Dortmund",4,3,9,12,5,6,9,10,2,1,0,0,3.05,3.84,2.16,1.39,2.92,3,0,0.311885208916163,0.247721324790181,0.440393466293656,1.18337695153867,1.56890172367115,1,-3,-1,3,-0.385524772132479,-1,1,0,0
"188","D1",10,"09.02.2020","Yes","Bayern Munich","RB Leipzig",0,0,10,8,3,1,8,12,2,2,0,0,1.42,5.28,6.4,1.28,3.6,1,1,0.67077431239281,0.180397637045036,0.148828050562155,2.19272057422346,0.6268817887315,0,2,2,0,1.56583878549197,-4,0,0,0
"189","D1",10,"14.02.2020","Yes","Dortmund","Ein Frankfurt",4,0,17,1,7,0,7,3,0,1,0,0,1.43,5.06,6.56,1.36,3.13,3,0,0.666401660704033,0.188330904112009,0.145267435183958,2.18753588622411,0.624133209663884,4,16,7,3,1.56340267656022,4,-1,0,0
"190","D1",10,"15.02.2020","Yes","Augsburg","Freiburg",1,1,10,20,3,5,19,5,4,1,0,0,2.04,3.61,3.55,1.67,2.2,1,1,0.467345442875949,0.264095485724913,0.268559071399137,1.66613181435276,1.06977269992232,0,-10,-2,0,0.596359114430437,14,3,0,0
"191","D1",10,"15.02.2020","Yes","Hoffenheim","Wolfsburg",2,3,14,15,6,6,7,12,2,2,0,0,2.48,3.43,2.82,1.7,2.14,0,3,0.384251130197119,0.27782589005506,0.337922979747821,1.43057928064642,1.29159482929852,-1,-1,0,-3,0.138984451347894,-5,0,0,0
"192","D1",10,"15.02.2020","Yes","Paderborn","Hertha",1,2,20,17,4,6,14,12,2,2,0,0,2.73,3.5,2.51,1.69,2.18,0,3,0.348717663730584,0.271999777709856,0.37928255855956,1.31815276890161,1.40984745338854,-1,3,-2,-3,-0.0916946844869269,2,0,0,0
"193","D1",10,"15.02.2020","Yes","RB Leipzig","Werder Bremen",3,0,10,8,3,1,10,12,1,1,0,0,1.25,6.32,10.73,1.34,3.24,3,0,0.760872516580441,0.150489026222397,0.0886384571971622,2.43310657596372,0.416404397813884,3,2,2,3,2.01670217814983,-2,0,0,0
"194","D1",10,"15.02.2020","Yes","Union Berlin","Leverkusen",2,3,20,12,7,5,9,12,2,2,0,0,3.81,3.7,1.94,1.67,2.2,0,3,0.250397678117936,0.257841933413334,0.49176038846873,1.00903496776714,1.73312309881952,-1,8,2,-3,-0.724088131052382,-3,0,0,0
"195","D1",10,"15.02.2020","Yes","Fortuna Dusseldorf","M'gladbach",1,4,9,17,4,6,10,10,2,2,0,0,4,3.88,1.85,1.66,2.21,0,3,0.238487607149977,0.245863512525749,0.515648880324274,0.96132633397568,1.79281015349857,-3,-8,-2,-3,-0.831483819522892,0,0,0,0
"196","D1",10,"16.02.2020","Yes","FC Koln","Bayern Munich",1,4,13,26,6,8,12,10,1,3,0,0,11.82,6.95,1.22,1.28,3.62,0,3,0.0807151751002395,0.137273866141702,0.782010958758058,0.379419391442421,2.48330674241588,-3,-13,-2,-3,-2.10388735097346,2,-2,0,0
"197","D1",10,"16.02.2020","Yes","Mainz","Schalke 04",0,0,15,8,5,3,7,11,2,2,0,0,2.84,3.41,2.46,1.73,2.1,1,1,0.334748637237923,0.278793586438622,0.386457776323456,1.28303949815239,1.43816691540899,0,7,2,0,-0.155127417256598,-4,0,0,0
"198","D1",10,"21.02.2020","Yes","Bayern Munich","Paderborn",3,2,18,5,9,4,3,9,1,3,0,0,1.06,14.01,32.25,1.12,6.01,3,0,0.902096821435053,0.0682528644340583,0.0296503141308886,2.77454332873922,0.157203806826724,1,13,5,3,2.61733952191249,-6,-2,0,0
"199","D1",10,"22.02.2020","Yes","Freiburg","Fortuna Dusseldorf",0,2,15,9,4,4,13,10,1,4,0,0,1.93,3.7,3.87,1.77,2.05,0,3,0.494968733904615,0.258186393631326,0.246844872464059,1.74309259534517,0.998721011023502,-2,6,0,-3,0.74437158432167,3,-3,0,0
"200","D1",10,"22.02.2020","Yes","Hertha","FC Koln",0,5,9,17,1,11,12,10,2,2,0,0,2.43,3.38,2.93,1.81,2,0,3,0.392420562117868,0.282124841995982,0.32545459588615,1.45938652834959,1.25848862965443,-5,-8,-10,-3,0.200897898695154,2,0,0,0
"201","D1",10,"22.02.2020","Yes","M'gladbach","Hoffenheim",1,1,17,22,10,4,8,8,4,4,0,0,1.64,4.21,4.94,1.47,2.64,1,1,0.580877793729087,0.22628018568069,0.192842020590223,1.96891356686795,0.80480624745136,0,-5,6,0,1.16410731941659,0,0,0,0
"202","D1",10,"22.02.2020","Yes","Werder Bremen","Dortmund",0,2,8,12,2,6,13,8,0,0,0,0,6.44,5.38,1.41,1.33,3.26,0,3,0.147832729852241,0.176959624581493,0.675207645566265,0.620457814138217,2.20258256128029,-2,-4,-4,-3,-1.58212474714207,5,0,0,0
"203","D1",10,"22.02.2020","Yes","Schalke 04","RB Leipzig",0,5,3,22,2,8,10,7,2,3,0,0,4.13,4,1.79,1.62,2.29,0,3,0.23042735262787,0.237916241588275,0.531656405783855,0.929198299471884,1.83288545893984,-5,-19,-6,-3,-0.903687159467957,3,-1,0,0
"204","D1",10,"23.02.2020","Yes","Leverkusen","Augsburg",2,0,9,8,4,3,8,12,2,4,0,0,1.47,4.62,6.52,1.46,2.68,3,0,0.647818625237106,0.206124108029988,0.146057266732906,2.14957998374131,0.644295908228706,2,1,1,3,1.5052840755126,-4,-2,0,0
"205","D1",10,"23.02.2020","Yes","Wolfsburg","Mainz",4,0,16,13,6,3,10,12,0,2,0,0,1.8,3.75,4.41,1.66,2.2,3,0,0.529615218331172,0.254215304798962,0.216169476869866,1.84306095979248,0.90272373540856,4,3,3,3,0.940337224383917,-2,-2,0,0
"206","D1",10,"24.02.2020","Yes","Ein Frankfurt","Union Berlin",1,2,21,11,3,7,10,15,3,4,0,0,1.9,3.63,3.99,1.73,2.09,0,3,0.500098405825625,0.261759496162173,0.238142098012202,1.76205471363905,0.97618579019878,-1,10,-4,-3,0.785868923440267,-5,-1,0,0
"207","D1",10,"28.02.2020","Yes","Fortuna Dusseldorf","Hertha",3,3,14,16,5,7,11,11,2,2,0,0,2.37,3.37,3.05,1.9,1.9,1,1,0.40317487712747,0.283538415071841,0.31328670780069,1.49306304645425,1.22339853847391,0,-2,-2,0,0.26966450798034,0,0,0,0
"208","D1",10,"29.02.2020","Yes","Augsburg","M'gladbach",2,3,8,15,3,7,11,6,3,2,0,0,3.45,3.76,2.03,1.58,2.34,0,3,0.276467584023645,0.253673714064249,0.469858701912106,1.08307646613518,1.66324981980057,-1,-7,-4,-3,-0.580173353665383,5,1,0,0
"209","D1",10,"29.02.2020","Yes","Dortmund","Freiburg",1,0,16,13,2,4,5,9,1,0,0,0,1.2,7.01,13.41,1.3,3.44,3,0,0.793229323565225,0.135788186630281,0.0709824898044944,2.51547615732595,0.348735656043764,1,3,-2,3,2.16674050128219,-4,1,0,0
"210","D1",10,"29.02.2020","Yes","Hoffenheim","Bayern Munich",0,6,4,25,1,11,3,7,0,0,0,0,6.85,5.41,1.39,1.31,3.39,0,3,0.139000256932083,0.175998476891824,0.685001266176093,0.592999247688073,2.2310022754201,-6,-21,-10,-3,-1.63800302773203,-4,0,0,0
"211","D1",10,"29.02.2020","Yes","Mainz","Paderborn",2,0,8,9,3,4,5,15,1,3,0,0,1.84,3.95,3.96,1.5,2.57,3,0,0.518008769257262,0.241300287451484,0.240690943291253,1.79532659522327,0.963373117325244,2,-1,-1,3,0.831953477898027,-10,-2,0,0
"212","D1",10,"29.02.2020","Yes","FC Koln","Schalke 04",3,0,11,7,6,1,7,8,1,2,0,0,2.22,3.51,3.19,1.76,2.04,3,0,0.429478844228623,0.271636192076223,0.298884963695154,1.56007272476209,1.16829108316169,3,4,5,3,0.391781641600405,-1,-1,0,0
"213","D1",10,"01.03.2020","Yes","Union Berlin","Wolfsburg",2,2,6,14,3,3,8,13,1,2,0,0,2.67,3.22,2.72,2.06,1.76,1,1,0.355769308885296,0.295001259230975,0.349229431883728,1.36230918588686,1.34268955488216,0,-8,0,0,0.0196196310047041,-5,-1,0,0
"214","D1",10,"01.03.2020","Yes","RB Leipzig","Leverkusen",1,1,9,14,2,6,4,12,0,3,0,0,1.48,4.82,5.96,1.42,2.81,1,1,0.642931318484566,0.197414595717253,0.159654085798181,2.12620855117095,0.676376853111796,0,-5,-4,0,1.44983169805916,-8,-3,0,0
"215","D1",10,"06.03.2020","Yes","Paderborn","FC Koln",1,2,16,15,2,3,8,12,3,4,0,0,3.19,3.82,2.12,1.52,2.51,0,3,0.299419528968093,0.250038821311051,0.450541649720856,1.14829740821533,1.60166377047362,-1,1,-1,-3,-0.453366362258291,-4,-1,0,0
"216","D1",10,"07.03.2020","Yes","Freiburg","Union Berlin",3,1,9,14,4,4,5,20,2,3,0,1,2.33,3.39,3.1,1.88,1.92,3,0,0.410016113488902,0.281810485082343,0.308173401428755,1.51185882554905,1.20633068936861,2,-5,0,3,0.30552813618044,-15,-1,-1,0
"217","D1",10,"07.03.2020","Yes","Hertha","Werder Bremen",2,2,19,7,5,3,16,5,3,3,0,0,2.16,3.46,3.39,1.84,1.96,1,1,0.442195028161686,0.276052387522903,0.281752584315411,1.60263747200796,1.12131014046914,0,12,2,0,0.481327331538827,11,0,0,0
"218","D1",10,"07.03.2020","Yes","Leverkusen","Ein Frankfurt",4,0,14,9,5,3,10,12,1,0,0,0,1.65,4.24,4.84,1.52,2.52,3,0,0.578014623869129,0.224934936175486,0.197050439955385,1.95897880778287,0.816086256041641,4,5,2,3,1.14289255174123,-2,1,0,0
"219","D1",10,"07.03.2020","Yes","Schalke 04","Hoffenheim",1,1,14,4,4,1,8,12,0,1,0,0,2.28,3.53,3.08,1.69,2.16,1,1,0.419084769804804,0.270683647352678,0.310231582842518,1.52793795676709,1.20137839588023,0,10,3,0,0.326559560886861,-4,-1,0,0
"220","D1",10,"07.03.2020","Yes","Wolfsburg","RB Leipzig",0,0,16,15,4,4,11,14,2,3,0,0,3.85,3.73,1.92,1.65,2.23,1,1,0.247685385331032,0.255653815958304,0.496660798710664,0.998709971951401,1.7456362120903,0,1,0,0,-0.746926240138895,-3,-1,0,0
"221","D1",10,"07.03.2020","Yes","M'gladbach","Dortmund",1,2,10,10,3,4,8,9,5,5,0,0,3.07,3.8,2.18,1.51,2.51,0,3,0.310930614879929,0.251199207284574,0.437870177835497,1.18399105192436,1.56480974079106,-1,0,-1,-3,-0.380818688866702,-1,0,0,0
"222","D1",10,"08.03.2020","Yes","Bayern Munich","Augsburg",2,0,17,8,6,2,4,7,1,0,0,0,1.09,11.11,25.02,1.19,4.49,3,0,0.875906046845493,0.0859349766932122,0.0381589764612945,2.71365311722969,0.200411906077096,2,9,4,3,2.5132412111526,-3,1,0,0
"223","D1",10,"08.03.2020","Yes","Mainz","Fortuna Dusseldorf",1,1,3,20,1,5,17,10,3,1,1,0,1.89,3.86,3.82,1.57,2.36,1,1,0.503930226517751,0.246743038372681,0.249326735109568,1.75853371792593,0.994723243701385,0,-17,-4,0,0.763810474224549,7,2,1,0
"224","D1",10,"11.03.2020","No","M'gladbach","FC Koln",2,1,12,16,5,3,14,14,1,2,0,0,1.78,4.03,4.16,1.49,2.56,3,0,0.53488179178764,0.236250518457072,0.228867689755288,1.84089589381999,0.922853587722936,1,-4,2,3,0.918042306097056,0,-1,0,0
"225","D1",10,"16.05.2020","No","Augsburg","Wolfsburg",1,2,8,17,3,5,8,11,1,3,0,0,3.41,3.44,2.16,1.91,1.9,0,3,0.280113396465408,0.277670547077628,0.442216056456964,1.11801073647385,1.60431871644852,-1,-9,-2,-3,-0.486307979974667,-3,-2,0,0
"226","D1",10,"16.05.2020","No","Dortmund","Schalke 04",4,0,11,10,4,3,9,8,2,2,0,0,1.52,4.48,6.05,1.65,2.24,3,0,0.628723068643643,0.213316755432665,0.157960175923692,2.09948596136359,0.687197283203741,4,1,1,3,1.41228867815985,1,0,0,0
"227","D1",10,"16.05.2020","No","Fortuna Dusseldorf","Paderborn",0,0,10,7,1,1,15,16,2,2,0,0,2.17,3.57,3.26,1.78,2.06,1,1,0.439852906161539,0.267361570411916,0.292785523426546,1.58692028889653,1.14571814069155,0,3,0,0,0.441202148204979,-1,0,0,0
"228","D1",10,"16.05.2020","No","Hoffenheim","Hertha",0,3,21,12,5,5,9,16,2,3,0,0,2.18,3.52,3.26,1.78,2.06,0,3,0.437057237313183,0.270677493563278,0.292265269123539,1.58184920550283,1.1474733009339,-3,9,0,-3,0.43437590456893,-7,-1,0,0
"229","D1",10,"16.05.2020","No","RB Leipzig","Freiburg",1,1,23,7,9,2,11,8,0,1,0,0,1.32,5.49,9.49,1.57,2.43,1,1,0.724884067468351,0.174289065402226,0.100826867129423,2.34894126780728,0.476769666790495,0,16,7,0,1.87217160101678,3,-1,0,0
"230","D1",10,"16.05.2020","No","Ein Frankfurt","M'gladbach",1,3,12,15,4,8,19,10,5,1,0,0,2.89,3.51,2.4,1.71,2.15,0,3,0.330302424335102,0.27195840636138,0.397739169303518,1.26286567936669,1.46517591427193,-2,-3,-4,-3,-0.20231023490525,9,4,0,0
"231","D1",10,"17.05.2020","No","FC Koln","Mainz",2,2,16,11,6,5,20,15,4,2,0,0,1.87,3.84,3.96,1.65,2.24,1,1,0.510412051395658,0.248560035445281,0.241027913159061,1.77979618963225,0.971643774922463,0,5,1,0,0.808152414709791,5,2,0,0
"232","D1",10,"17.05.2020","No","Union Berlin","Bayern Munich",0,2,10,14,2,3,13,10,2,1,0,0,14.63,6.86,1.2,1.45,2.7,0,3,0.0652557514954443,0.139167878189264,0.795576370315292,0.334935132675597,2.52589698913514,-2,-4,-1,-3,-2.19096185645954,3,1,0,0
"233","D1",10,"18.05.2020","No","Werder Bremen","Leverkusen",1,4,9,13,1,6,15,14,2,1,0,0,4.72,3.96,1.71,1.67,2.21,0,3,0.201932367149758,0.24068706387547,0.557380568974772,0.846484165324745,1.91282877079978,-3,-4,-5,-3,-1.06634460547504,1,1,0,0
"234","D1",10,"22.05.2020","No","Hertha","Union Berlin",4,0,14,7,8,0,12,12,2,1,0,0,2.36,3.37,3.09,1.88,1.94,3,0,0.405835791869488,0.284205480359641,0.309958727770871,1.5017128559681,1.21408166367225,4,7,8,3,0.28763119229585,0,1,0,0
"235","D1",10,"23.05.2020","No","Freiburg","Werder Bremen",0,1,15,11,8,3,12,18,0,3,0,1,2.19,3.65,3.17,1.71,2.15,0,3,0.436518865326356,0.261911319195814,0.30156981547783,1.57146791517488,1.1666207656293,-1,4,5,-3,0.40484714954558,-6,-3,-1,0
"236","D1",10,"23.05.2020","No","M'gladbach","Leverkusen",1,3,16,13,6,7,16,16,1,1,0,0,2.39,3.74,2.75,1.49,2.58,0,3,0.398703680013646,0.254786576265404,0.34650974372095,1.45089761630634,1.29431580742825,-2,3,-1,-3,0.156581808878086,0,0,0,0
"237","D1",10,"23.05.2020","No","Paderborn","Hoffenheim",1,1,13,18,3,7,14,13,3,0,0,0,3.19,3.77,2.13,1.58,2.39,1,1,0.299060373690463,0.253051085430392,0.447888540879145,1.15023220650178,1.59671670806783,0,-5,-4,0,-0.446484501566044,1,3,0,0
"238","D1",10,"23.05.2020","No","Wolfsburg","Dortmund",0,2,8,6,1,2,11,10,4,2,1,0,4.43,3.91,1.76,1.63,2.28,0,3,0.215052016112651,0.243652284240165,0.541295699647184,0.888808332578118,1.86753938318172,-2,2,-1,-3,-0.978731050603599,1,2,1,0
"239","D1",10,"23.05.2020","No","Bayern Munich","Ein Frankfurt",5,2,23,11,10,4,10,7,0,1,0,0,1.15,8.7,16.22,1.25,3.84,3,0,0.831197134981033,0.109870885658412,0.0589319793605542,2.60346229060151,0.286666823740075,3,12,6,3,2.31679546686144,3,-1,0,0
"240","D1",10,"24.05.2020","No","Schalke 04","Augsburg",0,3,12,9,2,7,14,11,0,2,0,0,2.06,3.49,3.6,1.87,1.94,0,3,0.462432000706677,0.272954132222279,0.264613867071043,1.66025013434231,1.06679573343541,-3,3,-5,-3,0.593454400906903,3,-2,0,0
"241","D1",10,"24.05.2020","No","Mainz","RB Leipzig",0,5,4,21,1,9,13,11,3,3,0,0,6.5,4.98,1.44,1.45,2.7,0,3,0.146646708056244,0.191406345856543,0.661946946087213,0.631346470025275,2.17724718411818,-5,-17,-8,-3,-1.54590071409291,2,0,0,0
"242","D1",10,"24.05.2020","No","FC Koln","Fortuna Dusseldorf",2,2,16,10,6,5,19,17,0,1,0,0,1.79,4.03,4.19,1.66,2.22,1,1,0.534366050095729,0.237348692226143,0.228285257678128,1.84044684251333,0.922204465260526,0,6,1,0,0.918242377252805,2,-1,0,0
"243","D1",10,"26.05.2020","No","Dortmund","Bayern Munich",0,1,13,13,5,6,9,15,2,2,0,0,3.63,4.17,1.89,1.37,3.05,0,3,0.263773005211,0.229615349859936,0.506611644929064,1.02093436549294,1.74945028464713,-1,0,-1,-3,-0.728515919154192,-6,0,0,0
"244","D1",10,"26.05.2020","No","Ein Frankfurt","Freiburg",3,3,35,10,16,5,14,9,4,1,0,0,2.04,3.59,3.64,1.85,1.97,1,1,0.469773661959679,0.266946593425556,0.263279744614765,1.67626757930459,1.05678582726985,0,25,11,0,0.619481752034742,5,3,0,0
"245","D1",10,"26.05.2020","No","Leverkusen","Wolfsburg",1,4,10,14,2,9,10,16,3,3,0,0,1.73,4.09,4.53,1.57,2.39,0,3,0.554053043782502,0.234354954949567,0.211592001267931,1.89651408629707,0.86913095875336,-3,-4,-7,-3,1.02738312754371,-6,0,0,0
"246","D1",10,"26.05.2020","No","Werder Bremen","M'gladbach",0,0,12,8,7,4,14,11,2,1,0,0,4.46,4.04,1.74,1.58,2.39,1,1,0.21426220114361,0.236536984430816,0.549200814425574,0.879323587861645,1.88413942770754,0,4,3,0,-1.00481583984589,3,1,0,0
"247","D1",10,"27.05.2020","No","RB Leipzig","Hertha",2,2,11,13,5,4,12,19,2,3,1,0,1.35,5.49,8.07,1.39,2.95,1,1,0.707619992237699,0.174004916124024,0.118375091638277,2.29686489283712,0.529130191038855,0,-2,1,0,1.76773470179827,-7,-1,1,0
"248","D1",10,"27.05.2020","No","Augsburg","Paderborn",0,0,12,15,3,3,7,14,1,1,0,0,1.95,3.71,3.77,1.77,2.05,1,1,0.489512716684108,0.257291050548251,0.253196232767642,1.72582920060057,1.01687974885118,0,-3,0,0,0.708949451749397,-7,0,0,0
"249","D1",10,"27.05.2020","No","Fortuna Dusseldorf","Schalke 04",2,1,13,7,8,2,10,13,3,2,0,0,2.67,3.29,2.7,1.96,1.85,3,0,0.357086865812038,0.28979390021828,0.353119233969682,1.36105449765439,1.34915160212733,1,6,6,3,0.0119028955270679,-3,1,0,0
"250","D1",10,"27.05.2020","No","Hoffenheim","FC Koln",3,1,8,15,6,5,12,8,6,1,1,1,2.46,3.65,2.72,1.51,2.55,3,0,0.387839769983827,0.261393379221977,0.350766850794196,1.42491268917346,1.31369393160457,2,-7,1,3,0.111218757568892,4,5,0,0
"251","D1",10,"27.05.2020","No","Union Berlin","Mainz",1,1,9,10,4,2,17,18,4,2,1,0,2.27,3.48,3.1,1.8,2.01,1,1,0.419365121323558,0.273551386610482,0.30708349206596,1.53164675058116,1.19480186280836,0,-1,2,0,0.336844887772793,-1,2,1,0
"252","D1",10,"29.05.2020","No","Freiburg","Leverkusen",0,1,9,7,1,1,8,13,0,2,0,0,4.68,4.14,1.7,1.55,2.44,0,3,0.20477636954017,0.23148633078454,0.563737299675291,0.845815439405049,1.92269822981041,-1,2,0,-3,-1.07688279040536,-5,-2,0,0
"253","D1",10,"30.05.2020","No","Hertha","Augsburg",2,0,12,8,6,2,19,7,3,3,0,0,1.91,3.79,3.83,1.73,2.11,3,0,0.499337803019618,0.251645172498013,0.249017024482368,1.74965858155687,0.998696245945118,2,4,4,3,0.75096233561175,12,0,0,0
"254","D1",10,"30.05.2020","No","Mainz","Hoffenheim",0,1,18,13,2,6,18,14,4,3,0,0,2.79,3.71,2.38,1.53,2.52,0,3,0.341963293301163,0.257163770434028,0.400872936264809,1.28305365033752,1.45978257922845,-1,5,-4,-3,-0.176728928890937,4,1,0,0
"255","D1",10,"30.05.2020","No","Schalke 04","Werder Bremen",0,1,12,6,1,2,19,16,5,3,0,0,2.47,3.37,2.88,1.94,1.87,0,3,0.386014453269485,0.282924539933421,0.331061006797093,1.44096789974188,1.2761075603247,-1,6,-1,-3,0.164860339417176,3,2,0,0
"256","D1",10,"30.05.2020","No","Wolfsburg","Ein Frankfurt",1,2,19,6,4,3,18,16,4,6,0,1,1.96,3.75,3.67,1.66,2.21,0,3,0.486209491374529,0.25412549415842,0.259665014467051,1.71275396828201,1.03312053755957,-1,13,1,-3,0.679633430722434,2,-2,-1,0
"257","D1",10,"30.05.2020","No","Bayern Munich","Fortuna Dusseldorf",5,0,23,7,8,2,9,10,0,2,0,0,1.07,12.43,30.41,1.19,4.5,3,0,0.891847560525308,0.0767720747998455,0.0313803646748464,2.75231475637577,0.170913168824385,5,16,6,3,2.58140158755138,-1,-2,0,0
"258","D1",10,"31.05.2020","No","M'gladbach","Union Berlin",4,1,16,13,10,5,13,9,3,2,0,0,1.52,4.33,6.28,1.64,2.26,3,0,0.627715860718935,0.220352911845908,0.151931227435156,2.10350049400271,0.676146594151377,3,3,5,3,1.42735389985134,4,1,0,0
"259","D1",10,"31.05.2020","No","Paderborn","Dortmund",1,6,10,16,1,11,4,6,2,3,0,0,8.5,5.49,1.33,1.43,2.77,0,3,0.111866245248707,0.173199104665575,0.714934650085719,0.508797840411695,2.31800305492273,-5,-6,-10,-3,-1.80920521451104,-2,-1,0,0
"260","D1",10,"01.06.2020","No","FC Koln","RB Leipzig",2,4,7,19,5,8,16,7,2,1,0,0,5.54,4.61,1.54,1.41,2.85,0,3,0.172439422497717,0.207226551114393,0.62033402638789,0.724544818607543,2.06822863027806,-2,-12,-3,-3,-1.34368381167052,9,1,0,0
"261","D1",10,"03.06.2020","No","Werder Bremen","Ein Frankfurt",0,3,11,12,3,4,14,21,2,1,0,0,2.78,3.4,2.53,1.74,2.08,0,3,0.342881287020576,0.280355875858,0.376762837121423,1.30899973691973,1.41064438722227,-3,-1,-1,-3,-0.101644650302542,-7,1,0,0
"262","D1",10,"05.06.2020","No","Freiburg","M'gladbach",1,0,16,18,6,4,14,14,4,3,0,1,4.42,4.01,1.76,1.62,2.3,3,0,0.216750099812659,0.238911581339639,0.544338318847701,0.889161880777617,1.87192653788274,1,-2,2,3,-0.982764657105126,0,1,-1,0
"263","D1",10,"06.06.2020","No","Ein Frankfurt","Mainz",0,2,10,17,0,5,17,15,3,3,0,0,2.05,3.65,3.51,1.54,2.47,0,3,0.466050673893669,0.261754488077266,0.272194838029066,1.65990650975827,1.07833900216446,-2,-7,-5,-3,0.581567507593808,2,0,0,0
"264","D1",10,"06.06.2020","No","Fortuna Dusseldorf","Hoffenheim",2,2,23,8,4,5,12,15,4,4,0,1,2.77,3.55,2.46,1.66,2.22,1,1,0.344080344513745,0.268479592761429,0.387440062724826,1.30072062630266,1.43079978093591,0,15,-1,0,-0.130079154633245,-3,0,-1,0
"265","D1",10,"06.06.2020","No","Leverkusen","Bayern Munich",2,4,10,16,6,10,14,4,3,3,0,0,5.86,4.95,1.48,1.31,3.42,0,3,0.16277901959303,0.19270405147781,0.64451692892916,0.6810411102569,2.12625483826529,-2,-6,-4,-3,-1.44521372800839,10,0,0,0
"266","D1",10,"06.06.2020","No","RB Leipzig","Paderborn",1,1,12,17,5,5,11,14,2,4,1,0,1.14,8.88,17.59,1.25,3.81,1,1,0.838090945674044,0.107592756539235,0.0543162977867203,2.62186559356137,0.270541649899396,0,-5,0,0,2.35132394366197,-3,-2,1,0
"267","D1",10,"06.06.2020","No","Dortmund","Hertha",1,0,12,5,3,2,7,11,0,2,0,0,1.37,5.32,7.68,1.37,3.04,3,0,0.696425284143207,0.179342601367706,0.124232114489088,2.26861845379733,0.552038944834969,1,7,1,3,1.71657950896236,-4,-2,0,0
"268","D1",10,"07.06.2020","No","Werder Bremen","Wolfsburg",0,1,14,18,4,3,17,13,3,3,0,0,3.66,3.52,2.04,1.87,1.93,0,3,0.260831662453143,0.271205649027984,0.467962688518874,1.05370063638741,1.6750937145846,-1,-4,1,-3,-0.621393078197193,4,0,0,0
"269","D1",10,"07.06.2020","No","Union Berlin","Schalke 04",1,1,12,5,6,1,19,13,3,1,0,0,2.46,3.2,3.01,2.13,1.71,1,1,0.386693752358623,0.297270822125692,0.316035425515685,1.45735207920156,1.24537709867275,0,7,5,0,0.211974980528813,6,2,0,0
"270","D1",10,"07.06.2020","No","Augsburg","FC Koln",1,1,18,9,5,2,13,21,1,3,0,0,2.77,3.51,2.47,1.72,2.12,1,1,0.343568079954665,0.271134923496986,0.385296996548349,1.30183916336098,1.42702591314203,0,9,3,0,-0.125186749781052,-8,-2,0,0
"271","D1",10,"12.06.2020","No","Hoffenheim","RB Leipzig",0,2,22,14,7,7,15,18,2,2,0,0,6.41,5.21,1.43,1.34,3.2,0,3,0.14896816208683,0.183279447020457,0.667752390892713,0.630183933280947,2.1865366196986,-2,8,0,-3,-1.55635268641765,-3,0,0,0
"272","D1",10,"13.06.2020","No","FC Koln","Union Berlin",1,2,10,7,6,5,18,17,3,0,0,0,2.04,3.46,3.7,1.77,2.06,0,3,0.467083084018038,0.27539002641526,0.257526889566702,1.67663927846937,1.04797069511537,-1,3,1,-3,0.628668583354008,1,3,0,0
"273","D1",10,"13.06.2020","No","Fortuna Dusseldorf","Dortmund",0,1,6,5,4,3,6,15,1,3,0,0,7.91,5.34,1.36,1.46,2.68,0,3,0.12051895637859,0.178521525272406,0.700959518349004,0.540078394408175,2.28140008031942,-1,1,1,-3,-1.74132168591124,-9,-2,0,0
"274","D1",10,"13.06.2020","No","Hertha","Ein Frankfurt",1,4,4,18,3,7,14,7,2,2,1,0,2.09,3.69,3.33,1.61,2.32,0,3,0.45578367551327,0.258153897512936,0.286062426973794,1.62550492405275,1.11634117843432,-3,-14,-4,-3,0.509163745618427,7,0,1,0
"275","D1",10,"13.06.2020","No","Paderborn","Werder Bremen",1,5,20,11,8,8,17,18,6,3,0,0,3.12,3.7,2.19,1.69,2.16,0,3,0.306006842951986,0.258038202705459,0.435954954342556,1.17605873156142,1.56590306573313,-4,9,0,-3,-0.389844334171709,-1,3,0,0
"276","D1",10,"13.06.2020","No","Wolfsburg","Freiburg",2,2,22,10,7,6,17,11,0,1,0,0,1.71,3.96,4.77,1.74,2.09,1,1,0.558562874251497,0.241197604790419,0.200239520958084,1.91688622754491,0.841916167664671,0,12,1,0,1.07497005988024,6,-1,0,0
"277","D1",10,"13.06.2020","No","Bayern Munich","M'gladbach",2,1,11,9,6,2,13,10,0,2,0,0,1.37,5.39,7.48,1.36,3.1,3,0,0.6957347051119,0.176837949165733,0.127427345722367,2.26404206450143,0.559119986332833,1,2,4,3,1.7049220781686,3,-2,0,0
"278","D1",10,"14.06.2020","No","Mainz","Augsburg",0,1,18,9,4,3,8,14,2,4,0,0,2.31,3.45,3.06,1.82,1.98,0,3,0.4124617602588,0.276170048173283,0.311368191567917,1.51355532894968,1.21027462287704,-1,9,1,-3,0.303280706072647,-6,-2,0,0
"279","D1",10,"14.06.2020","No","Schalke 04","Leverkusen",1,1,7,15,4,5,14,7,4,1,0,0,5.79,4.36,1.55,1.71,2.14,1,1,0.164922187866823,0.21901363939195,0.616064172741227,0.713780202992418,2.06720615761563,0,-8,-1,0,-1.35342595462321,7,3,0,0
"280","D1",10,"16.06.2020","No","M'gladbach","Wolfsburg",3,0,11,12,3,2,15,17,1,4,0,0,2.13,3.61,3.32,1.6,2.34,3,0,0.448110191766276,0.264397426166806,0.287492382066918,1.60872800146563,1.12687457236756,3,-1,1,3,0.481853429098074,-2,-3,0,0
"281","D1",10,"16.06.2020","No","Freiburg","Hertha",2,1,17,12,6,5,6,16,0,2,0,0,2.68,3.56,2.53,1.71,2.15,3,0,0.355606443461781,0.267703727100442,0.376689829437776,1.33452305748579,1.39777321541377,1,5,1,3,-0.0632501579279849,-10,-2,0,0
"282","D1",10,"16.06.2020","No","Union Berlin","Paderborn",1,0,14,10,6,2,17,16,0,0,0,0,1.67,4.06,4.95,1.7,2.17,3,0,0.571852138505621,0.235219968301573,0.192927893192806,1.95077638381844,0.81400364787999,1,4,4,3,1.13677273593845,1,0,0,0
"283","D1",10,"16.06.2020","No","Werder Bremen","Bayern Munich",0,1,6,13,1,4,9,13,2,3,0,1,13.52,7.27,1.2,1.32,3.35,0,3,0.0707896240132946,0.131647278770253,0.797563097216452,0.344016150810137,2.52433657041961,-1,-7,-3,-3,-2.18032041960947,-4,-1,-1,0
"284","D1",10,"17.06.2020","No","Ein Frankfurt","Schalke 04",2,1,14,8,4,5,9,16,3,5,0,1,1.73,4.04,4.5,1.67,2.21,3,0,0.551674748590468,0.236236959173641,0.212088292235891,1.89126120494505,0.872501835881314,1,6,-1,3,1.01875936906373,-7,-2,-1,0
"285","D1",10,"17.06.2020","No","Augsburg","Hoffenheim",1,3,12,17,5,5,10,14,2,1,0,0,2.71,3.65,2.46,1.61,2.32,0,3,0.351606094662276,0.261055483982128,0.387338421355596,1.31587376796896,1.42307074804892,-2,-5,0,-3,-0.107196980079962,-4,1,0,0
"286","D1",10,"17.06.2020","No","Dortmund","Mainz",0,2,15,10,5,6,14,13,6,3,0,0,1.26,6.25,10.55,1.38,3.01,0,3,0.756984346568242,0.152608044268158,0.0904076091636005,2.42356108397288,0.423830871758959,-2,5,-1,-3,1.99973021221392,1,3,0,0
"287","D1",10,"17.06.2020","No","Leverkusen","FC Koln",3,1,13,7,6,1,12,16,2,2,0,0,1.47,4.68,6.42,1.43,2.78,3,0,0.648056838917576,0.203556314788213,0.148386846294211,2.14772683154094,0.648716853670847,2,6,5,3,1.49900997787009,-4,0,0,0
"288","D1",10,"17.06.2020","No","RB Leipzig","Fortuna Dusseldorf",2,2,14,12,5,2,7,7,1,0,0,0,1.22,6.6,12.55,1.35,3.14,1,1,0.779994914919062,0.144180878212312,0.075824206868626,2.4841656229695,0.371653498818189,0,2,3,0,2.11251212415131,0,1,0,0
"289","D1",10,"20.06.2020","No","Bayern Munich","Freiburg",3,1,23,11,8,3,13,8,0,0,0,0,1.26,6.51,9.83,1.33,3.27,3,0,0.756585644412444,0.146435931176602,0.0969784244109542,2.41619286441393,0.437371204409465,2,12,5,3,1.97882166000447,5,0,0,0
"290","D1",10,"20.06.2020","No","FC Koln","Ein Frankfurt",1,1,4,9,2,2,8,15,1,2,0,0,2.7,3.75,2.43,1.51,2.55,1,1,0.353218210361067,0.254317111459969,0.392464678178964,1.31397174254317,1.43171114599686,0,-5,0,0,-0.117739403453689,-7,-1,0,0
"291","D1",10,"20.06.2020","No","Fortuna Dusseldorf","Augsburg",1,1,8,11,4,3,14,12,1,0,0,0,1.93,3.72,3.85,1.82,2,1,1,0.495021101129887,0.256825463758248,0.248153435111865,1.74188876714791,1.00128576909384,0,-3,1,0,0.740602998054065,2,1,0,0
"292","D1",10,"20.06.2020","No","Hertha","Leverkusen",2,0,13,12,5,2,14,15,4,3,0,0,4.99,4.24,1.63,1.51,2.56,3,0,0.190903943097852,0.224672329259029,0.584423727643119,0.797384158552586,1.97794351218839,2,1,3,3,-1.1805593536358,-1,1,0,0
"293","D1",10,"20.06.2020","No","Hoffenheim","Union Berlin",4,0,15,5,8,1,10,15,1,3,0,0,1.61,4.2,5.33,1.56,2.41,3,0,0.593331972763873,0.227443922892818,0.179224104343309,2.00743984118444,0.765116235922744,4,10,7,3,1.24232360526169,-5,-2,0,0
"294","D1",10,"20.06.2020","No","Mainz","Werder Bremen",3,1,21,19,12,6,12,15,2,3,0,0,2.55,3.55,2.66,1.71,2.13,3,0,0.373558557667583,0.26833079494432,0.358110647388097,1.38900646794707,1.34266273710861,2,2,6,3,0.0463437308384598,-3,-1,0,0
"295","D1",10,"20.06.2020","No","Paderborn","M'gladbach",1,3,11,22,1,10,11,13,4,2,1,0,9.86,6.06,1.28,1.33,3.3,0,3,0.0968036620857316,0.157505628410118,0.745690709504151,0.447916614667312,2.39457775692257,-2,-11,-9,-3,-1.94666114225526,-2,2,1,0
"296","D1",10,"20.06.2020","No","RB Leipzig","Dortmund",0,2,16,11,5,7,13,7,3,3,0,0,2.32,3.67,2.9,1.56,2.41,0,3,0.411158413623123,0.259914855478378,0.328926730898499,1.49339009634775,1.24669504817387,-2,5,-2,-3,0.246695048173874,6,0,0,0
"297","D1",10,"20.06.2020","No","Schalke 04","Wolfsburg",1,4,10,10,3,5,12,16,4,3,0,0,5.12,4.06,1.65,1.75,2.09,0,3,0.186424075115071,0.235096370588464,0.578479554296464,0.794368595933679,1.97053503347786,-3,0,-2,-3,-1.17616643754418,-4,1,0,0
"298","D1",10,"27.06.2020","No","Augsburg","RB Leipzig",1,2,5,14,1,5,11,10,4,1,0,0,7.02,5.21,1.4,1.37,3.06,0,3,0.135838290232828,0.183029711599704,0.681131998167468,0.590544582298189,2.22642570610211,-1,-9,-4,-3,-1.63588112380392,1,3,0,0
"299","D1",10,"27.06.2020","No","Dortmund","Hoffenheim",0,4,7,15,4,7,7,5,1,0,0,0,1.73,4.43,4.08,1.33,3.26,0,3,0.551104226949663,0.215216774858446,0.233678998191891,1.86852945570743,0.91625376943412,-4,-8,-3,-3,0.952275686273314,2,1,0,0
"300","D1",10,"27.06.2020","No","Ein Frankfurt","Paderborn",3,2,12,16,4,5,13,3,0,1,0,0,1.32,5.77,8.43,1.29,3.56,3,0,0.721837616921248,0.165134428827738,0.113027954251014,2.33064727959148,0.50421829158078,1,-4,-1,3,1.8264289880107,10,-1,0,0
"301","D1",10,"27.06.2020","No","Freiburg","Schalke 04",4,0,15,21,8,5,14,5,1,0,0,0,1.82,3.95,4.1,1.58,2.38,3,0,0.525027556247163,0.241911430979706,0.233061012773131,1.8169940997212,0.941094469299099,4,-6,3,3,0.875899630422097,9,1,0,0
"302","D1",10,"27.06.2020","No","Leverkusen","Mainz",1,0,13,6,2,1,10,10,1,1,0,0,1.26,6.54,9.77,1.31,3.42,3,0,0.756643267208549,0.14577530836128,0.0975814244301711,2.41570510998693,0.438519581651793,1,7,1,3,1.97718552833513,0,0,0,0
"303","D1",10,"27.06.2020","No","M'gladbach","Hertha",2,1,22,4,8,2,7,15,1,2,0,0,1.35,5.46,8.02,1.35,3.17,3,0,0.706423261576584,0.174665092148056,0.11891164627536,2.29393487687781,0.531400030974137,1,18,6,3,1.76253484590367,-8,-1,0,0
"304","D1",10,"27.06.2020","No","Union Berlin","Fortuna Dusseldorf",3,0,11,25,7,4,15,6,0,1,0,0,3.86,3.58,1.97,1.72,2.14,3,0,0.247671690851115,0.26704266108528,0.485285648063605,1.01005773363862,1.7228996052761,3,-14,3,3,-0.712841871637472,9,-1,0,0
"305","D1",10,"27.06.2020","No","Werder Bremen","FC Koln",6,1,18,6,9,2,22,16,1,2,0,0,1.62,4.36,4.93,1.41,2.85,3,0,0.588179922615106,0.218543916201026,0.193276161183869,1.98308368404634,0.798372399752631,5,12,7,3,1.18471128429371,6,-1,0,0
"306","D1",10,"27.06.2020","No","Wolfsburg","Bayern Munich",0,4,11,17,4,11,13,9,3,0,1,0,4.32,4.47,1.69,1.32,3.33,0,3,0.221109013478509,0.213689247925539,0.565201738595952,0.877016288361066,1.9092944637134,-4,-6,-7,-3,-1.03227817535233,4,3,1,0
"307","D2",10,"26.07.2019","Yes","Stuttgart","Hannover",2,1,14,7,7,2,14,15,6,3,1,1,1.74,3.85,4.41,1.67,2.18,3,0,0.541563400093777,0.244758523678746,0.213678076227477,1.86944872396008,0.885792752361176,1,7,5,3,0.983655971598901,-1,3,0,0
"308","D2",10,"27.07.2019","Yes","Dresden","Nurnberg",0,1,16,5,3,2,16,9,2,2,0,0,2.88,3.25,2.44,1.84,1.96,0,3,0.326106624117908,0.288980639218331,0.384912736663761,1.26730051157206,1.44371884920961,-1,11,1,-3,-0.176418337637557,7,0,0,0
"309","D2",10,"27.07.2019","Yes","Holstein Kiel","Sandhausen",1,1,21,15,3,3,4,22,0,4,0,0,2.06,3.54,3.37,1.68,2.17,1,1,0.455955420342144,0.265329990368592,0.278714589289263,1.63319625139503,1.10147375823638,0,6,0,0,0.531722493158643,-18,-4,0,0
"310","D2",10,"27.07.2019","Yes","Osnabruck","Heidenheim",1,3,9,9,2,6,12,13,2,1,1,0,2.53,3.16,2.82,1.96,1.83,0,3,0.370672944934819,0.29677295907756,0.332554095987621,1.40879179388202,1.29443524704042,-2,0,-4,-3,0.114356546841593,-1,1,1,0
"311","D2",10,"28.07.2019","Yes","Hamburg","Darmstadt",1,1,24,8,7,4,12,15,2,4,0,0,1.71,3.54,4.98,1.91,1.87,1,1,0.547517889087656,0.264478980322004,0.18800313059034,1.90703264758497,0.828488372093023,0,16,3,0,1.07854427549195,-3,-2,0,0
"312","D2",10,"28.07.2019","Yes","Greuther Furth","Erzgebirge Aue",0,2,23,12,7,7,9,17,1,4,0,0,2.2,3.25,3.3,2.01,1.79,0,3,0.426695842450766,0.288840262582057,0.284463894967177,1.56892778993435,1.14223194748359,-2,11,0,-3,0.426695842450766,-8,-3,0,0
"313","D2",10,"28.07.2019","Yes","Regensburg","Bochum",3,1,17,16,6,4,13,9,2,2,0,0,2.34,3.4,2.9,1.69,2.14,3,0,0.400780424355743,0.27583123323307,0.323388342411186,1.4781725063003,1.24599626046663,2,1,2,3,0.232176245833672,4,0,0,0
"314","D2",10,"28.07.2019","Yes","Wehen","Karlsruhe",1,2,16,12,4,4,9,17,2,2,0,0,2.4,3.27,2.91,1.86,1.92,0,3,0.39082541677448,0.286844342586774,0.322330240638746,1.45932059291021,1.25383506450301,-1,4,0,-3,0.205485528407201,-8,0,0,0
"315","D2",10,"29.07.2019","Yes","Bielefeld","St Pauli",1,1,22,5,5,3,8,15,2,2,0,0,2.21,3.37,3.14,1.76,2.04,1,1,0.423799206212528,0.27792173463789,0.298279059149582,1.54931935327547,1.17275891208664,0,17,2,0,0.376560441188839,-7,0,0,0
"316","D2",10,"02.08.2019","Yes","Bochum","Bielefeld",3,3,19,15,8,7,9,17,3,2,0,0,2.7,3.44,2.48,1.71,2.12,1,1,0.347996345124657,0.273136666231562,0.37886698864378,1.31712570160553,1.4097376321629,0,4,1,0,-0.0926119305573687,-8,1,0,0
"317","D2",10,"02.08.2019","Yes","Sandhausen","Osnabruck",0,1,13,18,4,4,15,8,4,1,0,0,2.01,3.34,3.73,1.93,1.87,0,3,0.467143376742198,0.281125205764017,0.251731417493785,1.68255533599061,1.03631945824537,-1,-5,0,-3,0.646235877745239,7,3,0,0
"318","D2",10,"02.08.2019","Yes","St Pauli","Greuther Furth",1,3,15,6,5,5,9,16,0,1,0,0,2.09,3.34,3.49,1.9,1.89,0,3,0.449518535514995,0.281285550666569,0.269195913818436,1.62984115721156,1.08887329212188,-2,9,0,-3,0.54096786508968,-7,-1,0,0
"319","D2",10,"03.08.2019","Yes","Karlsruhe","Dresden",4,2,15,15,6,5,9,14,1,3,0,0,2.09,3.39,3.43,1.85,1.94,3,0,0.449266850839403,0.276981627803643,0.273751521356954,1.62478218032185,1.0982361918745,2,0,1,3,0.526545988447347,-5,-2,0,0
"320","D2",10,"03.08.2019","Yes","Hannover","Regensburg",1,1,21,9,6,7,11,12,1,2,0,0,1.97,3.5,3.69,1.68,2.15,1,1,0.476932564726562,0.268444900717522,0.254622534555915,1.69924259489721,1.03231250438527,0,12,-1,0,0.666930090511941,-1,-1,0,0
"321","D2",10,"04.08.2019","Yes","Heidenheim","Stuttgart",2,2,15,23,5,10,8,12,0,1,0,0,3.42,3.4,2.09,1.68,2.16,1,1,0.274555865511672,0.276170900014682,0.449273234473646,1.0998384965497,1.62399060343562,0,-8,-5,0,-0.52415210688592,-4,-1,0,0
"322","D2",10,"04.08.2019","Yes","Darmstadt","Holstein Kiel",2,0,12,22,5,2,9,16,0,1,0,0,2.45,3.46,2.71,1.63,2.23,3,0,0.382826183700716,0.271076343949929,0.346097472349356,1.41955489505208,1.309368760998,2,-10,3,3,0.11018613405408,-7,-1,0,0
"323","D2",10,"04.08.2019","Yes","Erzgebirge Aue","Wehen",3,2,11,23,6,7,15,20,4,5,0,0,2.19,3.24,3.34,1.94,1.85,3,0,0.42888735643117,0.289896083513661,0.281216560055168,1.57655815280717,1.13354576367917,1,-12,-1,3,0.443012389128005,-5,-1,0,0
"324","D2",10,"05.08.2019","Yes","Nurnberg","Hamburg",0,4,9,15,0,8,13,6,1,1,0,0,2.53,3.25,2.75,1.88,1.9,0,3,0.370581527936146,0.2884834663626,0.340935005701254,1.40022805017104,1.31128848346636,-4,-6,-8,-3,0.0889395667046751,7,0,0,0
"325","D2",10,"16.08.2019","Yes","Hamburg","Bochum",1,0,14,7,6,0,8,16,1,1,0,0,1.48,4.36,6.36,1.67,2.19,3,0,0.636070026057915,0.215913678570118,0.148016295371968,2.12412375674386,0.65996256468602,1,7,6,3,1.46416119205784,-8,0,0,0
"326","D2",10,"16.08.2019","Yes","Sandhausen","Nurnberg",3,2,15,11,6,6,14,16,3,3,0,0,2.64,3.14,2.73,2.11,1.72,3,0,0.356151065686152,0.299439112551415,0.344409821762433,1.36789230960987,1.33266857783871,1,4,0,3,0.0352237317711581,-2,0,0,0
"327","D2",10,"17.08.2019","Yes","Bielefeld","Erzgebirge Aue",3,1,14,12,5,8,17,16,1,3,0,0,1.7,3.78,4.75,1.78,2.02,3,0,0.553210500369731,0.248798373182154,0.197991126448114,1.90842987429135,0.842771752526497,2,2,-3,3,1.06565812176485,1,-2,0,0
"328","D2",10,"17.08.2019","Yes","Stuttgart","St Pauli",2,1,17,15,5,2,11,17,0,2,0,0,1.48,4.39,6.25,1.6,2.31,3,0,0.635352335433614,0.214196231535706,0.15045143303068,2.12025323783655,0.665550530627746,1,2,3,3,1.4547027072088,-6,-2,0,0
"329","D2",10,"17.08.2019","Yes","Wehen","Hannover",0,3,14,11,5,6,12,8,4,1,0,0,2.91,3.34,2.37,1.77,2.04,0,3,0.32267374316706,0.28113191395693,0.39619434287601,1.24915314345811,1.46971494258496,-3,3,-1,-3,-0.220561799126851,4,3,0,0
"330","D2",10,"18.08.2019","Yes","Dresden","Heidenheim",2,1,17,13,5,6,11,15,0,1,0,0,2.7,3.31,2.54,1.85,1.94,3,0,0.347378772353155,0.283360327901365,0.36926089974548,1.32549664496083,1.3911430271378,1,4,-1,3,-0.0656463821769742,-4,-1,0,0
"331","D2",10,"18.08.2019","Yes","Greuther Furth","Regensburg",1,0,15,4,7,1,19,14,0,2,0,0,2.55,3.32,2.69,1.77,2.03,3,0,0.368184760247853,0.282792511636152,0.349022728115995,1.38734679237971,1.32986069598414,1,11,6,3,0.0574860963955757,5,-2,0,0
"332","D2",10,"18.08.2019","Yes","Holstein Kiel","Karlsruhe",2,1,20,17,7,2,15,13,0,2,1,0,2.09,3.57,3.25,1.58,2.35,3,0,0.44873009672691,0.262701933377939,0.288567969895151,1.60889222355867,1.12840584306339,1,3,5,3,0.480486380495276,2,-2,1,0
"333","D2",10,"19.08.2019","Yes","Osnabruck","Darmstadt",4,0,21,8,8,1,16,16,3,4,0,0,2.41,3.23,2.93,1.91,1.88,3,0,0.389308706472778,0.290474917213435,0.320216376313787,1.45840103663177,1.2511240461548,4,13,7,3,0.207276990476974,0,-1,0,0
"334","D2",10,"23.08.2019","Yes","Darmstadt","Dresden",0,0,11,11,2,2,10,16,2,2,0,0,2.39,3.31,2.9,1.86,1.94,1,1,0.392743311416519,0.283582028485039,0.323674660098442,1.4618119627346,1.25460600878036,0,0,0,0,0.207205953954232,-6,0,0,0
"335","D2",10,"23.08.2019","Yes","Erzgebirge Aue","Stuttgart",0,0,10,12,0,5,12,9,1,6,0,1,4.07,3.94,1.77,1.62,2.28,1,1,0.230817349860162,0.238433150743873,0.530749499395965,0.930885200324358,1.83068164893177,0,-2,-5,0,-0.899796448607411,3,-5,-1,0
"336","D2",10,"24.08.2019","Yes","Bochum","Wehen",3,3,23,16,9,7,12,9,3,1,1,0,2.01,3.58,3.47,1.64,2.24,1,1,0.467136212024924,0.262274800606172,0.270588987368904,1.66368343668094,1.07404176271288,0,7,2,0,0.589641673968059,3,2,1,0
"337","D2",10,"24.08.2019","Yes","Hannover","Greuther Furth",1,1,11,17,2,6,18,18,3,4,0,0,1.76,3.76,4.33,1.71,2.12,1,1,0.533460903300218,0.249705103672442,0.21683399302734,1.85008781357309,0.900207082754463,0,-6,-4,0,0.949880730818632,0,-1,0,0
"338","D2",10,"24.08.2019","Yes","Regensburg","Bielefeld",1,3,10,14,3,4,14,8,4,1,0,0,2.68,3.43,2.49,1.63,2.26,0,3,0.349938335593679,0.273421206819551,0.376640457586771,1.32323621360059,1.40334257957986,-2,-4,-1,-3,-0.080106365979276,6,3,0,0
"339","D2",10,"25.08.2019","Yes","Heidenheim","Sandhausen",0,2,13,15,2,4,9,8,1,0,0,0,2.12,3.5,3.24,1.75,2.05,0,3,0.442470970158572,0.268010987638906,0.289518042202522,1.59542389811462,1.13656511424647,-2,-2,-2,-3,0.458858783868148,1,1,0,0
"340","D2",10,"25.08.2019","Yes","Karlsruhe","Hamburg",2,4,21,16,7,7,10,13,2,3,0,0,3.18,3.46,2.16,1.77,2.03,0,3,0.294872401874911,0.271009895364803,0.434117702760286,1.15562710098954,1.57336300364566,-2,5,0,-3,-0.417735902656124,-3,-1,0,0
"341","D2",10,"25.08.2019","Yes","Nurnberg","Osnabruck",1,0,16,7,7,2,16,8,2,2,0,0,2.16,3.38,3.26,1.87,1.93,3,0,0.434474709398609,0.277652477012129,0.287872813589262,1.58107660520796,1.14127091777992,1,9,5,3,0.43980568742804,8,0,0,0
"342","D2",10,"26.08.2019","Yes","St Pauli","Holstein Kiel",2,1,11,13,2,6,14,7,4,3,1,0,2.9,3.47,2.3,1.61,2.28,3,0,0.322934369183459,0.269887513150441,0.4071781176661,1.23869062070082,1.49142186614874,1,-2,-4,3,-0.252731245447924,7,1,1,0
"343","D2",10,"30.08.2019","Yes","Nurnberg","Heidenheim",2,2,27,8,7,2,9,9,2,3,0,0,2.15,3.44,3.27,1.76,2.05,1,1,0.438117568246525,0.273823480154078,0.288058951599397,1.58817618489365,1.13800033495227,0,19,5,0,0.450175849941383,0,-1,0,0
"344","D2",10,"30.08.2019","Yes","Sandhausen","Darmstadt",1,0,16,16,5,3,20,12,2,5,0,1,1.91,3.46,4.03,2,1.81,3,0,0.493591082383176,0.272473689986088,0.233935227630736,1.75324693713562,0.974279372878296,1,0,2,3,0.77896756425732,8,-3,-1,0
"345","D2",10,"31.08.2019","Yes","Bielefeld","Greuther Furth",2,2,19,13,6,5,13,13,0,3,0,0,1.71,3.88,4.5,1.69,2.15,1,1,0.549232772776174,0.242058773568881,0.208708453654946,1.8897570918974,0.868184134533718,0,6,1,0,1.02157295736368,0,-3,0,0
"346","D2",10,"31.08.2019","Yes","Dresden","St Pauli",3,3,13,8,8,3,7,18,1,2,1,0,2.06,3.46,3.45,1.77,2.05,1,1,0.456105091014688,0.271553898118571,0.272341010866741,1.63986917116263,1.08857693071879,0,5,5,0,0.55129224044384,-11,-1,1,0
"347","D2",10,"31.08.2019","Yes","Wehen","Regensburg",0,5,11,14,2,9,12,8,1,0,0,0,2.36,3.53,2.79,1.59,2.33,0,3,0.397703915780632,0.26588703717912,0.336409047040248,1.45899878452102,1.27511417829986,-5,-3,-7,-3,0.183884606221153,4,1,0,0
"348","D2",10,"01.09.2019","Yes","Hamburg","Hannover",3,0,20,9,8,4,11,19,0,0,0,0,1.73,3.8,4.46,1.71,2.12,3,0,0.542547810665284,0.247002029592353,0.210450159742363,1.8746454615882,0.878352508819443,3,11,4,3,0.996292952768761,-8,0,0,0
"349","D2",10,"01.09.2019","Yes","Holstein Kiel","Erzgebirge Aue",1,1,12,21,3,6,10,12,3,3,0,0,1.66,4.04,4.68,1.55,2.4,1,1,0.566382285276074,0.23272143404908,0.200896280674847,1.9318682898773,0.83541027607362,0,-9,-3,0,1.09645801380368,-2,0,0,0
"350","D2",10,"01.09.2019","Yes","Osnabruck","Karlsruhe",3,0,20,10,7,3,19,16,2,3,0,0,2.35,3.34,2.93,1.85,1.94,3,0,0.399099536310138,0.280803565966714,0.320096897723148,1.47810217489713,1.24109425913616,3,10,4,3,0.237007915760969,3,-1,0,0
"351","D2",10,"02.09.2019","Yes","Stuttgart","Bochum",2,1,17,13,6,5,7,6,0,1,0,0,1.51,4.33,5.83,1.57,2.37,3,0,0.621993076345,0.216907516231166,0.161099407423834,2.08288674526617,0.700205738502667,1,4,1,3,1.3826810067635,1,-1,0,0
"352","D2",10,"13.09.2019","Yes","Greuther Furth","Wehen",2,1,21,9,6,1,10,19,4,1,0,0,1.93,3.73,3.65,1.59,2.33,3,0,0.48871235807437,0.252872614231511,0.258415027694119,1.71900968845462,1.02811769731387,1,12,5,3,0.690891991140754,-9,3,0,0
"353","D2",10,"13.09.2019","Yes","Karlsruhe","Sandhausen",1,0,14,17,5,5,12,12,2,3,0,0,2.46,3.47,2.73,1.72,2.11,3,0,0.383136974167951,0.271618719438951,0.345244306393098,1.4210296419428,1.30735163861825,1,-3,0,3,0.113678003324557,0,-1,0,0
"354","D2",10,"14.09.2019","Yes","Hannover","Bielefeld",0,2,13,7,4,4,13,15,5,1,1,0,2.31,3.48,2.9,1.65,2.22,0,3,0.406447091800981,0.269796776454099,0.323756131744919,1.48913805185704,1.24106517168886,-2,6,0,-3,0.248072880168185,-2,4,1,0
"355","D2",10,"14.09.2019","Yes","Heidenheim","Holstein Kiel",3,0,15,14,6,1,12,11,1,1,0,0,2.37,3.61,2.73,1.45,2.68,3,0,0.396095831775926,0.260040753825193,0.343863414398881,1.44832824915297,1.29163099702184,3,1,5,3,0.156697252131136,1,0,0,0
"356","D2",10,"14.09.2019","Yes","Regensburg","Stuttgart",2,3,14,24,5,7,22,9,4,0,0,0,3.3,3.71,2.03,1.51,2.52,0,3,0.284486633702636,0.253047410031994,0.462465956265369,1.1065073111399,1.6404452788281,-1,-10,-2,-3,-0.533937967688199,13,4,0,0
"357","D2",10,"15.09.2019","Yes","Bochum","Dresden",2,2,23,7,7,5,11,15,2,3,0,0,2.23,3.48,3.03,1.66,2.21,1,1,0.420737619554938,0.269610601036642,0.30965177940842,1.53182345970146,1.1985659392619,0,16,2,0,0.333257520439555,-4,-1,0,0
"358","D2",10,"15.09.2019","Yes","Darmstadt","Nurnberg",3,3,12,26,6,7,19,10,1,1,0,0,2.84,3.3,2.43,1.9,1.9,1,1,0.330105959937758,0.284091189764616,0.385802850297626,1.27440906957789,1.44149974065749,0,-14,-1,0,-0.167090671079606,9,0,0,0
"359","D2",10,"15.09.2019","Yes","Erzgebirge Aue","Osnabruck",1,0,22,14,6,3,16,14,2,5,1,0,2.61,3.34,2.62,1.86,1.94,3,0,0.360020406148175,0.281333311391239,0.358646282460586,1.36139452983576,1.357272158773,1,8,3,3,0.00412237106276536,2,-3,1,0
"360","D2",10,"16.09.2019","Yes","St Pauli","Hamburg",2,0,10,14,4,5,10,9,2,2,0,0,4.03,3.8,1.81,1.66,2.19,3,0,0.233260870302479,0.247379291399735,0.519359838297786,0.947161902307173,1.80545880629309,2,-4,-1,3,-0.858296903985919,1,0,0,0
"361","D2",10,"20.09.2019","Yes","Heidenheim","Darmstadt",1,0,9,13,5,2,11,12,2,0,0,0,1.88,3.76,3.77,1.64,2.25,3,0,0.500331785003318,0.250165892501659,0.249502322495023,1.75116124751161,0.998672859986729,1,-4,3,3,0.752488387524884,-1,2,0,0
"362","D2",10,"20.09.2019","Yes","Holstein Kiel","Hannover",1,2,9,11,5,3,16,15,2,2,0,0,2.19,3.7,2.99,1.53,2.46,0,3,0.430230885000836,0.254650172473468,0.315118942525696,1.54534282747598,1.20000700005056,-1,-2,2,-3,0.34533582742542,1,0,0,0
"363","D2",10,"21.09.2019","Yes","Nurnberg","Karlsruhe",1,1,16,13,7,3,12,13,0,0,0,0,1.99,3.5,3.66,1.77,2.05,1,1,0.473420453537534,0.269173343582769,0.257406202879697,1.68943470419537,1.04139195222186,0,3,4,0,0.648042751973509,-1,0,0,0
"364","D2",10,"21.09.2019","Yes","Sandhausen","Bochum",1,1,20,14,6,5,15,12,1,4,0,0,2.04,3.39,3.58,1.77,2.04,1,1,0.460489470688674,0.277108708025043,0.262401821286283,1.65857712009106,1.06431417188389,0,6,1,0,0.594262948207172,3,-3,0,0
"365","D2",10,"21.09.2019","Yes","Stuttgart","Greuther Furth",2,0,16,15,5,3,20,16,1,4,0,0,1.52,4.35,5.68,1.51,2.54,3,0,0.618417364142405,0.216090665171599,0.165491970685996,2.07134275759881,0.712566577229586,2,1,2,3,1.35877618036923,4,-3,0,0
"366","D2",10,"21.09.2019","Yes","Wehen","Bielefeld",2,5,11,10,6,8,13,11,2,2,1,0,3.73,3.7,1.9,1.52,2.5,0,3,0.251808868830145,0.253850562361201,0.494340568808654,1.00927716885164,1.73687226878716,-3,1,-2,-3,-0.727595099935525,2,0,1,0
"367","D2",10,"22.09.2019","Yes","Dresden","Regensburg",2,1,10,17,7,3,18,17,1,3,0,0,2.24,3.61,2.92,1.56,2.39,3,0,0.418826782791119,0.259881438629392,0.321291778579489,1.51636178700275,1.22375677436786,1,-7,4,3,0.292605012634891,1,-2,0,0
"368","D2",10,"22.09.2019","Yes","Hamburg","Erzgebirge Aue",4,0,9,9,5,2,6,14,1,3,0,0,1.42,4.55,7.23,1.64,2.24,3,0,0.66291378584196,0.206887379317711,0.13019883484033,2.19562873684359,0.597483883838699,4,0,3,3,1.59814485300489,-8,-2,0,0
"369","D2",10,"22.09.2019","Yes","Osnabruck","St Pauli",1,1,16,13,5,3,16,16,2,4,0,1,2.17,3.47,3.16,1.78,2.04,1,1,0.432513026431527,0.270476445924038,0.297010527644435,1.56801552521862,1.16150802885734,0,3,2,0,0.406507496361277,0,-2,-1,0
"370","D2",10,"27.09.2019","Yes","Bielefeld","Stuttgart",0,1,10,11,2,4,12,5,3,1,1,0,2.69,3.48,2.48,1.52,2.47,0,3,0.349935935903466,0.270496456201242,0.379567607895292,1.32030426391164,1.40919927988712,-1,-1,-2,-3,-0.0888950159754769,7,2,1,0
"371","D2",10,"27.09.2019","Yes","Wehen","Osnabruck",2,0,15,4,4,0,20,9,3,1,0,0,2.9,3.65,2.25,1.54,2.44,3,0,0.324316319478724,0.257675979859808,0.418007700661467,1.23062493829598,1.51169908184421,2,11,4,3,-0.281074143548228,11,2,0,0
"372","D2",10,"28.09.2019","Yes","Bochum","Darmstadt",2,2,15,10,5,6,19,12,2,1,0,0,1.99,3.56,3.58,1.74,2.09,1,1,0.472845726327662,0.264315448143833,0.262838825528505,1.68285262712682,1.05283192472935,0,5,-1,0,0.630020702397471,7,1,0,0
"373","D2",10,"28.09.2019","Yes","Karlsruhe","Heidenheim",1,1,17,10,3,2,11,12,2,3,0,0,2.22,3.48,3.06,1.68,2.16,1,1,0.423115434129595,0.269918466599914,0.306966099270491,1.5392647689887,1.19081676441139,0,7,1,0,0.348448004577314,-1,-1,0,0
"374","D2",10,"28.09.2019","Yes","Regensburg","Hamburg",2,2,8,14,2,3,23,11,4,1,0,0,3.72,3.88,1.86,1.55,2.42,1,1,0.252604166666667,0.2421875,0.505208333333333,1,1.7578125,0,-6,-1,0,-0.7578125,12,3,0,0
"375","D2",10,"29.09.2019","Yes","Erzgebirge Aue","Dresden",4,1,12,9,7,2,14,10,3,2,0,0,2.45,3.46,2.73,1.7,2.14,3,0,0.383799311698285,0.271765408572485,0.34443527972923,1.42316334366734,1.30507124776018,3,3,5,3,0.118092095907165,4,1,0,0
"376","D2",10,"29.09.2019","Yes","Greuther Furth","Holstein Kiel",0,3,6,18,2,9,14,13,1,1,0,0,2.35,3.56,2.79,1.55,2.42,0,3,0.399615367593513,0.263791043214819,0.336593589191668,1.46263714599536,1.27357181078982,-3,-12,-7,-3,0.189065335205533,1,0,0,0
"377","D2",10,"29.09.2019","Yes","St Pauli","Sandhausen",2,0,21,18,7,4,13,18,2,1,0,0,2.38,3.41,2.85,1.76,2.06,3,0,0.39478334342109,0.275537934704456,0.329678721874454,1.45988796496773,1.26457410032782,2,3,3,3,0.195313864639908,-5,1,0,0
"378","D2",10,"30.09.2019","Yes","Hannover","Nurnberg",0,4,10,8,0,4,6,15,3,1,0,0,2.25,3.41,3.03,1.75,2.07,0,3,0.416250710047014,0.274652228036886,0.3090970619161,1.52340435817793,1.20194341378519,-4,2,-4,-3,0.321460944392743,-9,2,0,0
"379","D2",10,"04.10.2019","Yes","Darmstadt","Karlsruhe",1,1,21,8,5,2,4,8,1,2,0,0,2.46,3.31,2.83,1.87,1.93,1,1,0.382780926539636,0.284483709754533,0.332735363705832,1.43282648937344,1.28268980087203,0,13,3,0,0.150136688501412,-4,-1,0,0
"380","D2",10,"04.10.2019","Yes","Stuttgart","Wehen",1,2,30,6,6,4,10,9,1,3,0,1,1.32,5.6,8.12,1.33,3.24,0,3,0.715166461159063,0.168574951558922,0.116258587282015,2.31407433503611,0.517350713404968,-1,24,2,-3,1.79672362163114,1,-2,-1,0
"381","D2",10,"05.10.2019","Yes","Dresden","Hannover",0,2,10,18,2,9,8,17,1,5,1,1,2.46,3.48,2.7,1.66,2.2,0,3,0.381969852187912,0.270013171374213,0.348016976437875,1.41592272793795,1.31406410068784,-2,-8,-7,-3,0.10185862725011,-9,-4,0,0
"382","D2",10,"05.10.2019","Yes","Hamburg","Greuther Furth",2,0,21,12,8,3,9,16,1,3,0,0,1.42,4.58,6.96,1.58,2.35,3,0,0.660472902974498,0.204775441533578,0.134751655491924,2.18619415045707,0.609030408009349,2,9,5,3,1.57716374244772,-7,-2,0,0
"383","D2",10,"05.10.2019","Yes","Sandhausen","Erzgebirge Aue",2,2,21,12,9,5,10,17,2,3,0,0,2.04,3.45,3.55,1.83,1.98,1,1,0.46169069833192,0.272999717274526,0.265309584393554,1.65807181227029,1.06892847045519,0,9,4,0,0.589143341815097,-7,-1,0,0
"384","D2",10,"06.10.2019","Yes","Heidenheim","Bochum",2,3,20,8,6,4,12,13,0,3,0,0,2.14,3.51,3.2,1.59,2.31,0,3,0.438897442109459,0.267589893479841,0.2935126644107,1.58428221980822,1.14812788671194,-1,12,2,-3,0.436154333096274,-1,-3,0,0
"385","D2",10,"06.10.2019","Yes","Holstein Kiel","Regensburg",1,2,20,6,5,3,11,10,1,1,0,0,1.97,3.87,3.38,1.41,2.86,0,3,0.478037941607493,0.24334231136092,0.278619747031586,1.6774561361834,1.07920155245568,-1,14,2,-3,0.598254583727721,1,0,0,0
"386","D2",10,"06.10.2019","Yes","Nurnberg","St Pauli",1,1,21,10,7,2,12,10,3,1,0,0,2.05,3.62,3.32,1.64,2.23,1,1,0.457924055263017,0.2593216335053,0.282754311231682,1.63309379929435,1.10758456720035,0,11,5,0,0.525509232094005,2,2,0,0
"387","D2",10,"07.10.2019","Yes","Osnabruck","Bielefeld",0,1,9,14,1,4,9,15,2,2,1,0,2.75,3.49,2.4,1.64,2.23,0,3,0.340854986062221,0.268582009074816,0.390563004862962,1.29114696726148,1.4402710236637,-1,-5,-3,-3,-0.149124056402222,-6,0,1,0
"388","D2",10,"18.10.2019","Yes","Erzgebirge Aue","Nurnberg",4,3,9,17,6,5,15,15,3,2,0,1,2.69,3.5,2.46,1.68,2.17,3,0,0.349397785929942,0.26853715547187,0.382065058598189,1.3167305132617,1.41473233126644,1,-8,1,3,-0.0980018180047399,0,1,-1,0
"389","D2",10,"18.10.2019","Yes","Greuther Furth","Dresden",2,0,11,11,3,1,12,18,1,3,0,0,2.28,3.41,3.03,1.74,2.07,3,0,0.413035917731007,0.276164777837741,0.310799304431253,1.51527253103076,1.2085626911315,2,0,2,3,0.306709839899262,-6,-2,0,0
"390","D2",10,"19.10.2019","Yes","Regensburg","Sandhausen",1,0,7,16,2,1,10,20,0,4,0,0,2.28,3.53,2.92,1.56,2.4,3,0,0.412079828573256,0.266159209390092,0.321760962036652,1.50239869510986,1.23144209550005,1,-9,1,3,0.270956599609812,-10,-4,0,0
"391","D2",10,"19.10.2019","Yes","St Pauli","Darmstadt",0,1,20,16,4,6,14,12,2,2,0,0,1.94,3.52,3.79,1.79,2.02,0,3,0.484728691747026,0.267151608519668,0.248119699733306,1.72133768376075,1.01151070771959,-1,4,-2,-3,0.70982697604116,2,0,0,0
"392","D2",10,"19.10.2019","Yes","Wehen","Heidenheim",0,0,9,10,3,1,14,8,2,3,0,0,2.85,3.62,2.28,1.54,2.43,1,1,0.329240563892678,0.259208731241473,0.411550704865848,1.24693042291951,1.49386084583902,0,-1,2,0,-0.246930422919509,6,-1,0,0
"393","D2",10,"20.10.2019","Yes","Bochum","Karlsruhe",3,3,19,18,7,6,14,11,2,4,0,1,2,3.49,3.62,1.7,2.14,1,1,0.470466004811237,0.269608025679792,0.259925969508971,1.6810060401135,1.0493859342067,0,1,1,0,0.631620105906799,3,-2,-1,0
"394","D2",10,"20.10.2019","Yes","Hannover","Osnabruck",0,0,20,9,4,4,9,13,2,2,0,0,1.78,3.66,4.34,1.83,1.97,1,1,0.527293489662865,0.256443281857896,0.216263228479239,1.83832375084649,0.905232967295614,0,11,0,0,0.933090783550876,-4,0,0,0
"395","D2",10,"20.10.2019","Yes","Stuttgart","Holstein Kiel",0,1,18,12,4,3,13,8,3,2,1,0,1.65,4.06,4.72,1.44,2.74,0,3,0.569482499361074,0.231439932006348,0.199077568632579,1.93988743008957,0.828672637904084,-1,6,1,-3,1.11121479218548,5,1,1,0
"396","D2",10,"21.10.2019","Yes","Bielefeld","Hamburg",1,1,14,15,7,3,8,5,2,0,0,0,2.87,3.46,2.34,1.7,2.12,1,1,0.327227754785308,0.271428802379721,0.401343442834972,1.25311206673564,1.47545913088464,0,-1,4,0,-0.222347064148991,3,2,0,0
"397","D2",10,"25.10.2019","Yes","Darmstadt","Erzgebirge Aue",1,0,9,9,1,2,9,7,4,0,0,0,2.21,3.37,3.19,1.82,1.98,3,0,0.425789867672163,0.279227183250884,0.294982949076953,1.55659678626737,1.16417603048174,1,0,-1,3,0.39242075578563,2,4,0,0
"398","D2",10,"25.10.2019","Yes","Holstein Kiel","Bochum",2,1,15,11,5,3,8,21,4,5,0,0,1.95,3.8,3.5,1.44,2.74,3,0,0.483021608861449,0.247866351915744,0.269112039222807,1.69693117850009,1.05520246958417,1,4,2,3,0.641728708915925,-13,-1,0,0
"399","D2",10,"26.10.2019","Yes","Dresden","Bielefeld",0,1,5,14,1,7,13,9,3,2,0,0,3.31,3.54,2.09,1.65,2.22,0,3,0.284190997122982,0.265726610304257,0.450082392572761,1.1182996016732,1.61597378802254,-1,-9,-6,-3,-0.497674186349337,4,1,0,0
"400","D2",10,"26.10.2019","Yes","Hamburg","Stuttgart",6,2,13,13,6,5,9,14,1,3,0,0,2.02,3.54,3.5,1.66,2.21,3,0,0.46560043290694,0.265681602958197,0.268717964134862,1.66248290167902,1.07183549536278,4,0,1,3,0.590647406316233,-5,-2,0,0
"401","D2",10,"26.10.2019","Yes","Karlsruhe","Hannover",3,3,20,13,7,7,15,16,3,4,0,1,2.69,3.37,2.53,1.79,2.02,1,1,0.349471863459182,0.278955285669198,0.37157285087162,1.32737087604674,1.39367383828406,0,7,0,0,-0.066302962237315,-1,-1,-1,0
"402","D2",10,"27.10.2019","Yes","Heidenheim","St Pauli",1,0,12,15,2,4,14,14,0,2,0,0,2.18,3.4,3.2,1.7,2.14,3,0,0.430584138040209,0.276080417919899,0.293335444039892,1.56783283204053,1.15608675003958,1,-3,-2,3,0.41174608200095,0,-2,0,0
"403","D2",10,"27.10.2019","Yes","Nurnberg","Regensburg",1,1,13,14,2,4,10,13,0,4,0,0,1.93,3.7,3.63,1.52,2.49,1,1,0.48702040401916,0.254040372907292,0.258939223073548,1.71510158496477,1.03085804212794,0,-1,-2,0,0.684243542836837,-3,-4,0,0
"404","D2",10,"27.10.2019","Yes","Osnabruck","Greuther Furth",0,0,13,14,4,3,21,17,4,3,0,0,2.25,3.34,3.12,1.84,1.95,1,1,0.417570264227154,0.281297333685957,0.30113240208689,1.53400812636742,1.18469453994663,0,-1,1,0,0.349313586420792,4,1,0,0
"405","D2",10,"28.10.2019","Yes","Sandhausen","Wehen",0,0,11,5,1,1,10,12,2,2,1,0,1.88,3.68,3.82,1.56,2.39,1,1,0.499247094922863,0.255050146319289,0.245702758757849,1.75279143108788,0.992158422592835,0,6,0,0,0.760633008495042,-2,0,1,0
"406","D2",10,"01.11.2019","Yes","Hannover","Sandhausen",1,1,15,17,1,6,15,9,3,0,0,0,1.98,3.43,3.74,1.93,1.87,1,1,0.47468251383914,0.274014978834256,0.251302507326604,1.69806252035168,1.02792250081407,0,-2,-5,0,0.67014001953761,6,3,0,0
"407","D2",10,"01.11.2019","Yes","Regensburg","Osnabruck",3,3,16,18,6,9,19,12,4,2,0,0,2.19,3.41,3.19,1.76,2.07,1,1,0.429415085327196,0.275782708758522,0.294802205914282,1.56402796474011,1.16018932650137,0,-2,-3,0,0.403838638238743,7,2,0,0
"408","D2",10,"02.11.2019","Yes","Erzgebirge Aue","Heidenheim",1,1,8,13,2,5,16,19,3,5,0,0,2.44,3.31,2.83,1.82,1.99,1,1,0.384711424335391,0.283593920053883,0.331694655610726,1.43772819306006,1.27867788688606,0,-5,-3,0,0.159050306173995,-3,-2,0,0
"409","D2",10,"02.11.2019","Yes","Greuther Furth","Darmstadt",3,1,19,11,6,3,16,12,2,2,0,0,2.1,3.32,3.47,1.9,1.9,3,0,0.446883946096496,0.282667556265856,0.270448497637649,1.62331939455534,1.0940130491788,2,8,3,3,0.529306345376541,4,0,0,0
"410","D2",10,"02.11.2019","Yes","St Pauli","Karlsruhe",2,2,19,14,8,4,11,15,2,3,0,0,2.15,3.42,3.27,1.75,2.07,1,1,0.437417129178743,0.274984452553888,0.287598418267369,1.58723584009012,1.137779707356,0,5,4,0,0.449456132734121,-4,-1,0,0
"411","D2",10,"03.11.2019","Yes","Bielefeld","Holstein Kiel",2,1,10,13,4,5,9,9,2,2,0,0,1.84,3.94,3.72,1.51,2.51,3,0,0.509780461337266,0.238070063162581,0.252149475500153,1.76741144717438,0.99451848966304,1,-3,-1,3,0.772892957511339,0,0,0,0
"412","D2",10,"03.11.2019","Yes","Stuttgart","Dresden",3,1,16,10,5,4,10,11,2,3,0,0,1.47,4.42,6.27,1.5,2.52,3,0,0.638150304989672,0.212235508673036,0.149614186337292,2.12668642364205,0.661078067684911,2,6,1,3,1.46560835595714,-1,-1,0,0
"413","D2",10,"03.11.2019","Yes","Wehen","Hamburg",1,1,9,20,2,7,18,4,1,0,1,0,4.8,4.09,1.64,1.51,2.51,1,1,0.196062154357002,0.230097393866408,0.57384045177659,0.818283856937413,1.95161874919618,0,-11,-5,0,-1.13333489225877,14,1,1,0
"414","D2",10,"04.11.2019","Yes","Bochum","Nurnberg",3,1,11,12,4,5,11,16,2,3,0,0,2.67,3.44,2.49,1.64,2.24,3,0,0.351067884764352,0.272485829163029,0.376446286072619,1.32568948345609,1.40182468738089,2,-1,-1,3,-0.0761352039247991,-5,-1,0,0
"415","D2",10,"08.11.2019","Yes","Dresden","Wehen",1,0,11,8,5,2,18,17,3,3,0,0,2.08,3.54,3.35,1.65,2.23,3,0,0.452802956831181,0.266053714748265,0.281143328420554,1.62446258524181,1.10948370000993,1,3,3,3,0.514978885231881,1,0,0,0
"416","D2",10,"08.11.2019","Yes","St Pauli","Bochum",1,1,13,11,4,4,12,11,1,2,0,0,1.91,3.73,3.72,1.62,2.28,1,1,0.493703989667356,0.252808209186233,0.253487801146411,1.7339201781883,1.01327161262547,0,2,0,0,0.720648565562834,1,-1,0,0
"417","D2",10,"09.11.2019","Yes","Holstein Kiel","Hamburg",1,1,9,11,2,2,12,9,2,2,0,1,3.49,3.59,2.01,1.61,2.29,1,1,0.269653474041383,0.262142235210147,0.468204290748471,1.07110265733429,1.66675510745556,0,-2,0,0,-0.595652450121264,3,0,-1,0
"418","D2",10,"09.11.2019","Yes","Osnabruck","Stuttgart",1,0,9,21,3,6,11,22,1,3,0,0,3.91,3.75,1.85,1.62,2.28,3,0,0.240605545632684,0.250871382246345,0.50852307212097,0.972688019144398,1.77644059860926,1,-12,-3,3,-0.803752579464858,-11,-2,0,0
"419","D2",10,"09.11.2019","Yes","Sandhausen","Greuther Furth",3,2,23,8,6,4,18,18,3,2,0,0,2.32,3.24,3.09,1.93,1.87,3,0,0.405373888537972,0.290267722656819,0.304358388805209,1.50638938827074,1.20334288907245,1,15,2,3,0.30304649919829,0,1,0,0
"420","D2",10,"10.11.2019","Yes","Darmstadt","Regensburg",2,2,23,7,9,2,13,12,0,2,0,0,2.35,3.37,2.92,1.72,2.11,1,1,0.399660464870705,0.278694982921708,0.321644552207588,1.47767637753382,1.24362863954447,0,16,7,0,0.234047737989351,1,-2,0,0
"421","D2",10,"10.11.2019","Yes","Heidenheim","Hannover",4,0,18,11,7,1,10,6,0,0,0,1,2.5,3.25,2.8,1.83,1.97,3,0,0.375644994840041,0.288957688338493,0.335397316821465,1.41589267285862,1.29514963880289,4,7,6,3,0.120743034055728,4,0,-1,0
"422","D2",10,"10.11.2019","Yes","Nurnberg","Bielefeld",1,5,14,9,5,6,12,8,2,2,0,0,2.91,3.46,2.32,1.7,2.15,0,3,0.323065158771683,0.271710870527629,0.405223970700688,1.24090634684268,1.48738278262969,-4,5,-1,-3,-0.246476435787017,4,0,0,0
"423","D2",10,"11.11.2019","Yes","Karlsruhe","Erzgebirge Aue",1,1,31,9,5,4,10,10,0,3,0,1,2.1,3.41,3.35,1.8,1.99,1,1,0.44589082534788,0.274595522941509,0.279513651710611,1.61226799898515,1.11313647807334,0,22,1,0,0.499131520911805,0,-3,-1,0
"424","D2",10,"22.11.2019","Yes","Bochum","Osnabruck",1,1,17,22,7,7,19,8,1,2,0,0,1.95,3.62,3.65,1.66,2.21,1,1,0.482411142956242,0.25986235601234,0.257726501031417,1.70709578488107,1.03304185910659,0,-5,0,0,0.674053925774476,11,-1,0,0
"425","D2",10,"22.11.2019","Yes","Erzgebirge Aue","St Pauli",3,1,13,14,7,5,10,12,2,1,0,0,2.66,3.34,2.57,1.85,1.95,3,0,0.353178848274387,0.281274172577805,0.365546979147809,1.34081071740096,1.37791511002123,2,-1,2,3,-0.0371043926202663,-2,1,0,0
"426","D2",10,"23.11.2019","Yes","Bielefeld","Sandhausen",1,1,13,15,2,6,8,11,1,1,0,0,1.69,3.77,4.84,1.76,2.05,1,1,0.556343889967894,0.249395536882159,0.194260573149946,1.91842720678584,0.832177256331999,0,-2,-4,0,1.08624995045384,-3,0,0,0
"427","D2",10,"23.11.2019","Yes","Hamburg","Dresden",2,1,16,12,8,4,10,13,1,3,0,0,1.33,5.1,8.58,1.52,2.49,3,0,0.70631646231623,0.184196253898154,0.109487283785616,2.30314564084684,0.512658105255002,1,4,4,3,1.79048753559184,-3,-2,0,0
"428","D2",10,"23.11.2019","Yes","Wehen","Holstein Kiel",3,6,20,13,7,10,10,7,3,2,0,0,3.3,3.58,2.07,1.6,2.3,0,3,0.284414866669737,0.26217012849445,0.453415004835813,1.11541472850366,1.62241514300189,-3,7,-3,-3,-0.507000414498227,3,1,0,0
"429","D2",10,"24.11.2019","Yes","Greuther Furth","Nurnberg",0,0,10,15,2,3,9,16,2,3,0,0,2.72,3.4,2.47,1.69,2.16,1,1,0.344683226346637,0.27574658107731,0.379570192576054,1.30979626011722,1.41445715880547,0,-5,-1,0,-0.10466089868825,-7,-1,0,0
"430","D2",10,"24.11.2019","Yes","Regensburg","Heidenheim",3,1,19,11,7,3,14,12,1,2,0,0,2.46,3.39,2.74,1.68,2.17,3,0,0.381173979415965,0.276604126655833,0.342221893928202,1.42012606490373,1.30326980844044,2,8,4,3,0.116856256463288,2,-1,0,0
"431","D2",10,"24.11.2019","Yes","Stuttgart","Karlsruhe",3,0,17,7,4,2,13,21,1,1,1,0,1.54,4.27,5.49,1.5,2.53,3,0,0.609322974472808,0.219755826859046,0.170921198668147,2.04772475027747,0.732519422863485,3,10,2,3,1.31520532741398,-8,0,1,0
"432","D2",10,"25.11.2019","Yes","Hannover","Darmstadt",1,2,17,10,4,8,16,18,5,2,1,0,1.9,3.52,3.89,1.81,1.99,0,3,0.493046903693675,0.266133271880109,0.240819824426217,1.74527398296113,0.988592745158758,-1,7,-4,-3,0.756681237802375,-2,3,1,0
"433","D2",10,"29.11.2019","Yes","Karlsruhe","Regensburg",4,1,19,16,11,5,17,12,1,1,0,0,2.22,3.58,3.01,1.55,2.42,3,0,0.424150580974273,0.263020751330415,0.312828667695311,1.53547249425324,1.20150675441635,3,3,6,3,0.333965739836886,5,0,0,0
"434","D2",10,"29.11.2019","Yes","Osnabruck","Hamburg",2,1,19,18,7,6,6,5,1,1,0,0,4.81,3.87,1.68,1.82,1.99,3,0,0.195848432543807,0.243418852851605,0.560732714604589,0.830964150483024,1.92561699666537,1,1,1,3,-1.09465284618235,1,0,0,0
"435","D2",10,"30.11.2019","Yes","Bochum","Erzgebirge Aue",2,0,16,11,4,0,13,17,2,4,0,1,1.9,3.71,3.72,1.6,2.31,3,0,0.494344191244421,0.253168184195256,0.252487624560323,1.73620075792852,1.01063105787622,2,5,4,3,0.725569700052296,-4,-2,-1,0
"436","D2",10,"30.11.2019","Yes","Dresden","Holstein Kiel",1,2,9,8,5,3,21,11,3,0,0,0,3.21,3.62,2.09,1.6,2.31,0,3,0.292173362322311,0.259081904158734,0.448744733518955,1.13560199112567,1.6053161047156,-1,1,2,-3,-0.469714113589935,10,3,0,0
"437","D2",10,"30.11.2019","Yes","Nurnberg","Wehen",0,2,24,5,4,2,13,11,1,1,0,0,1.69,3.92,4.6,1.55,2.41,0,3,0.556014652737521,0.239710398756737,0.204274948505741,1.9077543569693,0.852535244273962,-2,19,2,-3,1.05521911269534,2,0,0,0
"438","D2",10,"30.11.2019","Yes","St Pauli","Hannover",0,1,9,8,2,2,16,19,1,3,0,0,2.5,3.28,2.77,1.79,2.02,0,3,0.375273640471529,0.286031738164275,0.338694621364196,1.41185265957886,1.30211560225686,-1,1,0,-3,0.109737057321999,-3,-2,0,0
"439","D2",10,"01.12.2019","Yes","Darmstadt","Bielefeld",1,3,18,11,9,5,5,11,0,2,0,0,3.41,3.52,2.05,1.74,2.08,0,3,0.275317916649179,0.266714231753893,0.457967851596928,1.09266798170143,1.64061778654468,-2,7,4,-3,-0.547949804843245,-6,-2,0,0
"440","D2",10,"01.12.2019","Yes","Heidenheim","Greuther Furth",1,0,15,19,7,1,12,12,1,3,0,0,2.02,3.48,3.52,1.75,2.06,3,0,0.464182859914512,0.269439476157274,0.266377663928214,1.66198805590081,1.06857246794192,1,-4,6,3,0.593415587958893,0,-2,0,0
"441","D2",10,"01.12.2019","Yes","Sandhausen","Stuttgart",2,1,16,24,5,6,13,10,5,3,0,0,3.67,3.4,2.01,1.8,2,3,0,0.256063427592951,0.276397876254744,0.467538696152304,1.0445881590336,1.67901396471166,1,-8,-1,3,-0.634425805678058,3,2,0,0
"442","D2",10,"06.12.2019","Yes","Bielefeld","Karlsruhe",2,2,23,8,4,3,8,12,1,3,0,0,1.64,3.91,5.04,1.64,2.24,1,1,0.573120368539221,0.240388082967858,0.186491548492921,1.95974918858552,0.799862728446621,0,15,1,0,1.1598864601389,-4,-2,0,0
"443","D2",10,"06.12.2019","Yes","Hamburg","Heidenheim",0,1,16,9,9,2,6,11,0,0,0,0,1.53,4.11,5.93,1.66,2.21,0,3,0.613394239118125,0.228343840839594,0.158261920042282,2.06852655819397,0.703129600966439,-1,7,7,-3,1.36539695722753,-5,0,0,0
"444","D2",10,"07.12.2019","Yes","Greuther Furth","Bochum",3,1,17,9,7,2,16,14,1,3,0,0,2.51,3.42,2.66,1.68,2.17,3,0,0.373478939157566,0.274102964118565,0.352418096723869,1.39453978159126,1.33135725429017,2,8,5,3,0.0631825273010924,2,-2,0,0
"445","D2",10,"07.12.2019","Yes","Hannover","Erzgebirge Aue",3,2,22,11,5,1,24,10,2,3,0,0,1.79,3.58,4.43,1.84,1.95,3,0,0.525192649673977,0.262596324836989,0.212211025489034,1.83817427385892,0.89922940130409,1,11,4,3,0.938944872554831,14,-1,0,0
"446","D2",10,"07.12.2019","Yes","Holstein Kiel","Osnabruck",2,4,14,12,5,6,12,15,3,1,1,0,1.8,3.73,4.13,1.62,2.27,0,3,0.521265256539967,0.251548917365132,0.227185826094901,1.81534468698503,0.933106395649835,-2,2,-1,-3,0.882238291335199,-3,2,1,0
"447","D2",10,"08.12.2019","Yes","Dresden","Sandhausen",1,1,15,18,7,7,13,13,4,2,0,0,2.58,3.29,2.67,1.86,1.93,1,1,0.363572022796975,0.285111191129543,0.351316786073482,1.37582725952047,1.33906154934999,0,-3,0,0,0.0367657101704806,0,2,0,0
"448","D2",10,"08.12.2019","Yes","Regensburg","St Pauli",1,0,14,11,3,3,18,8,2,3,0,1,2.36,3.42,2.84,1.71,2.12,3,0,0.396661003659174,0.273719289074752,0.329619707266074,1.46370230005227,1.26257841087297,1,3,0,3,0.201123889179299,10,-1,-1,0
"449","D2",10,"08.12.2019","Yes","Wehen","Darmstadt",0,0,15,14,2,6,10,7,1,2,0,1,2.77,3.29,2.48,1.76,2.04,1,1,0.337965628507876,0.284548568682923,0.377485802809201,1.29844545420655,1.41700597711052,0,1,-4,0,-0.118560522903973,3,-1,-1,0
"450","D2",10,"09.12.2019","Yes","Stuttgart","Nurnberg",3,1,14,10,6,1,10,12,2,1,0,0,1.68,3.84,4.71,1.57,2.36,3,0,0.557355225205236,0.243842911027291,0.198801863767473,1.915908586643,0.840248502329709,2,4,5,3,1.07566008431329,-2,1,0,0
"451","D2",10,"13.12.2019","Yes","Bochum","Hannover",2,1,11,24,8,10,18,12,2,2,0,0,2.48,3.38,2.74,1.66,2.19,3,0,0.378954776830286,0.278049658739382,0.342995564430332,1.41491398923024,1.30703635203038,1,-13,-2,3,0.107877637199862,6,0,0,0
"452","D2",10,"13.12.2019","Yes","Erzgebirge Aue","Regensburg",1,0,12,11,4,2,10,18,0,3,0,0,2.57,3.46,2.58,1.6,2.31,3,0,0.365110267652641,0.271194620770892,0.363695111576468,1.36652542372881,1.36227995550029,1,1,2,3,0.00424546822851912,-8,-3,0,0
"453","D2",10,"14.12.2019","Yes","Heidenheim","Bielefeld",0,0,12,13,3,3,6,9,0,2,0,0,2.82,3.41,2.4,1.73,2.09,1,1,0.333113537011258,0.275478057000513,0.391408405988229,1.27481866803429,1.4497032749652,0,-1,0,0,-0.174884606930911,-3,-2,0,0
"454","D2",10,"14.12.2019","Yes","Karlsruhe","Greuther Furth",1,5,15,15,3,7,15,14,4,5,0,0,2.02,3.51,3.52,1.71,2.11,0,3,0.465254294730341,0.267753183861906,0.266992521407753,1.66351606805293,1.06873074808516,-4,0,-4,-3,0.594785319967766,1,-1,0,0
"455","D2",10,"14.12.2019","Yes","St Pauli","Wehen",3,1,12,6,6,3,4,8,1,2,0,0,1.83,3.64,4.12,1.68,2.16,3,0,0.513631257363619,0.258226703564677,0.228142039071705,1.79912047565553,0.94265282077979,2,6,3,3,0.856467654875743,-4,-1,0,0
"456","D2",10,"15.12.2019","Yes","Nurnberg","Holstein Kiel",2,2,11,13,4,4,15,14,1,1,0,0,2.35,3.55,2.8,1.57,2.36,1,1,0.399798893916541,0.264655605832076,0.335545500251383,1.4640522875817,1.27129210658622,0,-2,0,0,0.192760180995475,1,0,0,0
"457","D2",10,"15.12.2019","Yes","Osnabruck","Dresden",3,0,17,3,9,0,7,15,1,2,0,0,2,3.4,3.72,1.85,1.94,3,0,0.470395715560845,0.276703362094615,0.25290092234454,1.68789050877715,1.03540612912824,3,14,9,3,0.652484379648914,-8,-1,0,0
"458","D2",10,"15.12.2019","Yes","Sandhausen","Hamburg",1,1,12,25,5,4,9,10,1,1,0,0,3.88,3.46,1.93,1.81,1.99,1,1,0.242028197600667,0.271407342974158,0.486564459425175,0.997491935776159,1.73110072124968,0,-13,1,0,-0.733608785473524,-1,0,0,0
"459","D2",10,"16.12.2019","Yes","Darmstadt","Stuttgart",1,1,12,18,6,8,6,15,1,5,0,0,4.21,3.62,1.81,1.69,2.14,1,1,0.222769230769231,0.259076923076923,0.518153846153846,0.927384615384615,1.81353846153846,0,-6,-2,0,-0.886153846153846,-9,-4,0,0
"460","D2",10,"20.12.2019","Yes","Karlsruhe","Wehen",0,1,19,8,2,5,7,19,2,3,0,0,1.77,3.85,4.2,1.57,2.38,0,3,0.531584397652744,0.244390749050742,0.224024853296514,1.83914394200898,0.916465308940283,-1,11,-3,-3,0.922678633068692,-12,-1,0,0
"461","D2",10,"20.12.2019","Yes","Nurnberg","Dresden",2,0,15,8,3,2,12,10,3,4,0,0,1.67,3.94,4.75,1.63,2.25,3,0,0.563241671757862,0.238734414171479,0.198023914070659,1.92845942944506,0.832806156383456,2,7,1,3,1.09565327306161,2,-1,0,0
"462","D2",10,"21.12.2019","Yes","Darmstadt","Hamburg",2,2,11,16,5,6,18,12,0,1,0,0,4.29,3.59,1.81,1.82,1.97,1,1,0.219050765408459,0.261762613816794,0.519186620774746,0.918914910042172,1.81932247614103,0,-5,-1,0,-0.900407566098861,6,-1,0,0
"463","D2",10,"21.12.2019","Yes","Erzgebirge Aue","Greuther Furth",3,1,16,10,8,3,12,19,1,4,0,0,2.54,3.3,2.72,1.84,1.95,3,0,0.369888077538035,0.284701732408064,0.345410190053901,1.39436596502217,1.32093230256977,2,6,5,3,0.0734336624524041,-7,-3,0,0
"464","D2",10,"21.12.2019","Yes","Hannover","Stuttgart",2,2,17,14,6,5,14,15,1,3,0,0,3.28,3.56,2.09,1.72,2.09,1,1,0.28647333323066,0.263941722751844,0.449584944017495,1.12336172244382,1.61269655480433,0,3,1,0,-0.489334832360506,-1,-2,0,0
"465","D2",10,"21.12.2019","Yes","St Pauli","Bielefeld",3,0,11,19,4,5,10,5,1,0,0,0,3.17,3.34,2.22,1.77,2.04,3,0,0.29611821086262,0.281046325878594,0.422835463258786,1.16940095846645,1.54955271565495,3,-8,-1,3,-0.380151757188498,5,1,0,0
"466","D2",10,"22.12.2019","Yes","Bochum","Regensburg",2,3,20,14,4,6,11,12,1,3,0,1,2.11,3.55,3.23,1.54,2.44,0,3,0.444915665268525,0.264442832032841,0.290641502698634,1.59918982783842,1.13636734012874,-1,6,-2,-3,0.462822487709673,-1,-2,-1,0
"467","D2",10,"22.12.2019","Yes","Heidenheim","Osnabruck",3,1,14,13,5,5,15,4,1,3,0,1,2.07,3.35,3.53,1.82,1.97,3,0,0.453656141266194,0.280318869379409,0.266024989354397,1.64128729317799,1.0783938374426,2,1,0,3,0.56289345573539,11,-2,-1,0
"468","D2",10,"22.12.2019","Yes","Sandhausen","Holstein Kiel",2,2,15,18,4,6,11,11,1,1,0,0,2.51,3.41,2.67,1.74,2.07,1,1,0.373671790030986,0.275048736943629,0.351279473025384,1.39606410703659,1.32888715601978,0,-3,-2,0,0.0671769510168065,0,0,0,0
"469","D2",10,"28.01.2020","Yes","Bielefeld","Bochum",2,0,19,5,4,2,11,13,5,8,0,1,1.75,3.72,4.48,1.66,2.2,3,0,0.537329601877765,0.252776022388733,0.209894375733502,1.86476482802203,0.882459149589239,2,14,2,3,0.982305678432789,-2,-3,-1,0
"470","D2",10,"28.01.2020","Yes","Greuther Furth","St Pauli",3,0,24,11,7,2,14,13,1,1,0,0,2.5,3.26,2.81,1.89,1.9,3,0,0.376427949177337,0.288671740166669,0.334900310655994,1.41795558769868,1.29337267213465,3,13,5,3,0.12458291556403,1,0,0,0
"471","D2",10,"28.01.2020","Yes","Regensburg","Hannover",1,0,10,9,7,4,11,15,1,4,0,0,2.67,3.43,2.51,1.68,2.17,3,0,0.351843753959075,0.273884204976889,0.374272041064036,1.32941546685411,1.396700328169,1,1,3,3,-0.0672848613148826,-4,-3,0,0
"472","D2",10,"28.01.2020","Yes","Wehen","Erzgebirge Aue",1,0,8,17,2,4,16,17,6,1,1,0,2.59,3.2,2.74,1.87,1.92,3,0,0.363025098747133,0.293823439298461,0.343151461954407,1.38289873553986,1.32327782516168,1,-9,-2,3,0.0596209103781786,-1,5,1,0
"473","D2",10,"29.01.2020","Yes","Stuttgart","Heidenheim",3,0,12,10,5,1,9,12,2,1,0,0,1.58,4.03,5.42,1.65,2.21,3,0,0.593975025561816,0.232873583222747,0.173151391215437,2.0147986599082,0.752327756869058,3,2,4,3,1.26247090303914,-3,1,0,0
"474","D2",10,"29.01.2020","Yes","Dresden","Karlsruhe",1,0,10,9,3,1,12,12,5,1,0,0,2.55,3.4,2.63,1.78,2.01,3,0,0.367703600139811,0.275777700104858,0.35651869975533,1.37888850052429,1.34533379937085,1,1,2,3,0.0335547011534432,0,4,0,0
"475","D2",10,"29.01.2020","Yes","Holstein Kiel","Darmstadt",1,1,22,6,6,1,5,16,1,3,0,0,1.84,3.59,4.09,1.74,2.07,1,1,0.509576842054119,0.261175874478991,0.22924728346689,1.78990640064135,0.948917724879661,0,16,5,0,0.840988675761688,-11,-2,0,0
"476","D2",10,"29.01.2020","Yes","Osnabruck","Sandhausen",1,3,9,15,3,7,9,19,3,4,1,0,2.39,3.16,3.01,2,1.79,0,3,0.392103191125365,0.29655905911064,0.311337749763994,1.47286863248674,1.23057230840262,-2,-6,-4,-3,0.242296324084113,-10,-1,1,0
"477","D2",10,"30.01.2020","Yes","Hamburg","Nurnberg",4,1,16,5,6,3,5,13,2,4,0,0,1.53,4.22,5.68,1.61,2.27,3,0,0.612773093776044,0.222166548217381,0.165060358006575,2.06048582954551,0.717347622237106,3,11,3,3,1.34313820730841,-8,-2,0,0
"478","D2",10,"31.01.2020","Yes","Erzgebirge Aue","Bielefeld",0,0,8,9,4,3,11,10,3,2,0,0,3.7,3.43,1.99,1.93,1.86,1,1,0.253935125764052,0.273924188141981,0.472140686093967,1.03572956543414,1.69034624642388,0,-1,1,0,-0.654616680989743,1,1,0,0
"479","D2",10,"31.01.2020","Yes","Regensburg","Greuther Furth",0,2,20,11,5,8,19,17,4,4,0,0,2.17,3.39,3.25,1.68,2.16,0,3,0.433311177796219,0.277370281952152,0.289318540251629,1.57730381534081,1.14532590270704,-2,9,-3,-3,0.431977912633769,2,0,0,0
"480","D2",10,"01.02.2020","Yes","Hannover","Wehen",2,2,17,12,4,6,6,8,1,2,0,0,1.63,3.97,5.03,1.74,2.07,1,1,0.576490151303007,0.236694948771764,0.186814899925229,1.96616540268079,0.797139648547451,0,5,-2,0,1.16902575413334,-2,-1,0,0
"481","D2",10,"01.02.2020","Yes","Karlsruhe","Holstein Kiel",0,2,18,19,4,6,17,8,3,1,1,0,2.97,3.4,2.29,1.73,2.09,0,3,0.31541038593819,0.275520248893066,0.409069365168744,1.22175140670764,1.5027283443993,-2,-1,-2,-3,-0.280976937691662,9,2,1,0
"482","D2",10,"01.02.2020","Yes","St Pauli","Stuttgart",1,1,10,13,5,4,7,10,1,1,0,0,3.66,3.54,1.96,1.71,2.12,1,1,0.256328412466197,0.265017511193864,0.478654076339939,1.03400274859245,1.70097974021368,0,-3,1,0,-0.666976991621226,-3,0,0,0
"483","D2",10,"02.02.2020","Yes","Darmstadt","Osnabruck",2,2,23,16,11,7,11,12,4,4,0,1,2.26,3.2,3.2,1.96,1.83,1,1,0.414507772020725,0.292746113989637,0.292746113989637,1.53626943005181,1.17098445595855,0,7,4,0,0.365284974093264,-1,0,-1,0
"484","D2",10,"02.02.2020","Yes","Heidenheim","Dresden",0,0,11,8,3,1,12,11,1,1,0,0,1.75,3.58,4.61,1.82,1.97,1,1,0.535206882797223,0.261623476227693,0.203169640975085,1.86724412461936,0.871132399152946,0,3,2,0,0.996111725466415,1,0,0,0
"485","D2",10,"02.02.2020","Yes","Nurnberg","Sandhausen",2,0,12,15,3,2,10,10,3,1,1,0,2.14,3.27,3.41,1.96,1.82,3,0,0.438212049878369,0.286780974538138,0.275006975583493,1.60141712417325,1.11180190128862,2,-3,1,3,0.48961522288463,0,2,1,0
"486","D2",10,"03.02.2020","Yes","Bochum","Hamburg",1,3,17,20,3,5,11,7,1,1,0,0,3.64,3.46,1.98,1.71,2.11,0,3,0.257042517746995,0.270414671849439,0.472542810403566,1.04154222509042,1.68804310306014,-2,-3,-2,-3,-0.646500877969714,4,0,0,0
"487","D2",10,"07.02.2020","Yes","Dresden","Darmstadt",2,3,11,19,7,7,12,11,3,1,1,0,2.3,3.15,3.2,2.15,1.68,0,3,0.408345148875836,0.298156775369658,0.293498075754507,1.52319222199716,1.17865100263318,-1,-8,0,-3,0.344541219363987,1,2,1,0
"488","D2",10,"07.02.2020","Yes","Sandhausen","Heidenheim",0,1,17,9,3,3,13,14,2,2,0,0,2.37,3.18,3.05,1.95,1.84,0,3,0.396458484064405,0.29547377585932,0.308067740076275,1.48484922805253,1.21967699608815,-1,8,0,-3,0.265172231964388,-1,0,0,0
"489","D2",10,"08.02.2020","Yes","Hamburg","Karlsruhe",2,0,18,6,5,2,7,14,1,1,0,0,1.29,5.36,9.59,1.51,2.5,3,0,0.727173957636314,0.175010150252023,0.0978158921116627,2.35653202316097,0.468457826587011,2,12,3,3,1.88807419657395,-7,0,0,0
"490","D2",10,"08.02.2020","Yes","Osnabruck","Nurnberg",0,1,5,11,1,6,11,19,3,3,0,0,2.43,3.23,2.9,1.87,1.92,0,3,0.386062671815818,0.290443434214377,0.323493893969806,1.44863144966183,1.26092511612379,-1,-6,-5,-3,0.187706333538035,-8,0,0,0
"491","D2",10,"08.02.2020","Yes","Stuttgart","Erzgebirge Aue",3,0,20,10,8,2,9,12,3,2,0,0,1.37,4.66,8.13,1.57,2.36,3,0,0.683759233758241,0.201019345546951,0.115221420694808,2.25229704682167,0.546683607631375,3,10,6,3,1.7056134391903,-3,1,0,0
"492","D2",10,"09.02.2020","Yes","Bielefeld","Regensburg",6,0,19,5,9,0,4,16,0,3,0,0,1.69,3.79,4.76,1.62,2.26,3,0,0.555261789048289,0.247596945512298,0.197141265439413,1.91338231265716,0.839020741830538,6,14,9,3,1.07436157082663,-12,-3,0,0
"493","D2",10,"09.02.2020","Yes","Greuther Furth","Hannover",1,3,17,8,7,4,13,19,2,5,0,1,2.65,3.14,2.7,1.93,1.85,0,3,0.353928362695166,0.298697503548468,0.347374133756366,1.36048259163396,1.34081990481757,-2,9,3,-3,0.0196626868163983,-6,-3,-1,0
"494","D2",10,"09.02.2020","Yes","Wehen","Bochum",0,1,17,12,3,4,13,12,1,4,0,0,2.87,3.34,2.39,1.7,2.12,0,3,0.326784756649214,0.280800075324324,0.392415168026462,1.26115434527197,1.45804557940371,-1,5,-1,-3,-0.196891234131744,1,-3,0,0
"495","D2",10,"10.02.2020","Yes","Holstein Kiel","St Pauli",2,1,12,9,5,4,6,7,1,2,0,0,1.95,3.54,3.67,1.68,2.14,3,0,0.480265273757638,0.264552905035987,0.255181821206375,1.7053487263089,1.03009836865511,1,3,1,3,0.675250357653791,-1,-1,0,0
"496","D2",10,"14.02.2020","Yes","Heidenheim","Nurnberg",2,2,16,11,7,4,11,13,1,3,0,0,2.3,3.24,3.11,2.04,1.76,1,1,0.408258850794525,0.289813381736854,0.30192776746862,1.51458993412043,1.19559668414271,0,5,3,0,0.318993249977716,-2,-2,0,0
"497","D2",10,"14.02.2020","Yes","St Pauli","Dresden",0,0,20,3,8,1,8,10,2,3,0,0,1.88,3.44,4.14,1.97,1.82,1,1,0.499845570686508,0.273171416537976,0.226983012775516,1.7727081285975,0.954120454864523,0,17,7,0,0.818587673732978,-2,-1,0,0
"498","D2",10,"15.02.2020","Yes","Greuther Furth","Bielefeld",2,4,16,15,5,7,10,11,0,0,0,0,3.34,3.25,2.18,1.97,1.83,0,3,0.280914468780233,0.288693638684916,0.430391892534852,1.13143704502561,1.57986931628947,-2,1,-2,-3,-0.448432271263857,-1,0,0,0
"499","D2",10,"15.02.2020","Yes","Hannover","Hamburg",1,1,9,14,1,5,18,11,4,0,0,0,4.04,3.66,1.83,1.74,2.07,1,1,0.231939163498099,0.256020278833967,0.512040557667934,0.951837769328264,1.79214195183777,0,-5,-4,0,-0.840304182509506,7,4,0,0
"500","D2",10,"15.02.2020","Yes","Regensburg","Wehen",1,0,14,9,5,2,12,11,2,2,0,0,2.13,3.34,3.39,1.74,2.08,3,0,0.441297866121017,0.281426483484361,0.277275650394621,1.60532008184741,1.11325343466823,1,5,3,3,0.492066647179187,1,0,0,0
"501","D2",10,"16.02.2020","Yes","Darmstadt","Sandhausen",1,0,11,9,6,0,10,10,3,2,1,0,2.46,3.14,2.94,2.01,1.78,3,0,0.381654015974599,0.299002827801756,0.319343156223644,1.44396487572555,1.25703229647269,1,2,6,3,0.186932579252865,0,1,1,0
"502","D2",10,"16.02.2020","Yes","Erzgebirge Aue","Holstein Kiel",1,2,18,9,4,6,15,9,3,2,0,0,3.03,3.32,2.3,1.75,2.05,0,3,0.309593506482976,0.2825507001938,0.407855793323224,1.21133121964273,1.50611808016347,-1,9,-2,-3,-0.294786860520746,6,1,0,0
"503","D2",10,"16.02.2020","Yes","Karlsruhe","Osnabruck",1,1,23,13,9,4,13,10,4,2,0,1,2.41,3.25,2.91,1.86,1.92,1,1,0.389147886483617,0.288568125054005,0.322283988462377,1.45601178450486,1.25542009044114,0,10,5,0,0.20059169406372,3,2,-1,0
"504","D2",10,"17.02.2020","Yes","Bochum","Stuttgart",0,1,12,18,4,7,10,17,1,1,0,0,3.79,3.64,1.89,1.57,2.35,0,3,0.247127159345219,0.257310970856697,0.495561869798084,0.998692448892353,1.74399658025095,-1,-6,-3,-3,-0.745304131358596,-7,0,0,0
"505","D2",10,"21.02.2020","Yes","Osnabruck","Erzgebirge Aue",0,0,8,7,2,3,13,17,1,3,0,0,2.07,3.29,3.61,1.99,1.8,1,1,0.454011674356553,0.285654761677223,0.260333563966223,1.64768978474688,1.06665545357589,0,1,-1,0,0.581034331170991,-4,-2,0,0
"506","D2",10,"21.02.2020","Yes","Wehen","Greuther Furth",1,1,9,16,3,5,14,11,1,1,0,0,2.55,3.32,2.69,1.72,2.09,1,1,0.368184760247853,0.282792511636152,0.349022728115995,1.38734679237971,1.32986069598414,0,-7,-2,0,0.0574860963955757,3,0,0,0
"507","D2",10,"22.02.2020","Yes","Dresden","Bochum",1,2,10,10,2,4,15,17,0,1,0,0,2.53,3.22,2.77,1.9,1.89,0,3,0.370497754848572,0.291105378809592,0.338396866341836,1.40259864335531,1.3062959778351,-1,0,-2,-3,0.0963026655202062,-2,-1,0,0
"508","D2",10,"22.02.2020","Yes","Hamburg","St Pauli",0,2,19,8,4,4,3,14,0,4,0,0,1.43,4.45,7.11,1.62,2.26,0,3,0.656825886490223,0.211069891613712,0.132104221896065,2.18154755108438,0.607382557301906,-2,11,0,-3,1.57416499378248,-11,-4,0,0
"509","D2",10,"22.02.2020","Yes","Holstein Kiel","Heidenheim",0,1,10,13,2,4,9,18,1,3,0,1,1.95,3.52,3.74,1.78,2.02,0,3,0.481842338352524,0.266929704485063,0.251227957162412,1.71245671954264,1.0206135759723,-1,-3,-2,-3,0.691843143570336,-9,-2,-1,0
"510","D2",10,"22.02.2020","Yes","Stuttgart","Regensburg",2,0,16,10,7,2,15,15,3,3,0,0,1.34,5.15,8.22,1.44,2.7,3,0,0.70263640105695,0.18282189852744,0.11454170041561,2.29073110169829,0.526446999774269,2,6,5,3,1.76428410192402,0,0,0,0
"511","D2",10,"23.02.2020","Yes","Bielefeld","Hannover",1,0,12,11,4,2,16,9,2,3,0,0,1.85,3.55,4.1,1.8,1.99,3,0,0.507010363145519,0.264216668118088,0.228772968736393,1.78524775755465,0.950535574327267,1,1,2,3,0.834712183227379,7,-1,0,0
"512","D2",10,"23.02.2020","Yes","Nurnberg","Darmstadt",1,2,6,11,2,3,14,11,4,2,2,0,1.91,3.33,4.14,1.94,1.85,0,3,0.491418305476244,0.281864553591479,0.226717140932277,1.75611947002021,0.96201597638831,-1,-5,-1,-3,0.794103493631901,3,2,2,0
"513","D2",10,"23.02.2020","Yes","Sandhausen","Karlsruhe",0,2,12,8,3,3,16,9,4,3,0,0,2,3.31,3.82,1.91,1.87,0,3,0.469971231257573,0.283970532481917,0.24605823626051,1.69388422625464,1.02214524126345,-2,4,0,-3,0.671738984991191,7,1,0,0
"514","D2",10,"28.02.2020","Yes","Karlsruhe","Nurnberg",0,1,12,17,0,4,9,18,3,3,0,0,2.75,3.16,2.59,1.97,1.82,0,3,0.341060720343044,0.296809171184611,0.362130108472344,1.31999133221374,1.38319949660164,-1,-5,-4,-3,-0.0632081643878999,-9,0,0,0
"515","D2",10,"28.02.2020","Yes","Regensburg","Dresden",1,2,13,12,5,7,5,13,1,0,0,0,1.96,3.42,3.83,1.85,1.94,0,3,0.479651098921219,0.274887764294032,0.245461136784749,1.71384106105769,1.01127117464828,-1,1,-2,-3,0.70256988640941,-8,1,0,0
"516","D2",10,"29.02.2020","Yes","Darmstadt","Heidenheim",2,0,18,20,4,5,10,9,2,1,0,1,2.41,3.17,2.98,2.03,1.77,3,0,0.389259975028947,0.295935816977843,0.314804207993209,1.46371574206469,1.24034844095747,2,-2,-1,3,0.223367301107215,1,1,-1,0
"517","D2",10,"29.02.2020","Yes","Erzgebirge Aue","Hamburg",3,0,21,9,6,1,16,11,2,5,0,1,4.55,3.86,1.7,1.7,2.12,3,0,0.205963590709353,0.24278091650973,0.551255492780916,0.86067168863779,1.89654739485248,3,12,5,3,-1.03587570621469,5,-3,-1,0
"518","D2",10,"29.02.2020","Yes","Greuther Furth","Stuttgart",2,0,14,18,4,8,13,13,4,3,0,0,4.14,3.8,1.78,1.63,2.24,3,0,0.226484336284371,0.24674872426771,0.526766939447919,0.926201733120823,1.82704954261147,2,-4,-4,3,-0.900847809490645,0,1,0,0
"519","D2",10,"01.03.2020","Yes","Bielefeld","Wehen",1,0,15,7,6,1,8,14,1,3,0,0,1.52,4.22,5.82,1.61,2.28,3,0,0.616766948258716,0.222153024017358,0.161080027723926,2.07245386879351,0.705393107189135,1,8,5,3,1.36706076160437,-6,-2,0,0
"520","D2",10,"01.03.2020","Yes","Bochum","Sandhausen",4,4,13,18,5,8,17,20,2,3,0,0,2.21,3.44,3.08,1.8,1.99,1,1,0.423733422917566,0.272224088560413,0.30404248852202,1.54342435731311,1.18435155412647,0,-5,-3,0,0.359072803186639,-3,-1,0,0
"521","D2",10,"01.03.2020","Yes","St Pauli","Osnabruck",3,1,13,23,5,6,18,9,2,3,0,0,2,3.42,3.63,1.87,1.91,3,0,0.468217510352787,0.273811409563033,0.25797108008418,1.67846394062139,1.04772464981557,2,-10,-1,3,0.63073929080582,9,-1,0,0
"522","D2",10,"02.03.2020","Yes","Hannover","Holstein Kiel",3,1,17,18,7,8,8,2,1,0,0,0,2.39,3.41,2.8,1.65,2.19,3,0,0.391473519776629,0.274375868699749,0.334150611523622,1.44879642802964,1.27682770327062,2,-1,-1,3,0.171968724759019,6,1,0,0
"523","D2",10,"06.03.2020","Yes","Nurnberg","Hannover",0,3,8,10,3,5,6,9,1,0,0,0,2.46,3.2,2.9,1.9,1.88,0,3,0.382113151609981,0.293749485300173,0.324137363089846,1.44008894013012,1.26616157456971,-3,-2,-2,-3,0.173927365560405,-3,1,0,0
"524","D2",10,"06.03.2020","Yes","Osnabruck","Wehen",2,6,14,15,4,8,5,20,2,4,0,0,1.99,3.41,3.74,1.94,1.85,0,3,0.472665008765135,0.275836764645929,0.251498226588936,1.69383179094133,1.03033144441274,-4,-1,-4,-3,0.663500346528599,-15,-2,0,0
"525","D2",10,"07.03.2020","Yes","Darmstadt","Bochum",0,0,15,10,3,0,9,13,1,2,0,0,2.24,3.2,3.25,1.87,1.9,1,1,0.418544752092724,0.292981326464907,0.28847392144237,1.54861558274308,1.15840309079202,0,5,3,0,0.390212491951062,-4,-1,0,0
"526","D2",10,"07.03.2020","Yes","Hamburg","Regensburg",2,1,11,16,5,5,14,13,3,4,0,0,1.43,4.58,6.78,1.51,2.49,3,0,0.656537807734919,0.204988878834265,0.138473313430816,2.17460230203902,0.620408819126714,1,-5,0,3,1.55419348291231,1,-1,0,0
"527","D2",10,"07.03.2020","Yes","Heidenheim","Karlsruhe",3,1,15,14,7,4,8,12,1,1,0,1,2.02,3.29,3.77,1.91,1.87,3,0,0.465161544375481,0.285600705057286,0.249237750567234,1.68108533818373,1.03331395675899,2,1,3,3,0.647771381424741,-4,0,-1,0
"528","D2",10,"08.03.2020","Yes","Dresden","Erzgebirge Aue",2,1,16,11,12,4,9,10,2,4,0,1,2.54,3.06,2.88,2.11,1.71,3,0,0.368730230456394,0.30607019129387,0.325199578249736,1.41226088266305,1.28166892604308,1,5,8,3,0.130591956619973,-1,-2,-1,0
"529","D2",10,"08.03.2020","Yes","Holstein Kiel","Greuther Furth",1,1,10,10,5,6,9,10,2,3,0,0,1.84,3.62,4.05,1.63,2.24,1,1,0.509526027149699,0.258985604960068,0.231488367890233,1.78756368640916,0.953450708630768,0,0,-1,0,0.834112977778396,-1,-1,0,0
"530","D2",10,"08.03.2020","Yes","Sandhausen","St Pauli",2,2,19,6,6,4,22,16,2,2,0,0,2.42,3.19,2.94,1.97,1.81,1,1,0.387334181355624,0.293839723787025,0.318826094857351,1.4558422678539,1.25031800835908,0,13,2,0,0.205524259494821,6,0,0,0
"531","D2",10,"09.03.2020","Yes","Stuttgart","Bielefeld",1,1,8,14,4,5,10,11,1,2,0,0,1.83,3.67,4.01,1.64,2.21,1,1,0.511509813667187,0.255058026978461,0.233432159354352,1.78958746798002,0.955354505041517,0,-6,-1,0,0.834232962938504,-1,-1,0,0
"532","D2",10,"16.05.2020","No","Bochum","Heidenheim",3,0,10,11,3,3,15,12,4,0,0,0,2.59,3.29,2.67,1.83,1.97,3,0,0.362677379266495,0.28551197942256,0.351810641310945,1.37354411722205,1.34094390335539,3,-1,0,3,0.0326002138666512,3,4,0,0
"533","D2",10,"16.05.2020","No","Erzgebirge Aue","Sandhausen",3,1,13,15,7,6,11,10,1,3,0,1,2.57,3.19,2.76,2.01,1.79,3,0,0.365389962607747,0.294373731630692,0.340236305761561,1.39054361945393,1.31508264891538,2,-2,1,3,0.0754609705385563,1,-2,-1,0
"534","D2",10,"16.05.2020","No","Karlsruhe","Darmstadt",2,0,16,11,5,0,20,13,3,1,0,0,2.67,3.2,2.63,1.98,1.81,3,0,0.350928400765571,0.292805884388773,0.356265714845656,1.34559108668549,1.36160302892574,2,5,5,3,-0.0160119422402543,7,2,0,0
"535","D2",10,"16.05.2020","No","Regensburg","Holstein Kiel",2,2,7,17,4,6,16,14,5,1,0,0,2.81,3.29,2.46,1.74,2.08,1,1,0.333736067527391,0.285045091110021,0.381218841362589,1.28625329369219,1.42870161519779,0,-10,-2,0,-0.142448321505594,2,4,0,0
"536","D2",10,"17.05.2020","No","Bielefeld","Osnabruck",1,1,6,10,3,4,9,6,3,0,0,0,1.69,3.79,4.78,1.73,2.09,1,1,0.555720179757358,0.247801346646421,0.196478473596221,1.9149618859185,0.837236767435083,0,-4,-1,0,1.07772511848341,3,3,0,0
"537","D2",10,"17.05.2020","No","Greuther Furth","Hamburg",2,2,14,11,5,8,14,14,2,3,0,0,4.1,3.6,1.84,1.73,2.09,1,1,0.228982300884956,0.260785398230089,0.510232300884956,0.947732300884956,1.79148230088496,0,3,-3,0,-0.84375,0,-1,0,0
"538","D2",10,"17.05.2020","No","St Pauli","Nurnberg",1,0,13,14,7,5,14,8,1,0,0,1,2.48,3.19,2.87,1.93,1.86,3,0,0.378566909663787,0.294309070835797,0.327124019500416,1.43000979982716,1.27568112933704,1,-1,2,3,0.154328670490116,6,1,-1,0
"539","D2",10,"17.05.2020","No","Wehen","Stuttgart",2,1,12,21,6,6,16,14,2,1,0,0,4.74,3.87,1.68,1.72,2.11,3,0,0.198167553629231,0.242716848631152,0.559115597739617,0.837219509518845,1.92006364185,1,-9,0,3,-1.08284413233116,2,1,0,0
"540","D2",10,"22.05.2020","No","Heidenheim","Wehen",1,0,17,7,8,1,11,13,1,2,0,0,1.83,3.62,4.15,1.72,2.1,3,0,0.513745592826781,0.259711169854422,0.226543237318797,1.80094794833476,0.939340881810814,1,10,7,3,0.86160706652395,-2,-1,0,0
"541","D2",10,"22.05.2020","No","Nurnberg","Erzgebirge Aue",1,1,13,7,3,2,12,11,5,3,0,0,1.96,3.4,3.83,1.94,1.86,1,1,0.47887676149569,0.276058368391633,0.245064870112677,1.7126886528787,1.01125297872966,0,6,1,0,0.70143567414904,1,2,0,0
"542","D2",10,"23.05.2020","No","Darmstadt","St Pauli",4,0,21,13,9,4,8,16,0,2,0,0,2.4,3.26,2.93,1.94,1.85,3,0,0.39134211194782,0.288104622292874,0.320553265759306,1.46213095813633,1.24976441957079,4,8,5,3,0.212366538565541,-8,-2,0,0
"543","D2",10,"23.05.2020","No","Osnabruck","Hannover",2,4,8,12,4,5,16,18,3,2,0,0,2.83,3.24,2.47,1.87,1.92,0,3,0.331212932650722,0.289300185000476,0.379486882348802,1.28293898295264,1.42776083204688,-2,-4,-1,-3,-0.144821849094243,-2,1,0,0
"544","D2",10,"23.05.2020","No","Sandhausen","Regensburg",0,0,13,7,5,0,20,15,3,3,0,0,2.27,3.4,3.03,1.74,2.07,1,1,0.413766512304152,0.276249994979537,0.309983492716312,1.51754953189199,1.20620047312847,0,6,5,0,0.31134905876352,5,0,0,0
"545","D2",10,"24.05.2020","No","Hamburg","Bielefeld",0,0,13,8,7,2,7,6,1,1,0,0,2.1,3.39,3.39,1.77,2.04,1,1,0.446640316205534,0.276679841897233,0.276679841897233,1.61660079051383,1.10671936758893,0,5,5,0,0.509881422924901,1,0,0,0
"546","D2",10,"24.05.2020","No","Holstein Kiel","Stuttgart",3,2,15,18,7,9,10,13,2,3,0,1,3.32,3.5,2.09,1.6,2.31,3,0,0.28271842558882,0.268178620844252,0.449102953566929,1.11633389761071,1.61548748154504,1,-3,-2,3,-0.499153583934328,-3,-1,-1,0
"547","D2",10,"24.05.2020","No","Karlsruhe","Bochum",0,0,10,18,4,4,13,13,3,2,0,0,2.48,3.35,2.74,1.72,2.11,1,1,0.378013524309988,0.279842847847394,0.342143627842617,1.41388342077736,1.30627373137525,0,-8,0,0,0.107609689402113,0,1,0,0
"548","D2",10,"26.05.2020","No","Erzgebirge Aue","Darmstadt",1,3,6,17,3,13,15,10,3,2,0,0,2.5,3.22,2.84,1.99,1.81,0,3,0.376409766699047,0.292243607685595,0.331346625615358,1.42147290778274,1.28628348453167,-2,-11,-10,-3,0.135189423251066,5,1,0,0
"549","D2",10,"26.05.2020","No","Greuther Furth","Osnabruck",0,2,23,10,7,5,16,15,2,3,0,0,2.04,3.54,3.44,1.75,2.08,0,3,0.460979376760243,0.26564913237031,0.273371490869447,1.64858726265104,1.08576360497865,-2,13,2,-3,0.56282365767239,1,-1,0,0
"550","D2",10,"26.05.2020","No","Regensburg","Nurnberg",2,2,11,17,3,5,19,12,2,3,0,0,2.87,3.26,2.45,1.84,1.96,1,1,0.32767582780506,0.288475345337584,0.383848826857356,1.27150282875276,1.44002182590965,0,-6,-2,0,-0.168518997156888,7,-1,0,0
"551","D2",10,"26.05.2020","No","Wehen","Sandhausen",0,1,9,19,2,5,22,14,6,3,1,0,2.91,3.24,2.44,1.91,1.88,0,3,0.323543856202731,0.290590315293193,0.385865828504076,1.26122188390138,1.44818780080542,-1,-10,-3,-3,-0.186965916904037,8,3,1,0
"552","D2",10,"27.05.2020","No","Bochum","Holstein Kiel",2,1,11,14,7,4,9,5,3,1,0,0,2.7,3.38,2.5,1.6,2.31,3,0,0.347364959302804,0.277480884650169,0.375154156047028,1.31957576255858,1.40294335279125,1,-3,3,3,-0.0833675902326729,4,2,0,0
"553","D2",10,"27.05.2020","No","Hannover","Karlsruhe",1,1,19,13,4,3,12,18,2,0,0,0,1.78,3.71,4.25,1.77,2.03,1,1,0.526701696602452,0.252703239879344,0.220595063518204,1.8328083296867,0.914488430433955,0,6,1,0,0.918319899252746,-6,2,0,0
"554","D2",10,"27.05.2020","No","St Pauli","Heidenheim",0,0,11,9,0,3,16,16,3,3,0,0,2.49,3.19,2.83,1.98,1.81,1,1,0.375880087436244,0.293398563547413,0.330721349016342,1.42103882585615,1.28556261059644,0,2,-3,0,0.135476215259706,0,0,0,0
"555","D2",10,"28.05.2020","No","Stuttgart","Hamburg",3,2,13,9,7,4,15,14,3,2,0,0,2.25,3.34,3.09,1.74,2.07,3,0,0.416353008096627,0.280477325813596,0.303169666089777,1.52953635010348,1.18998632408293,1,4,3,3,0.33955002602055,1,1,0,0
"556","D2",10,"29.05.2020","No","Darmstadt","Greuther Furth",1,1,15,14,3,2,14,14,2,2,0,0,2.07,3.47,3.44,1.78,2.02,1,1,0.454899868523847,0.271366780358606,0.273733351117547,1.63606638593015,1.09256683371125,0,1,1,0,0.543499552218898,0,0,0,0
"557","D2",10,"29.05.2020","No","Osnabruck","Regensburg",2,2,14,10,4,3,21,20,3,2,0,0,2.39,3.3,2.93,1.78,2.03,1,1,0.393709764767679,0.285141314483259,0.321148920749062,1.4662706087863,1.24858807673045,0,4,1,0,0.21768253205585,1,1,0,0
"558","D2",10,"30.05.2020","No","Holstein Kiel","Bielefeld",1,2,11,20,3,8,17,10,1,2,0,0,2.78,3.4,2.43,1.73,2.08,0,3,0.337646203012743,0.276075424816301,0.386278372170956,1.28901403385453,1.43491054132917,-1,-9,-5,-3,-0.145896507474641,7,-1,0,0
"559","D2",10,"30.05.2020","No","Karlsruhe","St Pauli",1,1,9,6,5,3,15,13,3,1,0,0,2.56,3.25,2.71,1.94,1.85,1,1,0.365986428479416,0.288284694433017,0.345728877087567,1.38624397987127,1.32547132569572,0,3,2,0,0.0607726541755487,2,2,0,0
"560","D2",10,"30.05.2020","No","Nurnberg","Bochum",0,0,12,9,0,2,14,11,1,2,0,0,2.18,3.3,3.28,1.84,1.95,1,1,0.430063094992133,0.284102286994803,0.285834618013064,1.5742915719712,1.141606141034,0,3,-2,0,0.432685430937207,3,-1,0,0
"561","D2",10,"30.05.2020","No","Sandhausen","Hannover",3,1,15,16,6,3,15,9,3,2,0,0,2.69,3.25,2.59,1.84,1.95,3,0,0.34888154813467,0.28876657368685,0.36235187817848,1.33541121809086,1.37582220822229,2,-1,3,3,-0.0404109901314289,6,1,0,0
"562","D2",10,"31.05.2020","No","Dresden","Stuttgart",0,2,10,15,2,8,11,16,2,2,0,0,8.1,4.48,1.39,1.71,2.12,0,3,0.11580274555456,0.209375499774985,0.674821754670455,0.556783736438664,2.23384076378635,-2,-5,-6,-3,-1.67705702734769,-5,0,0,0
"563","D2",10,"31.05.2020","No","Hamburg","Wehen",3,2,13,13,7,6,11,17,2,2,0,0,1.41,4.64,7.06,1.59,2.32,3,0,0.665072256036901,0.202101698493972,0.132826045469126,2.19731846660468,0.600579834901351,1,0,1,3,1.59673863170333,-6,0,0,0
"564","D2",10,"31.05.2020","No","Heidenheim","Erzgebirge Aue",3,0,16,13,8,5,11,12,1,3,0,0,1.92,3.45,3.93,1.95,1.84,3,0,0.488980492713168,0.272128274205589,0.238891233081242,1.73906975234509,0.988801973449317,3,3,3,3,0.750267778895777,-1,-2,0,0
"565","D2",10,"03.06.2020","No","Hannover","Dresden",3,0,12,7,6,1,6,7,0,2,0,0,1.7,3.7,4.86,1.79,2.01,3,0,0.552714083727793,0.253949714145202,0.193336202127006,1.91209196532858,0.833958320526219,3,5,5,3,1.07813364480236,-1,-2,0,0
"566","D2",10,"05.06.2020","No","Bochum","St Pauli",2,0,16,5,7,1,14,12,3,3,0,0,2.32,3.2,3.16,1.8,1.99,3,0,0.406640072062798,0.294814052245528,0.298545875691674,1.51473426843392,1.19045167932055,2,11,6,3,0.32428258911337,2,0,0,0
"567","D2",10,"05.06.2020","No","Greuther Furth","Sandhausen",1,2,13,10,3,3,12,21,2,2,0,0,2.53,3.28,2.75,1.92,1.88,0,3,0.371561919434501,0.286601114685758,0.341836965879741,1.40128687298926,1.31211201232498,-1,3,0,-3,0.0891748606642802,-9,0,0,0
"568","D2",10,"06.06.2020","No","Bielefeld","Nurnberg",1,1,14,12,4,8,16,10,2,2,0,0,1.87,3.51,4.07,1.89,1.91,1,1,0.501951841688246,0.267421636454992,0.230626521856762,1.77327716151973,0.959301202025277,0,2,-4,0,0.813975959494454,6,0,0,0
"569","D2",10,"06.06.2020","No","Regensburg","Darmstadt",3,0,7,22,3,4,16,16,5,1,1,0,2.63,3.34,2.6,1.79,2.02,3,0,0.35727509853453,0.281327397947849,0.361397503517621,1.35315269355144,1.36551990850071,3,-15,-1,3,-0.012367214949272,0,4,1,0
"570","D2",10,"06.06.2020","No","Wehen","Dresden",2,3,19,10,4,5,13,16,2,3,0,1,2.16,3.34,3.3,1.87,1.93,0,3,0.434546056677863,0.28102379713299,0.284430146189147,1.58466196716658,1.13431423570043,-1,9,-1,-3,0.450347731466149,-3,-1,-1,0
"571","D2",10,"07.06.2020","No","Erzgebirge Aue","Karlsruhe",1,0,10,14,3,2,10,9,1,2,0,0,2.27,3.26,3.14,1.96,1.83,3,0,0.413351423818061,0.287824457689264,0.298824118492675,1.52787872914345,1.18429681316729,1,-4,1,3,0.34358191597616,1,-1,0,0
"572","D2",10,"07.06.2020","No","Hannover","Heidenheim",2,1,16,9,6,2,16,12,4,2,0,0,2.29,3.2,3.16,1.92,1.87,3,0,0.409784247297013,0.293251851971925,0.296963900731063,1.52260459386296,1.18414355416511,1,7,4,3,0.338461039697849,4,2,0,0
"573","D2",10,"07.06.2020","No","Stuttgart","Osnabruck",0,0,16,7,4,1,16,10,3,3,0,0,1.45,4.47,6.59,1.59,2.32,1,1,0.647494301483922,0.210037301376216,0.142468397139861,2.15252020582798,0.637442492795801,0,9,3,0,1.51507771303218,6,0,0,0
"574","D2",10,"08.06.2020","No","Hamburg","Holstein Kiel",3,3,8,15,5,7,14,6,5,1,0,0,1.61,3.94,5.21,1.69,2.15,1,1,0.582190595849559,0.237900218100962,0.17990918604948,1.98447200564964,0.777627776249401,0,-7,-2,0,1.20684422940024,8,4,0,0
"575","D2",10,"09.06.2020","No","Dresden","Greuther Furth",1,1,7,10,1,3,16,12,4,1,0,0,2.93,3.44,2.32,1.87,1.93,1,1,0.321060762100927,0.273461637487127,0.405477600411946,1.23664392378991,1.48989443872297,0,-3,-2,0,-0.253250514933059,4,3,0,0
"576","D2",10,"12.06.2020","No","Dresden","Hamburg",0,1,7,20,3,5,9,12,2,1,0,0,5.93,4.2,1.51,1.65,2.22,0,3,0.157752168408275,0.222731037776446,0.619516793815279,0.695987543001271,2.08128141922228,-1,-13,-2,-3,-1.38529387622101,-3,1,0,0
"577","D2",10,"12.06.2020","No","Sandhausen","Bielefeld",0,0,21,9,3,0,16,9,0,0,0,0,3.06,3.22,2.34,1.96,1.83,1,1,0.306936500953219,0.291684997800264,0.401378501246517,1.21249450065992,1.49582050153982,0,12,3,0,-0.283326000879894,7,0,0,0
"578","D2",10,"13.06.2020","No","Heidenheim","Regensburg",4,1,15,14,7,4,12,10,3,2,0,0,1.83,3.63,4.11,1.71,2.11,3,0,0.512981587498066,0.258610552375058,0.228407860126876,1.79755531486926,0.943834132755686,3,1,3,3,0.853721182113569,2,1,0,0
"579","D2",10,"13.06.2020","No","Holstein Kiel","Wehen",1,2,13,12,6,3,12,14,2,2,0,1,1.81,3.69,4.1,1.61,2.28,0,3,0.517604152054987,0.253892551550007,0.228503296395006,1.80670500771497,0.939402440735026,-1,1,3,-3,0.867302566979941,-2,0,-1,0
"580","D2",10,"13.06.2020","No","Nurnberg","Greuther Furth",0,1,16,12,5,1,21,15,3,3,0,0,1.93,3.52,3.79,1.86,1.92,0,3,0.486019578055383,0.266482325467866,0.247498096476752,1.72454105963401,1.00897661489812,-1,4,4,-3,0.715564444735893,6,0,0,0
"581","D2",10,"13.06.2020","No","Osnabruck","Bochum",0,2,11,16,3,6,9,17,1,3,0,0,2.49,3.26,2.77,1.84,1.95,0,3,0.375555731152968,0.286850849868371,0.337593418978661,1.41351804332728,1.29963110680435,-2,-5,-3,-3,0.113886936522921,-8,-2,0,0
"582","D2",10,"14.06.2020","No","Darmstadt","Hannover",3,2,11,14,4,7,8,8,3,0,0,0,2.55,3.33,2.65,1.73,2.09,3,0,0.366564895009035,0.280702847529441,0.352732257461524,1.38039753255655,1.33889961991401,1,-3,-3,3,0.0414979126425326,0,3,0,0
"583","D2",10,"14.06.2020","No","Karlsruhe","Stuttgart",2,1,12,14,3,6,14,18,2,3,0,0,4.4,3.77,1.74,1.65,2.2,3,0,0.212954245904726,0.248540764451139,0.538504989644135,0.887403502165317,1.86405573338354,1,-2,-3,3,-0.976652231218226,-4,-1,0,0
"584","D2",10,"14.06.2020","No","St Pauli","Erzgebirge Aue",2,1,8,18,4,4,20,17,2,2,0,0,1.93,3.43,3.87,1.91,1.88,3,0,0.485109508791036,0.272962493284752,0.241927997924212,1.72829101965786,0.998746487057387,1,-10,0,3,0.729544532600473,3,0,0,0
"585","D2",10,"15.06.2020","No","Bielefeld","Dresden",4,0,13,8,4,2,12,15,1,4,0,0,1.45,4.23,7.41,1.86,1.94,3,0,0.64999595622772,0.222811852607611,0.127192191164669,2.17279972129077,0.604388426101617,4,5,2,3,1.56841129518916,-3,-3,0,0
"586","D2",10,"16.06.2020","No","Greuther Furth","Heidenheim",0,0,10,11,1,3,16,24,0,0,0,0,3.09,3.5,2.18,1.79,2.01,1,1,0.303003828252824,0.267509094086064,0.429487077661112,1.17652057884453,1.5559703270694,0,-1,-2,0,-0.379449748224866,-8,0,0,0
"587","D2",10,"16.06.2020","No","Hamburg","Osnabruck",1,1,6,8,2,3,15,12,1,3,0,0,1.42,4.56,7,1.59,2.32,1,1,0.660388288452308,0.205647230175938,0.133964481371754,2.18681209553286,0.6075406742912,0,-2,-1,0,1.57927142124166,3,-2,0,0
"588","D2",10,"16.06.2020","No","Wehen","Nurnberg",0,6,10,21,4,9,10,12,2,1,0,0,3.05,3.39,2.25,1.8,1.99,0,3,0.307195070379992,0.276384945327131,0.416419984292877,1.19797015646711,1.52564489820576,-6,-11,-5,-3,-0.327674741738657,-2,1,0,0
"589","D2",10,"17.06.2020","No","Erzgebirge Aue","Bochum",1,2,16,9,7,2,21,15,5,3,1,1,2.74,3.27,2.51,1.86,1.92,0,3,0.341348893112469,0.286023231537665,0.372627875349866,1.31006991087507,1.40390685758726,-1,7,5,-3,-0.0938369467121929,6,2,0,0
"590","D2",10,"17.06.2020","No","Hannover","St Pauli",4,0,12,5,6,0,13,6,1,1,0,0,1.97,3.47,3.67,1.76,2.04,3,0,0.475170424653087,0.269765341950024,0.255064233396889,1.69527661590929,1.03495804214069,4,7,6,3,0.660318573768595,7,0,0,0
"591","D2",10,"17.06.2020","No","Regensburg","Karlsruhe",2,1,9,14,6,6,20,15,3,3,0,0,2.59,3.3,2.64,1.77,2.04,3,0,0.361544782251438,0.283757874554916,0.354697343193646,1.36839222130923,1.34784990413585,1,-5,0,3,0.0205423171733772,5,0,0,0
"592","D2",10,"17.06.2020","No","Stuttgart","Sandhausen",5,1,18,16,11,5,14,15,4,1,0,0,1.51,4.22,5.93,1.64,2.22,3,0,0.620171445140281,0.221909687716072,0.157918867143647,2.08242402313692,0.695666289147012,4,2,6,3,1.3867577339899,-1,3,0,0
"593","D2",10,"18.06.2020","No","Holstein Kiel","Dresden",2,0,21,8,8,2,11,15,1,4,0,1,1.74,3.82,4.32,1.58,2.33,3,0,0.538133437683428,0.245118372138525,0.216748190178047,1.85951868518881,0.895362942672667,2,13,6,3,0.964155742516142,-4,-3,-1,0
"594","D2",10,"18.06.2020","No","Bielefeld","Darmstadt",1,0,13,15,6,6,7,10,2,1,0,0,1.76,3.53,4.61,1.96,1.82,3,0,0.531812403389576,0.265152926335879,0.203034670274545,1.86059013650461,0.874256937159515,1,-2,0,3,0.986333199345092,-3,1,0,0
"595","D2",10,"21.06.2020","No","Bochum","Greuther Furth",2,2,8,10,7,2,13,18,1,2,0,0,2.1,3.47,3.3,1.68,2.16,1,1,0.446119682094437,0.269985974754558,0.283894343151005,1.60834502103787,1.12166900420757,0,-2,5,0,0.486676016830295,-5,-1,0,0
"596","D2",10,"21.06.2020","No","Darmstadt","Wehen",3,1,16,10,7,4,9,16,2,4,0,0,2.18,3.65,2.99,1.57,2.34,3,0,0.429856589742681,0.256736264558642,0.313407145698677,1.54630603378668,1.19695770165467,2,6,3,3,0.349348332132011,-7,-2,0,0
"597","D2",10,"21.06.2020","No","Erzgebirge Aue","Hannover",2,1,9,16,3,7,5,13,1,3,0,0,3.31,3.63,2.04,1.57,2.35,3,0,0.282933874350951,0.257992045207065,0.459074080441984,1.10679366825992,1.63521428653302,1,-7,-4,3,-0.528420618273099,-8,-2,0,0
"598","D2",10,"21.06.2020","No","Heidenheim","Hamburg",2,1,15,13,5,4,17,8,2,3,0,0,3.09,3.54,2.17,1.71,2.12,3,0,0.303320342576908,0.264762671910352,0.43191698551274,1.17472369964108,1.56051362844857,1,2,1,3,-0.385789928807496,9,-1,0,0
"599","D2",10,"21.06.2020","No","Karlsruhe","Bielefeld",3,3,11,10,5,4,17,12,2,1,0,0,2.16,3.43,3.2,1.82,1.96,1,1,0.433888871319693,0.273236140539515,0.292874988140793,1.57490275449859,1.15186110496189,0,1,1,0,0.4230416495367,5,1,0,0
"600","D2",10,"21.06.2020","No","Nurnberg","Stuttgart",0,6,5,15,0,9,15,15,2,1,0,0,3.25,3.4,2.16,1.79,2,0,3,0.28897458093964,0.276225702368773,0.434799716691587,1.14314944518769,1.58062485244353,-6,-10,-9,-3,-0.437475407255843,0,1,0,0
"601","D2",10,"21.06.2020","No","Osnabruck","Holstein Kiel",4,1,21,8,9,1,8,3,0,2,0,1,2.19,3.53,3.05,1.66,2.19,3,0,0.42763745844372,0.265304825493412,0.307057716062868,1.54821720082457,1.18647797368202,3,13,8,3,0.361739227142556,5,-2,-1,0
"602","D2",10,"21.06.2020","No","Sandhausen","Dresden",0,1,11,17,5,4,21,16,6,3,1,1,1.66,3.9,4.87,1.81,1.97,0,3,0.56609003552779,0.240951143327213,0.192958821144996,1.93922124991058,0.819827606762202,-1,-6,1,-3,1.11939364314838,5,3,0,0
"603","D2",10,"21.06.2020","No","St Pauli","Regensburg",1,1,13,6,6,2,12,12,3,0,0,0,2.14,3.38,3.3,1.74,2.07,1,1,0.438284896971221,0.277493988023199,0.28422111500558,1.59234867893686,1.13015733303994,0,7,4,0,0.462191345896924,0,3,0,0
"604","D2",10,"28.06.2020","No","Bielefeld","Heidenheim",3,0,14,6,9,1,4,9,0,1,0,0,3.12,3.45,2.19,1.71,2.11,3,0,0.300390023973951,0.271657065159051,0.427952910866998,1.1728271370809,1.55551579776005,3,8,8,3,-0.382688660679143,-5,-1,0,0
"605","D2",10,"28.06.2020","No","Dresden","Osnabruck",2,2,21,15,5,7,17,9,3,2,0,0,2.78,3.4,2.42,1.67,2.17,1,1,0.337108113866173,0.275635457808224,0.387256428325604,1.28695979940674,1.43740474278503,0,6,-2,0,-0.150444943378292,8,1,0,0
"606","D2",10,"28.06.2020","No","Greuther Furth","Karlsruhe",1,2,9,14,4,6,17,13,3,2,0,0,3.4,3.63,2.01,1.7,2.13,0,3,0.275620176561916,0.258156639203998,0.466223184234086,1.08501716888975,1.65682619190626,-1,-5,-2,-3,-0.571809023016512,4,1,0,0
"607","D2",10,"28.06.2020","No","Hamburg","Sandhausen",1,5,7,8,2,2,8,17,0,2,0,0,1.33,5.2,8.06,1.54,2.41,0,3,0.703837925162642,0.18002008470506,0.116141990132297,2.29153386019299,0.528446055101952,-4,-1,0,-3,1.76308780509104,-9,-2,0,0
"608","D2",10,"28.06.2020","No","Hannover","Bochum",2,0,11,20,2,5,13,12,2,0,0,0,2.09,3.64,3.18,1.5,2.53,3,0,0.448147431182005,0.257315420651206,0.294537148166789,1.60175771419722,1.14092686515157,2,-9,-3,3,0.460830849045647,1,2,0,0
"609","D2",10,"28.06.2020","No","Holstein Kiel","Nurnberg",1,1,13,13,5,1,15,16,0,4,0,0,3.32,3.66,2.03,1.57,2.34,1,1,0.28228079906993,0.256057992598953,0.461661208331117,1.10290038980874,1.6410416175923,0,0,4,0,-0.538141227783561,-1,-4,0,0
"610","D2",10,"28.06.2020","No","Regensburg","Erzgebirge Aue",1,2,19,16,6,4,16,15,4,4,0,0,2.05,3.64,3.28,1.52,2.47,0,3,0.45699937225361,0.257376020087884,0.285624607658506,1.62837413684871,1.1142498430634,-1,3,2,-3,0.514124293785311,1,0,0,0
"611","D2",10,"28.06.2020","No","Stuttgart","Darmstadt",1,3,11,6,3,4,13,12,2,3,0,1,1.57,4.23,5.17,1.46,2.64,0,3,0.597074297446426,0.221609136404466,0.181316566149108,2.01283202874374,0.76555883485179,-2,5,-1,-3,1.24727319389195,1,-1,-1,0
"612","D2",10,"28.06.2020","No","Wehen","St Pauli",5,3,23,12,8,5,11,9,0,1,0,0,2.27,3.59,2.87,1.51,2.48,3,0,0.412668469009713,0.260935215780515,0.326396315209773,1.49894062280965,1.24012416140983,2,11,3,3,0.25881646139982,2,-1,0,0
"613","E0",10,"09.08.2019","Yes","Liverpool","Norwich",4,1,15,12,7,5,9,9,0,2,0,0,1.14,8.75,19.83,1.41,2.92,3,0,0.841910742540893,0.109688942456756,0.0484003150023509,2.63542117007943,0.254889887463809,3,3,2,3,2.38053128261563,0,-2,0,0
"614","E0",10,"10.08.2019","Yes","West Ham","Man City",0,5,5,14,3,9,6,13,2,2,0,0,11.84,6.28,1.25,1.48,2.65,0,3,0.0809234968847031,0.152569140623389,0.766507362491908,0.395339631277498,2.45209122809911,-5,-9,-6,-3,-2.05675159682161,-7,0,0,0
"615","E0",10,"10.08.2019","Yes","Bournemouth","Sheffield United",1,1,13,8,3,3,10,19,2,1,0,0,2.01,3.53,3.83,1.9,1.93,1,1,0.47750719621382,0.271895032405036,0.250597771381143,1.7044166210465,1.02368834654847,0,5,0,0,0.680728274498031,-9,1,0,0
"616","E0",10,"10.08.2019","Yes","Burnley","Southampton",3,0,10,11,4,3,6,12,0,0,0,0,2.68,3.22,2.78,2.12,1.73,3,0,0.357611978459228,0.297639783313891,0.344748238226881,1.37047571869157,1.33188449799454,3,-1,1,3,0.0385912206970389,-6,0,0,0
"617","E0",10,"10.08.2019","Yes","Crystal Palace","Everton",0,0,6,10,2,3,16,14,2,1,0,1,3.13,3.27,2.4,2.18,1.7,1,1,0.306621189211998,0.293493676524022,0.39988513426398,1.21335724416001,1.49314907931596,0,-4,-1,0,-0.279791835155948,2,1,-1,0
"618","E0",10,"10.08.2019","Yes","Watford","Brighton",0,3,11,5,3,3,15,11,0,1,0,0,1.94,3.41,4.26,2.16,1.71,0,3,0.493994504597639,0.281040861853202,0.224964633549159,1.76302437564612,0.95593476250068,-3,6,0,-3,0.807089613145438,4,-1,0,0
"619","E0",10,"10.08.2019","Yes","Tottenham","Aston Villa",3,1,31,7,7,4,13,9,1,0,0,0,1.3,5.53,10.51,1.65,2.26,3,0,0.735958051114125,0.173010030099161,0.0910319187867138,2.38088418344154,0.446105786459303,2,24,3,3,1.93477839698223,4,1,0,0
"620","E0",10,"11.08.2019","Yes","Leicester","Wolves",0,0,15,8,1,2,3,13,0,2,0,0,2.22,3.28,3.48,2.17,1.7,1,1,0.432010173494414,0.292397129621219,0.275592696884367,1.58842765010446,1.11917522027432,0,7,-1,0,0.469252429830139,-10,-2,0,0
"621","E0",10,"11.08.2019","Yes","Newcastle","Arsenal",0,1,9,8,2,2,12,7,1,3,0,0,4.49,3.82,1.79,1.77,2.07,0,3,0.213503108343976,0.250949988603259,0.535546903052765,0.891459313635186,1.85759069776156,-1,1,0,-3,-0.96613138412637,5,-2,0,0
"622","E0",10,"11.08.2019","Yes","Man United","Chelsea",4,0,11,18,5,7,15,13,3,4,0,0,2.19,3.32,3.49,2.01,1.83,3,0,0.437226186478093,0.288411249514164,0.274362564007743,1.60008980894844,1.11149894153739,4,-7,-2,3,0.48859086741105,2,-1,0,0
"623","E0",10,"17.08.2019","Yes","Arsenal","Burnley",2,1,16,18,9,5,13,11,2,1,0,0,1.33,5.49,9.48,1.6,2.34,3,0,0.723299048159065,0.175225452468407,0.101475499372527,2.3451225969456,0.479651950585989,1,-2,4,3,1.86547064635961,2,1,0,0
"624","E0",10,"17.08.2019","Yes","Aston Villa","Bournemouth",1,2,22,12,7,4,10,13,0,2,0,0,2.33,3.49,3.08,1.81,2.03,0,3,0.41252163501207,0.275408426813215,0.312069938174715,1.51297333184942,1.21161824133736,-1,10,3,-3,0.301355090512064,-3,-2,0,0
"625","E0",10,"17.08.2019","Yes","Brighton","West Ham",1,1,16,8,4,3,11,10,0,2,0,0,2.52,3.33,2.9,1.95,1.87,1,1,0.380847589976574,0.288208987009299,0.330943423014126,1.43075175693902,1.28103925605168,0,8,1,0,0.149712500887343,1,-2,0,0
"626","E0",10,"17.08.2019","Yes","Everton","Watford",1,0,12,8,2,2,11,11,2,3,0,0,1.73,3.9,4.86,1.79,2.05,3,0,0.555692372642837,0.246499437095412,0.197808190261751,1.91357655502392,0.839924007880664,1,4,0,3,1.07365254714326,0,-1,0,0
"627","E0",10,"17.08.2019","Yes","Norwich","Newcastle",3,1,15,10,8,3,9,11,1,3,0,0,2.23,3.38,3.38,1.95,1.88,3,0,0.431122448979592,0.284438775510204,0.284438775510204,1.57780612244898,1.13775510204082,2,5,5,3,0.440051020408163,-2,-2,0,0
"628","E0",10,"17.08.2019","Yes","Southampton","Liverpool",1,2,14,15,3,6,10,6,2,1,0,0,6.77,4.67,1.47,1.64,2.28,0,3,0.141741013819176,0.205478942945572,0.652780043235252,0.6307019844031,2.16381907265133,-1,-1,-3,-3,-1.53311708824823,4,1,0,0
"629","E0",10,"17.08.2019","Yes","Man City","Tottenham",2,2,30,3,10,2,14,4,1,0,0,0,1.36,5.32,8.46,1.52,2.55,1,1,0.706017443684508,0.180485662295288,0.113496894020205,2.29853799334881,0.520976344355901,0,27,8,0,1.77756164899291,10,1,0,0
"630","E0",10,"18.08.2019","Yes","Sheffield United","Crystal Palace",1,0,15,6,3,4,16,11,3,1,0,0,2.57,3.19,2.95,2.37,1.6,3,0,0.37357633692334,0.300969023790904,0.325454639285757,1.42169803456092,1.27733294164817,1,9,-1,3,0.144365092912748,5,2,0,0
"631","E0",10,"18.08.2019","Yes","Chelsea","Leicester",1,1,14,12,5,3,9,14,1,0,0,0,1.73,3.77,5.07,1.96,1.86,1,1,0.555521970756036,0.254921222654627,0.189556806589338,1.92148713492273,0.823591642422639,0,2,2,0,1.09789549250009,-5,1,0,0
"632","E0",10,"19.08.2019","Yes","Wolves","Man United",1,1,6,9,2,2,17,8,2,2,0,0,3.32,3.28,2.3,2.12,1.74,1,1,0.289379200294596,0.292908214932335,0.417712584773069,1.16104581581612,1.54604596925154,0,-3,0,0,-0.385000153435419,9,0,0,0
"633","E0",10,"23.08.2019","Yes","Aston Villa","Everton",2,0,7,12,3,1,10,18,2,3,0,0,3.16,3.5,2.27,1.79,2.05,3,0,0.303496802683148,0.274014256136786,0.422488941180066,1.18450466418623,1.54148107967698,2,-5,2,3,-0.356976415490752,-8,-1,0,0
"634","E0",10,"24.08.2019","Yes","Norwich","Chelsea",2,3,6,23,5,8,9,9,1,1,0,0,4.18,3.92,1.83,1.56,2.44,0,3,0.229859718154611,0.245105515787315,0.525034766058074,0.934684670251149,1.82020981396154,-1,-17,-3,-3,-0.885525143710387,0,0,0,0
"635","E0",10,"24.08.2019","Yes","Brighton","Southampton",0,2,12,12,3,4,9,10,1,3,1,0,2.43,3.25,3.08,2.1,1.75,0,3,0.394220204080829,0.294755414128128,0.311024381791044,1.47741602637061,1.22782855950126,-2,0,-1,-3,0.249587466869356,-1,-2,1,0
"636","E0",10,"24.08.2019","Yes","Man United","Crystal Palace",1,2,22,5,3,3,8,18,2,4,0,0,1.36,5.06,9.16,1.76,2.09,0,3,0.705593647623339,0.189645723471886,0.104760628904775,2.3064266663419,0.503927610186211,-1,17,0,-3,1.80249905615569,-10,-2,0,0
"637","E0",10,"24.08.2019","Yes","Sheffield United","Leicester",1,2,8,10,3,2,11,6,1,0,0,0,3.45,3.23,2.26,2.3,1.63,0,3,0.278190417030293,0.297138371131428,0.424671211838279,1.13170962222231,1.57115200664627,-1,-2,1,-3,-0.439442384423959,5,1,0,0
"638","E0",10,"24.08.2019","Yes","Watford","West Ham",1,3,23,16,3,10,12,11,1,1,0,0,2.13,3.53,3.47,1.73,2.13,0,3,0.451012736062682,0.272140829408927,0.27684643452839,1.62517903759697,1.1026801329941,-2,7,-7,-3,0.522498904602877,1,0,0,0
"639","E0",10,"24.08.2019","Yes","Liverpool","Arsenal",3,1,25,9,5,3,8,5,1,1,0,0,1.5,4.76,6.09,1.44,2.79,3,0,0.640437969750394,0.201818687946553,0.157743342303053,2.12313259719774,0.675048714855711,2,16,2,3,1.44808388234202,3,0,0,0
"640","E0",10,"25.08.2019","Yes","Bournemouth","Man City",1,3,10,19,7,5,7,13,1,3,0,0,14.52,7.28,1.19,1.37,3.08,0,3,0.0658059850692303,0.131250398791926,0.802943616138843,0.328668353999617,2.54008124720846,-2,-9,2,-3,-2.21141289320884,-6,-2,0,0
"641","E0",10,"25.08.2019","Yes","Tottenham","Newcastle",0,1,17,8,2,3,10,5,2,2,0,0,1.24,6.26,12.35,1.55,2.47,0,3,0.770126529823464,0.152549025076852,0.0773244450996838,2.46292861454724,0.384522360375904,-1,9,-1,-3,2.07840625417134,5,0,0,0
"642","E0",10,"25.08.2019","Yes","Wolves","Burnley",1,1,17,13,2,4,9,11,0,2,0,0,1.85,3.43,4.78,2.29,1.63,1,1,0.519106253502576,0.27998442244308,0.200909324054344,1.83730318295081,0.882712394606113,0,4,-2,0,0.954590788344695,-2,-2,0,0
"643","E0",10,"31.08.2019","Yes","Southampton","Man United",1,1,10,21,2,8,17,7,1,2,1,0,3.75,3.38,2.1,1.9,1.94,1,1,0.256727430555556,0.284830729166667,0.458441840277778,1.05501302083333,1.66015625,0,-11,-6,0,-0.605143229166667,10,-1,1,0
"644","E0",10,"31.08.2019","Yes","Chelsea","Sheffield United",2,2,13,8,5,2,6,11,0,1,0,0,1.36,4.98,9.53,1.73,2.13,1,1,0.70631464587085,0.192889140237822,0.100796213891328,2.31183307785037,0.495277781911806,0,5,3,0,1.81655529593856,-5,-1,0,0
"645","E0",10,"31.08.2019","Yes","Crystal Palace","Aston Villa",1,0,22,10,5,2,15,16,2,4,0,1,2.21,3.38,3.43,1.97,1.86,3,0,0.435130519638936,0.284508416686997,0.280361063674067,1.58989997560381,1.1255916077092,1,12,3,3,0.464308367894608,-1,-2,-1,0
"646","E0",10,"31.08.2019","Yes","Leicester","Bournemouth",3,1,13,8,5,2,9,11,1,3,0,0,1.72,4.02,4.81,1.65,2.26,3,0,0.560083188988466,0.239637583348299,0.200279227663235,1.9198871503137,0.840475266338004,2,5,3,3,1.07941188397569,-2,-2,0,0
"647","E0",10,"31.08.2019","Yes","Man City","Brighton",4,0,15,6,6,2,10,6,1,1,0,0,1.09,11.73,30.92,1.3,3.53,3,0,0.886386214774374,0.0823666644589998,0.0312471207666257,2.74152530878212,0.176108026758877,4,9,4,3,2.56541728202325,4,0,0,0
"648","E0",10,"31.08.2019","Yes","Newcastle","Watford",1,1,13,13,5,3,5,11,2,3,0,0,2.63,3.24,2.86,2.08,1.77,1,1,0.366124838992627,0.297193927947719,0.336681233059654,1.3955684449256,1.30723762712668,0,0,2,0,0.0883308177989204,-6,-1,0,0
"649","E0",10,"31.08.2019","Yes","West Ham","Norwich",2,0,18,8,8,3,16,10,2,1,0,0,1.89,3.91,3.92,1.48,2.64,3,0,0.508771522178591,0.245927922485303,0.245300555336106,1.77224248902108,0.981829588493622,2,10,5,3,0.790412900527453,6,1,0,0
"650","E0",10,"31.08.2019","Yes","Burnley","Liverpool",0,3,7,15,2,7,10,16,0,0,0,0,9.45,5.43,1.33,1.61,2.33,0,3,0.101568268407218,0.176762456067811,0.721669275524971,0.481467261289465,2.34177028264272,-3,-8,-5,-3,-1.86030302135326,-6,0,0,0
"651","E0",10,"01.09.2019","Yes","Everton","Wolves",3,2,15,8,6,5,12,12,1,4,0,1,2.17,3.29,3.65,2.25,1.66,3,0,0.443637021903851,0.292611652745093,0.263751325351056,1.62352271845665,1.08386562879826,1,7,1,3,0.539657089658383,0,-3,-1,0
"652","E0",10,"01.09.2019","Yes","Arsenal","Tottenham",2,2,26,13,8,9,13,19,3,5,0,0,2.38,3.63,2.9,1.57,2.4,1,1,0.403822252228752,0.264765002838686,0.331412744932562,1.47623175952494,1.25900323763637,0,13,-1,0,0.21722852188857,-6,-2,0,0
"653","E0",10,"14.09.2019","Yes","Liverpool","Newcastle",3,1,21,8,9,1,5,4,0,0,0,0,1.15,8.27,19.45,1.42,2.89,3,0,0.834597194513554,0.116056441800555,0.0493463636858914,2.61984802534122,0.264095532858229,2,13,8,3,2.35575249248299,1,0,0,0
"654","E0",10,"14.09.2019","Yes","Brighton","Burnley",1,1,14,7,5,1,13,7,0,2,0,0,2.15,3.34,3.62,2.09,1.76,1,1,0.446900365184736,0.287675384774606,0.265424250040658,1.62837648032881,1.08394813489658,0,7,4,0,0.544428345432234,6,-2,0,0
"655","E0",10,"14.09.2019","Yes","Man United","Leicester",1,0,10,9,5,3,14,14,1,2,0,0,1.94,3.55,4.12,1.85,1.98,3,0,0.49569915067546,0.270889113326871,0.233411735997668,1.75798656535325,0.971124321319876,1,1,2,3,0.786862244033377,0,-1,0,0
"656","E0",10,"14.09.2019","Yes","Sheffield United","Southampton",0,1,17,11,4,7,10,7,1,1,1,0,2.46,3.26,3.06,2.18,1.7,0,3,0.39085053364051,0.294936292256336,0.314213174103155,1.46748789317786,1.2375758145658,-1,6,-3,-3,0.229912078612065,3,0,1,0
"657","E0",10,"14.09.2019","Yes","Tottenham","Crystal Palace",4,0,13,11,5,6,19,11,4,2,0,0,1.39,5,8.24,1.64,2.28,3,0,0.691233415431283,0.192162889489897,0.116603695078821,2.26586313578374,0.541973974726359,4,2,-1,3,1.72388916105739,8,2,0,0
"658","E0",10,"14.09.2019","Yes","Wolves","Chelsea",2,5,11,15,4,6,8,11,1,2,0,0,2.97,3.36,2.46,1.97,1.86,0,3,0.323494188094399,0.285945755547728,0.390560056357873,1.25642831983093,1.45762592462135,-3,-4,-2,-3,-0.201197604790419,-3,-1,0,0
"659","E0",10,"14.09.2019","Yes","Norwich","Man City",3,2,7,25,3,8,8,7,3,1,0,0,17.04,9.03,1.15,1.23,4.15,3,0,0.0564830240895243,0.106585905923089,0.836931069987387,0.276034978191662,2.61737911588525,1,-18,-5,3,-2.34134413769359,1,2,0,0
"660","E0",10,"15.09.2019","Yes","Bournemouth","Everton",3,1,13,14,6,5,5,14,0,4,0,0,3.01,3.48,2.37,1.75,2.1,3,0,0.318980820773435,0.275900077737942,0.405119101488624,1.23284254005825,1.49125738220381,2,-1,1,3,-0.258414842145567,-9,-4,0,0
"661","E0",10,"15.09.2019","Yes","Watford","Arsenal",2,2,31,10,7,4,14,4,3,3,0,0,3.64,3.74,2.01,1.57,2.41,1,1,0.264256135885881,0.25719046380337,0.478553400310749,1.04995887146101,1.69285066473562,0,21,3,0,-0.642891793274605,10,0,0,0
"662","E0",10,"16.09.2019","Yes","Aston Villa","West Ham",0,0,10,13,5,1,13,12,2,1,0,1,2.64,3.56,2.63,1.62,2.31,1,1,0.364248922363486,0.270117178381911,0.365633899254602,1.36286394547237,1.36701887614572,0,-3,4,0,-0.00415493067334793,1,1,-1,0
"663","E0",10,"20.09.2019","Yes","Southampton","Bournemouth",1,3,25,6,6,3,8,9,1,3,0,0,2.1,3.62,3.5,1.69,2.21,0,3,0.458692346680182,0.266092245311708,0.27521540800811,1.64216928535226,1.09173846933604,-2,19,3,-3,0.550430816016219,-1,-2,0,0
"664","E0",10,"21.09.2019","Yes","Leicester","Tottenham",2,1,16,11,7,4,16,13,1,2,0,0,2.87,3.5,2.45,1.79,2.04,3,0,0.334288443170965,0.274116523400191,0.391595033428844,1.27698185291308,1.44890162368672,1,5,3,3,-0.171919770773639,3,-1,0,0
"665","E0",10,"21.09.2019","Yes","Burnley","Norwich",2,0,13,11,6,2,11,10,0,1,0,0,1.99,3.76,3.67,1.67,2.22,3,0,0.482744386021991,0.255495034091426,0.261760579886584,1.7037281921574,1.04077677375118,2,2,4,3,0.662951418406221,1,-1,0,0
"666","E0",10,"21.09.2019","Yes","Everton","Sheffield United",0,2,16,2,3,1,9,9,1,3,0,0,1.67,3.8,5.58,2.03,1.81,0,3,0.575123546866439,0.252751664017619,0.172124789115942,1.97812230461694,0.769126031365444,-2,14,2,-3,1.20899627325149,0,-2,0,0
"667","E0",10,"21.09.2019","Yes","Man City","Watford",8,0,28,5,11,4,5,9,2,2,0,0,1.11,10.24,23.21,1.25,3.91,3,0,0.86488532201067,0.093752217522641,0.0413624604666887,2.68840818355465,0.217839598922707,8,23,7,3,2.47056858463194,-4,0,0,0
"668","E0",10,"21.09.2019","Yes","Newcastle","Brighton",0,0,11,16,4,3,12,8,2,1,0,0,2.5,3.16,3.07,2.35,1.61,1,1,0.383807692612022,0.303645326433562,0.312546980954416,1.45506840426963,1.24128626929681,0,-5,1,0,0.21378213497282,4,1,0,0
"669","E0",10,"22.09.2019","Yes","Crystal Palace","Wolves",1,1,13,14,4,4,7,10,2,1,0,1,2.64,3.11,2.93,2.37,1.59,1,1,0.363649787093092,0.308693066857159,0.327657146049749,1.39964242813644,1.29166450500641,0,-1,0,0,0.107977923130031,-3,1,-1,0
"670","E0",10,"22.09.2019","Yes","West Ham","Man United",2,0,8,9,6,3,8,9,2,2,0,0,3.24,3.59,2.21,1.69,2.2,3,0,0.296861845625405,0.267919882959975,0.43521827141462,1.15850541983619,1.57357469720384,2,-1,3,3,-0.415069277367647,-1,0,0,0
"671","E0",10,"22.09.2019","Yes","Arsenal","Aston Villa",3,2,21,14,6,9,13,15,5,1,1,0,1.42,4.9,7.49,1.45,2.77,3,0,0.675957918622041,0.195889845804755,0.128152235573204,2.22376360167088,0.580346552524367,1,7,-3,3,1.64341704914651,-2,4,1,0
"672","E0",10,"22.09.2019","Yes","Chelsea","Liverpool",1,2,13,6,2,3,8,13,3,3,0,0,3.58,3.69,2.04,1.59,2.37,0,3,0.268449769979673,0.260447202310902,0.471103027709425,1.06579651224992,1.67375628543918,-1,7,-1,-3,-0.607959773189259,-5,0,0,0
"673","E0",10,"28.09.2019","Yes","Sheffield United","Liverpool",0,1,12,16,2,4,8,4,1,1,0,0,8.9,5.17,1.36,1.62,2.32,0,3,0.107926235874514,0.185791779358447,0.706281984767039,0.509570486981989,2.30463773365956,-1,-4,-2,-3,-1.79506724667758,4,0,0,0
"674","E0",10,"28.09.2019","Yes","Aston Villa","Burnley",2,2,16,10,3,3,10,16,1,4,0,0,2.38,3.38,3.08,1.91,1.92,1,1,0.403735476164622,0.284287110435444,0.311977413399935,1.49549353892931,1.22021935063525,0,6,0,0,0.27527418829406,-6,-3,0,0
"675","E0",10,"28.09.2019","Yes","Bournemouth","West Ham",2,2,13,17,5,6,7,8,3,1,0,0,2.48,3.56,2.79,1.57,2.41,1,1,0.38676967648479,0.26943505552873,0.34379526798648,1.4297440849831,1.30082085948817,0,-4,-1,0,0.12892322549493,-1,2,0,0
"676","E0",10,"28.09.2019","Yes","Chelsea","Brighton",2,0,24,8,10,1,5,13,2,3,0,0,1.44,4.64,7.64,1.65,2.27,3,0,0.667188629245965,0.207058540110817,0.125752830643218,2.20862442784871,0.584317032040472,2,16,9,3,1.62430739580824,-8,-1,0,0
"677","E0",10,"28.09.2019","Yes","Crystal Palace","Norwich",2,0,15,10,3,3,14,10,3,1,0,0,1.94,3.75,3.88,1.72,2.14,3,0,0.495703899537343,0.256444150693985,0.247851949768672,1.74355584930601,1,2,5,0,3,0.743555849306015,4,2,0,0
"678","E0",10,"28.09.2019","Yes","Tottenham","Southampton",2,1,9,14,4,6,5,16,0,2,1,0,1.44,4.67,7.61,1.61,2.35,3,0,0.667745796373297,0.205900202736092,0.126354000890611,2.20913759185598,0.584962205407924,1,-5,-2,3,1.62417538644806,-11,-2,1,0
"679","E0",10,"28.09.2019","Yes","Wolves","Watford",2,0,6,14,2,5,5,6,0,1,0,0,1.89,3.49,4.46,1.99,1.84,3,0,0.50882451971011,0.275552533596592,0.215622946693298,1.80202609272692,0.922421373676485,2,-8,-3,3,0.879604719050437,-1,-1,0,0
"680","E0",10,"28.09.2019","Yes","Everton","Man City",1,3,12,20,8,9,4,8,2,2,0,0,9.84,5.86,1.3,1.47,2.69,0,3,0.0975760960339377,0.163847915524564,0.738575988441498,0.456576203626378,2.37957588084906,-2,-8,-1,-3,-1.92299967722268,-4,0,0,0
"681","E0",10,"29.09.2019","Yes","Leicester","Newcastle",5,0,13,3,5,0,12,9,1,1,0,1,1.53,4.09,7.06,2.08,1.77,3,0,0.628615714848623,0.235154533916477,0.1362297512349,2.12100167846235,0.643843787621177,5,10,5,3,1.47715789084117,3,0,-1,0
"682","E0",10,"30.09.2019","Yes","Man United","Arsenal",1,1,16,10,4,5,18,13,4,2,0,0,2.36,3.53,2.99,1.63,2.28,1,1,0.406859173769076,0.272007832888108,0.321132993342816,1.49258535419534,1.23540681291656,0,6,-1,0,0.257178541278781,5,2,0,0
"683","E0",10,"05.10.2019","Yes","Brighton","Tottenham",3,0,17,8,6,3,11,7,2,1,0,0,3.9,3.63,1.96,1.76,2.09,3,0,0.246052331251427,0.264353744319714,0.489593924428859,1.00251073807399,1.73313551760629,3,9,3,3,-0.730624779532297,4,1,0,0
"684","E0",10,"05.10.2019","Yes","Burnley","Everton",1,0,9,11,3,2,5,12,2,1,0,1,2.93,3.3,2.52,2.12,1.74,3,0,0.327806816300466,0.291052718715262,0.381140464984272,1.27447316761666,1.43447411366808,1,-2,1,3,-0.160000946051418,-7,1,-1,0
"685","E0",10,"05.10.2019","Yes","Liverpool","Leicester",2,1,18,2,8,1,9,17,1,4,0,0,1.46,4.66,7,1.61,2.34,3,0,0.657083692560572,0.20586742299108,0.137048884448348,2.1771185006728,0.617014076336124,1,16,7,3,1.56010442433667,-8,-3,0,0
"686","E0",10,"05.10.2019","Yes","Norwich","Aston Villa",1,5,21,22,5,12,14,17,1,3,0,0,2.41,3.6,2.85,1.57,2.43,0,3,0.397605068883334,0.266174504446899,0.336220426669767,1.4589897110969,1.2748357844562,-4,-1,-7,-3,0.184153926640702,-3,-2,0,0
"687","E0",10,"05.10.2019","Yes","Watford","Sheffield United",0,0,8,9,2,3,7,6,0,2,0,0,2.14,3.38,3.58,2,1.84,1,1,0.448249292456325,0.283802806466431,0.267947901077244,1.62855068383541,1.08764650969816,0,-1,-1,0,0.540904174137241,1,-2,0,0
"688","E0",10,"05.10.2019","Yes","West Ham","Crystal Palace",1,2,9,7,4,4,11,7,3,2,0,0,2,3.58,3.8,1.83,2,0,3,0.479622056127486,0.267945282752785,0.252432661119729,1.70681145113524,1.02524326611197,-1,2,0,-3,0.681568185023269,4,1,0,0
"689","E0",10,"06.10.2019","Yes","Arsenal","Bournemouth",1,0,12,10,2,2,12,6,1,2,0,0,1.45,4.97,6.68,1.35,3.2,3,0,0.662771175494739,0.193363823836493,0.143865000668768,2.18167735032071,0.624958825842798,1,2,0,3,1.55671852447791,6,-1,0,0
"690","E0",10,"06.10.2019","Yes","Man City","Wolves",0,2,18,7,2,2,11,14,5,2,0,0,1.13,9.26,21.61,1.38,3.08,0,3,0.85155603368119,0.103915585103644,0.0445283812151663,2.65858368614721,0.237500728749143,-2,11,0,-3,2.42108295739807,-3,3,0,0
"691","E0",10,"06.10.2019","Yes","Southampton","Chelsea",1,4,10,13,3,7,8,15,0,1,0,0,4.02,3.84,1.87,1.7,2.18,0,3,0.238287705326033,0.249457441513191,0.512254853160776,0.964320557491289,1.78622200099552,-3,-3,-4,-3,-0.821901443504231,-7,-1,0,0
"692","E0",10,"06.10.2019","Yes","Newcastle","Man United",1,0,12,12,2,3,12,10,3,3,0,0,4.42,3.44,1.9,2.16,1.71,3,0,0.216863312407926,0.278644139779951,0.504492547812122,0.92923407700373,1.79212178321632,1,0,-1,3,-0.862887706212589,2,0,0,0
"693","E0",10,"19.10.2019","Yes","Everton","West Ham",2,0,19,8,10,4,15,15,2,2,0,0,1.97,3.71,3.81,1.72,2.14,3,0,0.48826750030225,0.259268726575588,0.252463773122161,1.72407122748234,1.01666004594207,2,11,6,3,0.707411181540268,0,0,0,0
"694","E0",10,"19.10.2019","Yes","Aston Villa","Brighton",2,1,24,20,8,5,9,17,1,2,0,1,2.38,3.43,3.05,1.82,2.01,3,0,0.404170159829083,0.280444600697731,0.315385239473186,1.49295508018498,1.22660031911729,1,4,3,3,0.266354761067691,-8,-1,-1,0
"695","E0",10,"19.10.2019","Yes","Bournemouth","Norwich",0,0,11,10,2,1,8,11,1,3,0,0,1.73,4.33,4.35,1.41,2.94,1,1,0.556408946026663,0.22230657658802,0.221284477385317,1.89153341466801,0.88616000874397,0,1,1,0,1.00537340592404,-3,-2,0,0
"696","E0",10,"19.10.2019","Yes","Chelsea","Newcastle",1,0,16,5,8,0,9,12,2,1,0,0,1.31,5.62,10.38,1.59,2.38,3,0,0.735672597218509,0.171482402554492,0.0928450002269987,2.37850019421002,0.450017403235488,1,11,8,3,1.92848279097453,-3,1,0,0
"697","E0",10,"19.10.2019","Yes","Leicester","Burnley",2,1,19,13,3,4,4,10,0,3,0,0,1.57,4.09,6.37,1.94,1.89,3,0,0.613372414686113,0.235451024708361,0.151176560605526,2.0755682687667,0.688980706524938,1,6,-1,3,1.38658756224176,-6,-3,0,0
"698","E0",10,"19.10.2019","Yes","Tottenham","Watford",1,1,12,7,2,2,5,9,4,3,0,0,1.42,4.9,7.48,1.53,2.52,1,1,0.675842128943273,0.195856290428459,0.128301580628268,2.22338267725828,0.580761032313264,0,5,0,0,1.64262164494501,-4,1,0,0
"699","E0",10,"19.10.2019","Yes","Wolves","Southampton",1,1,4,14,1,5,10,17,3,2,0,0,1.85,3.58,4.52,2.09,1.76,1,1,0.519196832506594,0.268300039144469,0.212503128348938,1.82589053666425,0.905809424191282,0,-10,-4,0,0.920081112472968,-7,1,0,0
"700","E0",10,"19.10.2019","Yes","Crystal Palace","Man City",0,2,7,21,2,10,8,10,1,1,0,0,11.88,6.72,1.24,1.44,2.81,0,3,0.0809814806176237,0.143163688949013,0.775854830433363,0.386108130801885,2.4707281802491,-2,-14,-8,-3,-2.08462004944722,-2,0,0,0
"701","E0",10,"20.10.2019","Yes","Man United","Liverpool",1,1,7,10,2,4,6,14,0,1,0,0,5.03,3.96,1.7,1.76,2.08,1,1,0.191240220670534,0.242913714639592,0.565846064689874,0.816634376651194,1.94045190870921,0,-3,-2,0,-1.12381753205802,-8,-1,0,0
"702","E0",10,"21.10.2019","Yes","Sheffield United","Arsenal",1,0,8,9,2,3,10,12,4,4,0,0,3.88,3.79,1.93,1.69,2.19,3,0,0.247886187953898,0.25377266735122,0.498341144694882,0.997431231212913,1.74879610143587,1,-1,-1,3,-0.751364870222954,-2,0,0,0
"703","E0",10,"25.10.2019","Yes","Southampton","Leicester",0,9,6,25,3,15,3,12,0,0,1,0,3.2,3.34,2.36,2.01,1.83,0,3,0.301748690778795,0.289100542063516,0.409150767157688,1.1943466143999,1.51655284353658,-9,-19,-12,-3,-0.32220622913668,-9,0,1,0
"704","E0",10,"26.10.2019","Yes","Man City","Aston Villa",3,0,25,11,9,5,10,5,1,1,1,0,1.09,11.64,28.3,1.21,4.45,3,0,0.883268543003207,0.0827115731850083,0.0340198838117843,2.73251720219463,0.184771224620361,3,14,4,3,2.54774597757427,5,0,1,0
"705","E0",10,"26.10.2019","Yes","Brighton","Everton",3,2,8,10,4,6,12,12,2,1,0,0,2.87,3.3,2.58,2.06,1.78,3,0,0.335334152566405,0.291639096322904,0.373026751110691,1.29764155402212,1.41071934965498,1,-2,-2,3,-0.113077795632858,0,1,0,0
"706","E0",10,"26.10.2019","Yes","Watford","Bournemouth",0,0,7,15,3,5,14,8,5,3,0,0,2.19,3.53,3.31,1.69,2.18,1,1,0.438206713946572,0.271861955677902,0.289931330375526,1.58648209751762,1.14165594680448,0,-8,-2,0,0.444826150713137,6,2,0,0
"707","E0",10,"26.10.2019","Yes","West Ham","Sheffield United",1,1,12,10,4,4,7,10,2,2,0,0,2.11,3.46,3.6,1.88,1.95,1,1,0.455386325248788,0.277706689674839,0.266906985076373,1.6438656654212,1.07842764490396,0,2,0,0,0.565438020517245,-3,0,0,0
"708","E0",10,"26.10.2019","Yes","Burnley","Chelsea",2,4,13,16,5,7,7,8,3,2,0,0,4.53,4.02,1.75,1.66,2.25,0,3,0.21206941769084,0.238973746800872,0.548956835508288,0.875181999873391,1.88584425332574,-2,-3,-2,-3,-1.01066225345235,-1,1,0,0
"709","E0",10,"27.10.2019","Yes","Newcastle","Wolves",1,1,13,13,2,5,8,15,2,2,1,0,3.02,3.09,2.59,2.49,1.54,1,1,0.318129961401933,0.310923133797358,0.370946904800709,1.26531301800316,1.42376384819949,0,0,-3,0,-0.158450830196329,-7,0,1,0
"710","E0",10,"27.10.2019","Yes","Arsenal","Crystal Palace",2,2,15,10,6,4,18,9,2,0,0,0,1.49,4.63,6.49,1.52,2.53,1,1,0.64457982517295,0.207434976135571,0.147985198691478,2.14117445165442,0.651390572210007,0,5,2,0,1.48978387944441,9,2,0,0
"711","E0",10,"27.10.2019","Yes","Liverpool","Tottenham",2,1,21,11,13,4,9,11,3,3,0,0,1.54,4.45,6.11,1.53,2.51,3,0,0.625737884879602,0.216547492744851,0.157714622375546,2.09376114738366,0.68969135987149,1,10,9,3,1.40406978751217,-2,0,0,0
"712","E0",10,"27.10.2019","Yes","Norwich","Man United",1,3,10,21,3,11,13,10,2,2,0,0,4.36,3.91,1.8,1.67,2.22,0,3,0.220394819249944,0.245759951900193,0.533845228849864,0.906944409650024,1.84729563844978,-2,-11,-8,-3,-0.94035122879976,3,0,0,0
"713","E0",10,"02.11.2019","Yes","Bournemouth","Man United",1,0,12,15,6,4,14,12,4,3,0,0,3.33,3.55,2.19,1.84,1.99,3,0,0.289136328643631,0.27121802095304,0.439645650403329,1.13862700688393,1.59015497216303,1,-3,2,3,-0.451527965279095,2,1,0,0
"714","E0",10,"02.11.2019","Yes","Arsenal","Wolves",1,1,10,25,4,8,6,15,0,2,0,0,1.78,3.8,4.65,1.74,2.12,1,1,0.54018525878145,0.253034147534469,0.206780593684082,1.87358992387882,0.873375928586714,0,-15,-4,0,1.0002139952921,-9,-2,0,0
"715","E0",10,"02.11.2019","Yes","Aston Villa","Liverpool",1,2,5,25,2,6,12,9,1,2,0,0,8.4,5.37,1.36,1.47,2.71,0,3,0.114407098278066,0.178960824122114,0.70663207759982,0.522182118956313,2.29885705692157,-1,-20,-4,-3,-1.77667493796526,3,-1,0,0
"716","E0",10,"02.11.2019","Yes","Brighton","Norwich",2,0,21,7,5,0,11,8,0,1,0,0,1.71,4.17,4.65,1.66,2.25,3,0,0.562488577918179,0.23066078375062,0.206850638331201,1.91812651750516,0.851212698744224,2,14,5,3,1.06691381876093,3,-1,0,0
"717","E0",10,"02.11.2019","Yes","Man City","Southampton",2,1,26,3,4,3,11,10,3,1,0,0,1.08,11.99,29.72,1.22,4.27,3,0,0.887772877025214,0.0799661974301277,0.0322609255446579,2.74328482850577,0.176748974064101,1,23,1,3,2.56653585444167,1,2,0,0
"718","E0",10,"02.11.2019","Yes","Sheffield United","Burnley",3,0,13,6,6,0,8,12,1,2,0,0,2.26,3.22,3.46,2.33,1.62,3,0,0.424620779022791,0.298025764158854,0.277353456818355,1.57188810122723,1.13008613461392,3,7,6,3,0.441801966613309,-4,-1,0,0
"719","E0",10,"02.11.2019","Yes","West Ham","Newcastle",2,3,16,12,6,9,10,7,2,1,0,0,1.79,3.82,4.55,1.83,2,0,3,0.537058952579001,0.25165851442838,0.211282532992618,1.86283537216538,0.885506113406235,-1,4,-3,-3,0.97732925875915,3,1,0,0
"720","E0",10,"02.11.2019","Yes","Watford","Chelsea",1,2,12,16,3,10,8,5,4,2,0,0,4.99,4.24,1.65,1.63,2.29,0,3,0.192265940401956,0.226275245897585,0.58145881370046,0.803073067103451,1.97065168699896,-1,-4,-7,-3,-1.16757861989551,3,2,0,0
"721","E0",10,"03.11.2019","Yes","Crystal Palace","Leicester",0,2,12,14,3,5,15,16,2,2,0,0,3.5,3.38,2.17,2.05,1.78,0,3,0.274092288375013,0.283823375536256,0.442084336088731,1.1061002406613,1.61007638380245,-2,-2,-2,-3,-0.503976143141153,-1,0,0,0
"722","E0",10,"03.11.2019","Yes","Everton","Tottenham",1,1,7,4,3,2,9,8,1,2,0,1,2.73,3.49,2.57,1.74,2.11,1,1,0.351556651288946,0.274999902011124,0.373443446699931,1.32966985587796,1.39533024211092,0,3,1,0,-0.0656603862329548,1,-1,-1,0
"723","E0",10,"08.11.2019","Yes","Norwich","Watford",0,2,17,12,5,2,7,13,1,2,0,1,2.68,3.57,2.6,1.69,2.21,0,3,0.359522186415469,0.269893406048587,0.370584407535945,1.34845996529499,1.38164662865642,-2,5,3,-3,-0.0331866633614277,-6,-1,-1,0
"724","E0",10,"09.11.2019","Yes","Chelsea","Crystal Palace",2,0,23,3,5,1,9,17,3,2,0,0,1.34,5.35,9.29,1.58,2.4,3,0,0.716995748646477,0.179583981903977,0.103420269449546,2.33057122784341,0.489844790252614,2,20,4,3,1.84072643759079,-8,1,0,0
"725","E0",10,"09.11.2019","Yes","Burnley","West Ham",3,0,14,7,12,4,17,10,2,1,0,0,2.27,3.55,3.13,1.71,2.17,3,0,0.422890873869177,0.270411910896628,0.306697215234195,1.53908453250416,1.19050355659921,3,7,8,3,0.348580975904944,7,1,0,0
"726","E0",10,"09.11.2019","Yes","Newcastle","Bournemouth",2,1,20,16,9,3,10,5,2,0,0,0,2.64,3.21,2.84,2.07,1.77,3,0,0.363371119720668,0.298847276031951,0.337781604247381,1.38896063519395,1.3121920887741,1,4,6,3,0.0767685464198591,5,2,0,0
"727","E0",10,"09.11.2019","Yes","Southampton","Everton",1,2,4,24,3,5,12,12,1,1,0,0,2.96,3.37,2.44,1.94,1.89,0,3,0.323472486664254,0.284118267218454,0.392409246117292,1.25453572721122,1.46134600557033,-1,-20,-2,-3,-0.206810278359113,0,0,0,0
"728","E0",10,"09.11.2019","Yes","Tottenham","Sheffield United",1,1,17,14,5,4,6,9,2,2,0,0,1.58,4.14,6.02,1.79,2.04,1,1,0.608235144817892,0.232128388601997,0.159636466580111,2.05683382305567,0.711037788342331,0,3,1,0,1.34579603471334,-3,0,0,0
"729","E0",10,"09.11.2019","Yes","Leicester","Arsenal",2,0,19,8,7,1,10,10,1,1,0,0,1.99,3.78,3.62,1.57,2.42,3,0,0.481654088758729,0.253569216039649,0.264776695201622,1.69853148231584,1.04789930164451,2,11,6,3,0.650632180671322,0,0,0,0
"730","E0",10,"10.11.2019","Yes","Man United","Brighton",3,1,21,6,11,2,10,14,2,5,0,0,1.67,3.67,5.82,2.02,1.82,3,0,0.574058595398264,0.261220123791581,0.164721280810155,1.98339590998637,0.755383966222045,2,15,9,3,1.22801194376433,-4,-3,0,0
"731","E0",10,"10.11.2019","Yes","Wolves","Aston Villa",2,1,17,13,5,4,17,8,4,3,0,0,1.9,3.6,4.24,1.87,1.96,3,0,0.506100795755968,0.26710875331565,0.226790450928382,1.78541114058355,0.947480106100796,1,4,1,3,0.837931034482758,9,1,0,0
"732","E0",10,"10.11.2019","Yes","Liverpool","Man City",3,1,12,18,5,3,10,5,0,2,0,0,2.56,3.58,2.68,1.63,2.3,3,0,0.374488680718189,0.267790788446526,0.357720530835285,1.39125683060109,1.34095238095238,2,-6,2,3,0.0503044496487122,5,-2,0,0
"733","E0",10,"23.11.2019","Yes","West Ham","Tottenham",2,3,11,15,4,6,12,14,3,2,0,0,4.32,4.14,1.75,1.55,2.47,0,3,0.221628764935852,0.231264798193932,0.547106436870216,0.896151093001487,1.87258410880458,-1,-4,-2,-3,-0.976433015803095,-2,1,0,0
"734","E0",10,"23.11.2019","Yes","Arsenal","Southampton",2,2,12,21,5,6,13,19,6,2,0,0,1.47,4.75,6.55,1.47,2.67,1,1,0.651932486091758,0.201755948327344,0.146311565580898,2.15755340660262,0.640690645070039,0,-9,-1,0,1.51686276153258,-6,4,0,0
"735","E0",10,"23.11.2019","Yes","Bournemouth","Wolves",1,2,9,17,2,7,10,12,2,1,1,0,2.82,3.3,2.59,2.02,1.81,0,3,0.339749093684411,0.290331043693952,0.369919862621637,1.30957832474719,1.40009063155886,-1,-8,-5,-3,-0.0905123068116771,-2,1,1,0
"736","E0",10,"23.11.2019","Yes","Brighton","Leicester",0,2,7,19,0,9,9,1,2,0,0,0,3.69,3.53,2.04,1.89,1.93,0,3,0.259460628006269,0.271220883100038,0.469318488893693,1.04960276711885,1.67917634978112,-2,-12,-9,-3,-0.629573582662271,8,2,0,0
"737","E0",10,"23.11.2019","Yes","Crystal Palace","Liverpool",1,2,16,12,6,4,8,7,0,1,0,0,7.33,4.62,1.45,1.67,2.22,0,3,0.13086003504447,0.207619925730728,0.661520039224802,0.600200030864137,2.19218004340513,-1,4,2,-3,-1.591980012541,1,-1,0,0
"738","E0",10,"23.11.2019","Yes","Everton","Norwich",0,2,18,13,7,5,12,11,3,5,0,0,1.4,5,7.73,1.55,2.45,0,3,0.684409973084006,0.191634792463522,0.123955234452472,2.24486471171554,0.563500495820938,-2,5,2,-3,1.6813642158946,1,-2,0,0
"739","E0",10,"23.11.2019","Yes","Watford","Burnley",0,3,15,11,4,5,14,13,0,3,0,0,2.33,3.31,3.2,2.02,1.81,0,3,0.411175335690966,0.289437623009049,0.299387041299985,1.52296363008195,1.187598746909,-3,4,-1,-3,0.335364883172944,1,-3,0,0
"740","E0",10,"23.11.2019","Yes","Man City","Chelsea",2,1,15,11,4,2,5,9,1,1,0,0,1.45,4.96,6.64,1.4,2.92,3,0,0.66193944656151,0.193510523692377,0.144550029746113,2.17932886337691,0.627160612930716,1,4,2,3,1.55216825044619,-4,0,0,0
"741","E0",10,"24.11.2019","Yes","Sheffield United","Man United",3,3,12,11,8,5,13,10,1,2,0,0,3.55,3.28,2.18,2.18,1.69,1,1,0.269486760083517,0.291670121431856,0.438843118484627,1.10013040168241,1.60819947688574,0,1,3,0,-0.508069075203328,3,-1,0,0
"742","E0",10,"25.11.2019","Yes","Aston Villa","Newcastle",2,0,17,11,8,5,10,9,1,1,0,0,2.11,3.46,3.55,1.92,1.9,3,0,0.45368082410865,0.276666629730998,0.269652546160353,1.63770910205695,1.08562426821205,2,6,3,3,0.552084833844892,1,0,0,0
"743","E0",10,"30.11.2019","Yes","Newcastle","Man City",2,2,6,24,3,9,4,6,1,2,0,0,15.11,7.59,1.18,1.44,2.79,1,1,0.0633077191139662,0.126031572570755,0.810660708315279,0.315954729912653,2.55801369751659,0,-18,-6,0,-2.24205896760394,-2,-1,0,0
"744","E0",10,"30.11.2019","Yes","Burnley","Crystal Palace",0,2,15,7,4,2,13,10,2,0,0,0,2.31,3.26,3.3,2.22,1.67,0,3,0.415180845644422,0.294192562404483,0.290626591951095,1.53973509933775,1.16607233825777,-2,8,2,-3,0.373662761079979,3,2,0,0
"745","E0",10,"30.11.2019","Yes","Chelsea","West Ham",0,1,19,5,6,4,0,16,0,3,0,0,1.3,5.94,9.63,1.4,2.94,0,3,0.7386342506508,0.161653960580141,0.0997117887690591,2.37755671253254,0.460789326887319,-1,14,2,-3,1.91676738564522,-16,-3,0,0
"746","E0",10,"30.11.2019","Yes","Liverpool","Brighton",2,1,15,12,7,5,3,10,0,0,1,0,1.21,6.85,14.67,1.47,2.7,3,0,0.79420321239371,0.140289910510422,0.0655068770958684,2.52289954769155,0.336810541798027,1,3,2,3,2.18608900589352,-7,0,1,0
"747","E0",10,"30.11.2019","Yes","Tottenham","Bournemouth",3,2,15,20,5,6,10,12,0,2,0,0,1.38,5.19,7.86,1.51,2.57,3,0,0.693736990326925,0.184461858699645,0.12180115097343,2.26567282968042,0.549865311619934,1,-5,-1,3,1.71580751806049,-2,-2,0,0
"748","E0",10,"30.11.2019","Yes","Southampton","Watford",2,1,11,6,6,3,6,10,1,0,0,0,2.12,3.5,3.51,1.91,1.91,3,0,0.452549528110748,0.274115714169939,0.273334757719312,1.63176429850218,1.09411998732788,1,5,3,3,0.537644311174308,-4,1,0,0
"749","E0",10,"01.12.2019","Yes","Norwich","Arsenal",2,2,15,16,8,7,8,10,2,1,0,0,4.14,4.22,1.77,1.41,2.89,1,1,0.231480104127929,0.227091855708442,0.54142804016363,0.921532168092228,1.85137597619933,0,-1,1,0,-0.929843808107103,-2,1,0,0
"750","E0",10,"01.12.2019","Yes","Wolves","Sheffield United",1,1,13,9,3,4,12,18,1,4,0,0,1.92,3.43,4.35,2.3,1.63,1,1,0.49971364554342,0.279723090216725,0.220563264239855,1.77886402684699,0.941412882936289,0,4,-1,0,0.837451143910698,-6,-3,0,0
"751","E0",10,"01.12.2019","Yes","Leicester","Everton",2,1,16,11,6,3,7,9,0,1,0,0,1.64,4.08,5.33,1.81,2.02,3,0,0.584913983237759,0.235112483458315,0.179973533303926,1.98985443317159,0.775033083370093,1,5,3,3,1.2148213498015,-2,-1,0,0
"752","E0",10,"01.12.2019","Yes","Man United","Aston Villa",2,2,16,9,6,3,16,8,4,1,0,0,1.49,4.38,7.08,1.69,2.18,1,1,0.644897246172467,0.219382853149994,0.135719900677539,2.1540745916674,0.626542555182611,0,7,3,0,1.52753203648478,8,3,0,0
"753","E0",10,"03.12.2019","Yes","Crystal Palace","Bournemouth",1,0,7,6,2,3,6,15,3,3,1,0,2.24,3.38,3.34,2.03,1.8,3,0,0.428562751499507,0.284017918153519,0.287419330346974,1.56970617265204,1.14627590919444,1,1,-1,3,0.423430263457596,-9,0,1,0
"754","E0",10,"03.12.2019","Yes","Burnley","Man City",1,4,4,17,2,8,9,6,1,1,0,0,11.59,6.41,1.25,1.48,2.68,0,3,0.0827806872269271,0.149676780805005,0.767542531968068,0.398018842485787,2.45230437670921,-3,-13,-6,-3,-2.05428553422342,3,0,0,0
"755","E0",10,"04.12.2019","Yes","Chelsea","Aston Villa",2,1,25,9,9,3,18,10,2,1,0,0,1.3,5.85,9.89,1.42,2.86,3,0,0.738733504855175,0.164163001078928,0.0971034940658976,2.38036351564445,0.45547348327662,1,16,6,3,1.92489003236783,8,1,0,0
"756","E0",10,"04.12.2019","Yes","Leicester","Watford",2,0,12,4,6,1,13,16,3,2,0,0,1.36,5.13,8.81,1.63,2.3,3,0,0.704484698466339,0.186763974642149,0.108751326891512,2.30021807004117,0.513017955316685,2,8,5,3,1.78720011472448,-3,1,0,0
"757","E0",10,"04.12.2019","Yes","Man United","Tottenham",2,1,12,8,7,5,9,9,0,1,0,0,2.69,3.47,2.61,1.8,2.03,3,0,0.356396019187861,0.276283945710474,0.367320035101665,1.34547200327406,1.37824405101547,1,4,2,3,-0.0327720477414124,0,-1,0,0
"758","E0",10,"04.12.2019","Yes","Southampton","Norwich",2,1,14,10,5,3,12,7,1,1,0,0,1.78,3.99,4.35,1.59,2.37,3,0,0.538993282963322,0.240453143778124,0.220553573258555,1.85743299266809,0.902113863553788,1,4,2,3,0.955319129114301,5,0,0,0
"759","E0",10,"04.12.2019","Yes","Wolves","West Ham",2,0,13,6,7,3,8,9,1,2,0,0,1.77,3.73,4.74,1.89,1.93,3,0,0.541140606205294,0.256787901604121,0.202071492190585,1.88020972022,0.863002378175875,2,7,4,3,1.01720734204413,-1,-1,0,0
"760","E0",10,"04.12.2019","Yes","Liverpool","Everton",5,2,11,12,5,4,13,17,1,2,0,0,1.39,4.99,8.28,1.58,2.38,3,0,0.691356619953985,0.192582304957122,0.116061075088894,2.26665216481908,0.540765530223803,3,-1,1,3,1.72588663459527,-4,-1,0,0
"761","E0",10,"05.12.2019","Yes","Sheffield United","Newcastle",0,2,13,6,6,4,10,6,2,0,0,0,1.86,3.45,4.62,2.33,1.61,0,3,0.515005234384088,0.277654995928812,0.2073397696871,1.82267069908107,0.899674304990113,-2,7,2,-3,0.922996394090962,4,2,0,0
"762","E0",10,"05.12.2019","Yes","Arsenal","Brighton",1,2,12,20,5,9,10,11,3,1,0,0,1.61,4.23,5.41,1.54,2.5,0,3,0.595872380203465,0.226797761732288,0.177329858064247,2.01441490234268,0.75878733592503,-1,-8,-4,-3,1.25562756641765,-1,2,0,0
"763","E0",10,"07.12.2019","Yes","Everton","Chelsea",3,1,13,15,7,4,14,9,3,0,0,0,3.52,3.8,2.02,1.69,2.18,3,0,0.272561997557026,0.252478481947561,0.474959520495412,1.07016447461864,1.6773570434338,2,-2,3,3,-0.607192568815158,5,3,0,0
"764","E0",10,"07.12.2019","Yes","Bournemouth","Liverpool",0,3,3,21,0,9,5,6,0,1,0,0,7.01,5.03,1.42,1.5,2.59,0,3,0.136420848366315,0.190121301599974,0.673457850033711,0.59938384669892,2.21049485170111,-3,-18,-9,-3,-1.61111100500219,-1,-1,0,0
"765","E0",10,"07.12.2019","Yes","Tottenham","Burnley",5,0,13,7,7,1,12,8,1,1,0,0,1.41,4.82,7.98,1.59,2.35,3,0,0.68063194105281,0.199106024249888,0.120262034697301,2.24100184740832,0.559892128341792,5,6,6,3,1.68110971906653,4,0,0,0
"766","E0",10,"07.12.2019","Yes","Watford","Crystal Palace",0,0,13,3,3,0,15,16,4,2,0,0,2.37,3.34,3.12,2.05,1.78,1,1,0.40499008977498,0.28737320741518,0.30763670280984,1.50234347674012,1.2102833158447,0,10,3,0,0.292060160895418,-1,2,0,0
"767","E0",10,"07.12.2019","Yes","Man City","Man United",1,2,22,11,5,7,10,10,3,2,0,0,1.31,5.67,9.9,1.49,2.63,0,3,0.733479943080922,0.16946362000635,0.097056436912728,2.36990344924912,0.460632930744534,-1,11,-2,-3,1.90927051850458,0,1,0,0
"768","E0",10,"08.12.2019","Yes","Aston Villa","Leicester",1,4,15,23,2,8,21,15,6,2,0,0,4.27,3.88,1.82,1.62,2.31,0,3,0.224887422533327,0.247492086138481,0.527620491328191,0.922154353738464,1.83035356012305,-3,-8,-6,-3,-0.908199206384591,6,4,0,0
"769","E0",10,"08.12.2019","Yes","Newcastle","Southampton",2,1,12,19,6,4,11,17,1,3,0,0,2.59,3.23,2.87,2.12,1.73,3,0,0.369781922765476,0.296512439616899,0.333705637617625,1.40585820791333,1.29762935246977,1,-7,2,3,0.108228855443554,-6,-2,0,0
"770","E0",10,"08.12.2019","Yes","Norwich","Sheffield United",1,2,14,9,4,3,6,12,0,4,0,0,2.98,3.45,2.4,1.84,1.99,0,3,0.32201610080504,0.278147240695368,0.399836658499592,1.24419554311049,1.47765721619414,-1,5,1,-3,-0.233461673083654,-6,-4,0,0
"771","E0",10,"08.12.2019","Yes","Brighton","Wolves",2,2,13,13,4,5,10,7,3,0,0,0,2.69,3.16,2.81,2.29,1.63,1,1,0.356054196456139,0.303096768502219,0.340849035041642,1.37125935787064,1.32564387362714,0,0,-1,0,0.045615484243491,3,3,0,0
"772","E0",10,"09.12.2019","Yes","West Ham","Arsenal",1,3,11,10,4,3,12,6,2,0,0,0,3.43,4.02,1.98,1.44,2.78,0,3,0.278896690913678,0.237964091998486,0.483139217087836,1.07465416473952,1.68738174326199,-2,1,1,-3,-0.612727578522474,6,2,0,0
"773","E0",10,"14.12.2019","Yes","Liverpool","Watford",2,0,16,8,6,2,8,6,2,1,0,0,1.17,7.72,16.32,1.39,3.01,3,0,0.817497333198371,0.123895321223069,0.0586073455785597,2.57638732081818,0.299717357958748,2,8,4,3,2.27666996285943,2,1,0,0
"774","E0",10,"14.12.2019","Yes","Burnley","Newcastle",1,0,7,9,4,0,15,12,0,2,0,0,1.96,3.5,4.07,2.11,1.74,3,0,0.489818514417754,0.274298368073942,0.235883117508304,1.7437539113272,0.981947720598854,1,-2,4,3,0.76180619072835,3,-2,0,0
"775","E0",10,"14.12.2019","Yes","Chelsea","Bournemouth",0,1,18,11,5,2,9,14,1,2,0,0,1.25,6.48,11.64,1.4,2.94,0,3,0.769059475596775,0.148352522298761,0.0825880021044647,2.45553094908909,0.396116528612155,-1,7,3,-3,2.05941442047693,-5,-1,0,0
"776","E0",10,"14.12.2019","Yes","Leicester","Norwich",1,1,18,10,5,3,11,15,0,4,0,0,1.22,6.73,13.29,1.43,2.83,1,1,0.785498932518107,0.142393565775942,0.0721075017059511,2.49889036333026,0.358716070893795,0,8,2,0,2.14017429243647,-4,-4,0,0
"777","E0",10,"14.12.2019","Yes","Sheffield United","Aston Villa",2,0,7,8,3,0,10,9,2,2,0,0,1.86,3.75,4.17,1.81,2.02,3,0,0.514921613371662,0.255401120232345,0.229677266395993,1.80016596034733,0.944432919420324,2,-1,3,3,0.855733040927007,1,0,0,0
"778","E0",10,"14.12.2019","Yes","Southampton","West Ham",0,1,11,11,2,4,9,14,1,3,0,0,1.92,3.86,3.83,1.61,2.33,0,3,0.500321504233703,0.248864582416764,0.250813913349533,1.74982909511787,1.00130632246536,-1,0,-2,-3,0.748522772652511,-5,-2,0,0
"779","E0",10,"15.12.2019","Yes","Man United","Everton",1,1,24,8,8,3,10,12,1,2,0,0,1.78,3.71,4.76,1.8,2.03,1,1,0.539451738442458,0.258820510627379,0.201727750930163,1.87717572595475,0.864003763417868,0,16,5,0,1.01317196253689,-2,-1,0,0
"780","E0",10,"15.12.2019","Yes","Wolves","Tottenham",1,2,18,9,5,5,14,10,4,4,0,0,3.22,3.45,2.26,1.9,1.92,0,3,0.297786366830639,0.277933942375264,0.424279690794097,1.17129304286718,1.55077301475755,-1,9,0,-3,-0.379479971890373,4,0,0,0
"781","E0",10,"15.12.2019","Yes","Arsenal","Man City",0,3,6,14,1,7,9,24,1,4,0,0,6.03,5.33,1.45,1.32,3.32,0,3,0.158983705635863,0.17986336678879,0.661152927575347,0.656814483696379,2.16332214951483,-3,-8,-6,-3,-1.50650766581845,-15,-3,0,0
"782","E0",10,"16.12.2019","Yes","Crystal Palace","Brighton",1,1,11,15,4,10,7,12,1,1,0,0,2.55,3.22,2.91,2.18,1.69,1,1,0.374782514788994,0.296799817612402,0.328417667598603,1.42114736197939,1.28205282040821,0,-4,-6,0,0.139094541571173,-5,0,0,0
"783","E0",10,"21.12.2019","Yes","Everton","Arsenal",0,0,9,6,0,2,10,11,2,3,0,0,2.33,3.75,2.9,1.57,2.4,1,1,0.412408274711314,0.25624300802063,0.331348717268056,1.49346783215457,1.2502891598248,0,3,-2,0,0.243178672329775,-1,-1,0,0
"784","E0",10,"21.12.2019","Yes","Aston Villa","Southampton",1,3,19,17,6,8,16,15,2,1,0,0,2.43,3.54,2.87,1.62,2.31,0,3,0.394768438108338,0.270985114294707,0.334246447596955,1.45529042861972,1.27372445708557,-2,2,-2,-3,0.181565971534149,1,1,0,0
"785","E0",10,"21.12.2019","Yes","Bournemouth","Burnley",0,1,3,2,0,1,13,21,2,4,0,0,2.43,3.38,2.97,1.92,1.9,0,3,0.394148203116718,0.283366903424149,0.322484893459133,1.4658115127743,1.25082158380155,-1,1,-1,-3,0.214989928972755,-8,-2,0,0
"786","E0",10,"21.12.2019","Yes","Brighton","Sheffield United",0,1,9,7,2,2,6,11,1,3,0,0,2.21,3.27,3.52,2.11,1.73,0,3,0.434087712086528,0.293374264131874,0.272538023781598,1.59563740039146,1.11098833547667,-1,2,0,-3,0.484649064914788,-5,-2,0,0
"787","E0",10,"21.12.2019","Yes","Newcastle","Crystal Palace",1,0,8,16,3,4,12,11,2,0,0,0,2.43,3.11,3.22,2.44,1.56,3,0,0.394320387776076,0.308102425175519,0.297577187048405,1.49106358850375,1.20083398632073,1,-8,-1,3,0.290229602183012,1,2,0,0
"788","E0",10,"21.12.2019","Yes","Norwich","Wolves",1,2,13,14,7,4,7,14,2,4,0,0,3.71,3.75,1.97,1.79,2.04,0,3,0.258225644646559,0.255471237770329,0.486303117583113,1.03014817171,1.71438059051967,-1,-1,3,-3,-0.684232418809663,-7,-2,0,0
"789","E0",10,"21.12.2019","Yes","Man City","Leicester",3,1,23,5,12,2,14,9,2,2,0,0,1.37,5.41,7.72,1.42,2.86,3,0,0.698960559500479,0.177001102867959,0.124038337631562,2.2738827813694,0.549116115762644,2,18,10,3,1.72476666560675,5,0,0,0
"790","E0",10,"22.12.2019","Yes","Watford","Man United",2,0,11,17,3,8,16,11,3,1,0,0,4.39,3.89,1.8,1.85,1.97,3,0,0.218941812508013,0.247083433653001,0.533974753838986,0.903908871177039,1.84900769516996,2,-6,-5,3,-0.945098823992921,5,2,0,0
"791","E0",10,"22.12.2019","Yes","Tottenham","Chelsea",0,2,5,13,1,3,9,11,4,3,1,0,2.37,3.65,2.88,1.59,2.37,0,3,0.404492825562469,0.262643286735083,0.332863887702448,1.47612176342249,1.26123494984243,-2,-8,-2,-3,0.214886813580061,-2,1,1,0
"792","E0",10,"26.12.2019","Yes","Tottenham","Brighton",2,1,11,11,5,5,10,9,4,2,0,0,1.55,4.41,5.73,1.6,2.35,3,0,0.616530401622005,0.216694358846737,0.166775239531258,2.06628556371275,0.717020077440511,1,0,0,3,1.34926548627224,1,2,0,0
"793","E0",10,"26.12.2019","Yes","Aston Villa","Norwich",1,0,11,16,2,6,15,12,2,3,0,0,2.11,3.77,3.28,1.52,2.51,3,0,0.453931742844452,0.254057288435489,0.292010968720059,1.61585251696884,1.13009019459567,1,-5,-4,3,0.485762322373179,3,-1,0,0
"794","E0",10,"26.12.2019","Yes","Bournemouth","Arsenal",1,1,12,17,4,2,5,13,4,4,0,0,3.5,3.85,2.01,1.55,2.43,1,1,0.273943749225623,0.249039772023293,0.477016478751084,1.07087101970016,1.68008920827655,0,-5,2,0,-0.609218188576385,-8,0,0,0
"795","E0",10,"26.12.2019","Yes","Chelsea","Southampton",0,2,10,5,3,3,10,9,3,2,0,0,1.35,5.31,8.58,1.49,2.62,0,3,0.708426046433519,0.180108316889878,0.111465636676603,2.30538645619044,0.514505226919686,-2,5,0,-3,1.79088122927075,1,1,0,0
"796","E0",10,"26.12.2019","Yes","Crystal Palace","West Ham",2,1,13,10,4,2,5,10,0,2,0,0,2.32,3.42,3.12,1.9,1.92,3,0,0.412890044576523,0.280089153046062,0.307020802377415,1.51875928677563,1.20115156017831,1,3,2,3,0.317607726597325,-5,-2,0,0
"797","E0",10,"26.12.2019","Yes","Everton","Burnley",1,0,21,6,5,0,15,14,0,0,0,0,1.71,3.76,5.15,1.93,1.89,3,0,0.559651561700689,0.254522385773452,0.18582605252586,1.93347707087552,0.812000543351031,1,15,5,3,1.12147652752449,1,0,0,0
"798","E0",10,"26.12.2019","Yes","Sheffield United","Watford",1,1,16,5,4,2,11,8,1,3,0,0,1.86,3.54,4.46,2.11,1.74,1,1,0.514810032476425,0.270493406894393,0.214696560629182,1.81492350432367,0.914583088781938,0,11,2,0,0.90034041554173,3,-2,0,0
"799","E0",10,"26.12.2019","Yes","Man United","Newcastle",4,1,22,7,10,2,10,7,2,2,0,0,1.35,5.19,9.18,1.72,2.13,3,0,0.710643953123112,0.184849583182312,0.104506463694575,2.31678144255165,0.498368974266038,3,15,8,3,1.81841246828561,3,0,0,0
"800","E0",10,"26.12.2019","Yes","Leicester","Liverpool",0,4,3,15,0,6,5,7,1,1,0,0,3.38,3.72,2.08,1.64,2.27,0,3,0.282997337390643,0.257131989349563,0.459870673259795,1.10612400152149,1.63674400912895,-4,-12,-6,-3,-0.530620007607455,-2,0,0,0
"801","E0",10,"27.12.2019","Yes","Wolves","Man City",3,2,20,7,8,3,7,13,0,1,0,1,7.73,4.95,1.4,1.56,2.41,3,0,0.123715757245762,0.193196525961564,0.683087716792673,0.564343797698851,2.24245967633958,1,13,5,3,-1.67811587864073,-6,-1,-1,0
"802","E0",10,"28.12.2019","Yes","Brighton","Bournemouth",2,0,16,10,6,2,8,11,0,2,0,0,1.79,3.85,4.43,1.92,1.91,3,0,0.535045974018641,0.248761634673602,0.216192391307758,1.85389955672952,0.897338808596875,2,6,4,3,0.956560748132649,-3,-2,0,0
"803","E0",10,"28.12.2019","Yes","Newcastle","Everton",1,2,20,22,5,9,13,13,2,2,0,0,3.55,3.4,2.14,2.06,1.77,0,3,0.270051590394537,0.281965631147237,0.447982778458227,1.09212040233085,1.62591396652192,-1,-2,-4,-3,-0.53379356419107,0,0,0,0
"804","E0",10,"28.12.2019","Yes","Southampton","Crystal Palace",1,1,14,5,5,2,13,7,1,2,0,0,1.98,3.57,3.91,2.04,1.78,1,1,0.485197659989364,0.269101223187378,0.245701116823258,1.72469420315547,1.00620457365715,0,9,3,0,0.718489629498316,6,-1,0,0
"805","E0",10,"28.12.2019","Yes","Watford","Aston Villa",3,0,20,11,6,2,16,9,3,1,1,0,1.99,3.77,3.65,1.7,2.18,3,0,0.482379418291191,0.254624679681557,0.262995902027252,1.70176293455513,1.04361238576331,3,9,4,3,0.658150548791816,7,2,1,0
"806","E0",10,"28.12.2019","Yes","Norwich","Tottenham",2,2,5,15,2,7,12,10,3,3,0,0,4.93,4.07,1.69,1.6,2.35,1,1,0.194990233904369,0.236192101510697,0.568817664584934,0.821162803223804,1.9426450952655,0,-10,-5,0,-1.1214822920417,2,0,0,0
"807","E0",10,"28.12.2019","Yes","West Ham","Leicester",1,2,14,13,4,8,16,4,4,1,0,0,4.03,3.87,1.86,1.61,2.32,0,3,0.237642001842186,0.247466994166411,0.514891003991403,0.960392999692969,1.79214000614062,-1,1,-4,-3,-0.831747006447651,12,3,0,0
"808","E0",10,"28.12.2019","Yes","Burnley","Man United",0,2,8,14,1,5,17,10,4,3,0,0,4.31,3.7,1.85,1.95,1.87,0,3,0.222489476849068,0.259170174383644,0.518340348767288,0.926638604930848,1.81419122068551,-2,-6,-4,-3,-0.88755261575466,7,1,0,0
"809","E0",10,"29.12.2019","Yes","Arsenal","Chelsea",1,2,7,13,2,4,13,19,5,4,0,0,2.86,3.73,2.35,1.53,2.48,0,3,0.335145654825402,0.256974952493471,0.407879392681127,1.26241191696968,1.48061313053685,-1,-6,-2,-3,-0.218201213567176,-6,1,0,0
"810","E0",10,"29.12.2019","Yes","Liverpool","Wolves",1,0,10,10,3,2,7,3,1,0,0,0,1.28,5.84,10.92,1.55,2.43,3,0,0.748282206285435,0.164007058911876,0.0877107348026884,2.40885367776818,0.427139263319941,1,0,1,3,1.98171441444824,4,1,0,0
"811","E0",10,"29.12.2019","Yes","Man City","Sheffield United",2,0,16,8,4,0,5,6,1,1,0,0,1.18,7.62,14.91,1.38,3,3,0,0.810374637302817,0.125491085566578,0.0641342771306052,2.55661499747503,0.317893916958394,2,8,4,3,2.23872108051664,-1,0,0,0
"812","E0",10,"01.01.2020","Yes","Brighton","Chelsea",1,1,16,16,5,5,8,15,2,3,0,0,3.7,3.64,2.01,1.7,2.15,1,1,0.259250072639912,0.263523425485624,0.477226501874464,1.04127364340536,1.69520293110902,0,0,0,0,-0.653929287703658,-7,-1,0,0
"813","E0",10,"01.01.2020","Yes","Burnley","Aston Villa",1,2,20,11,1,6,12,10,1,1,0,0,1.81,3.81,4.37,1.87,1.94,0,3,0.529309659677958,0.251456819951996,0.219233520370047,1.83938579898587,0.909157381062135,-1,9,-5,-3,0.930228417923734,2,0,0,0
"814","E0",10,"01.01.2020","Yes","Newcastle","Leicester",0,3,5,17,2,10,8,12,1,1,0,0,5.26,3.9,1.67,1.94,1.87,0,3,0.181870476275579,0.245291975694755,0.572837548029667,0.79090340452149,1.96380461978375,-3,-12,-8,-3,-1.17290121526226,-4,0,0,0
"815","E0",10,"01.01.2020","Yes","Southampton","Tottenham",1,0,12,11,3,5,21,8,3,4,0,0,3.34,3.54,2.16,1.66,2.23,3,0,0.286549444619328,0.270360210460044,0.443090344920628,1.13000854431803,1.59963124522193,1,1,-2,3,-0.469622700903898,13,-1,0,0
"816","E0",10,"01.01.2020","Yes","Watford","Wolves",2,1,9,16,3,4,12,6,3,1,1,0,3.16,3.37,2.32,2,1.82,3,0,0.303052855171558,0.284168255887871,0.412778888940571,1.19332682140255,1.52250492270958,1,-7,-1,3,-0.329178101307038,6,2,1,0
"817","E0",10,"01.01.2020","Yes","Man City","Everton",2,1,16,7,7,2,11,11,0,4,0,0,1.27,6.19,10.49,1.37,3.09,3,0,0.754012868584142,0.154700540081076,0.0912865913347818,2.4167391458335,0.428560314085421,1,9,5,3,1.98817883174808,0,-4,0,0
"818","E0",10,"01.01.2020","Yes","Norwich","Crystal Palace",1,1,15,12,4,3,12,9,5,0,0,0,2.53,3.46,2.77,1.88,1.94,1,1,0.378133125017261,0.276496186790078,0.345370688192661,1.41089556184186,1.31260825136806,0,3,1,0,0.0982873104738009,3,5,0,0
"819","E0",10,"01.01.2020","Yes","West Ham","Bournemouth",4,0,14,3,7,2,3,12,1,2,0,0,1.95,3.84,3.68,1.67,2.22,3,0,0.490748458076346,0.249208201366895,0.260043340556759,1.72145357559593,1.02933822303717,4,11,5,3,0.69211535255876,-9,-1,0,0
"820","E0",10,"01.01.2020","Yes","Arsenal","Man United",2,0,10,10,4,4,11,15,2,0,0,0,2.58,3.64,2.61,1.64,2.26,3,0,0.370741529888314,0.26277833711864,0.366480132993046,1.37500292678358,1.36221873609778,2,0,0,3,0.0127841906858039,-4,2,0,0
"821","E0",10,"02.01.2020","Yes","Liverpool","Sheffield United",2,0,19,3,7,2,5,8,0,0,0,0,1.23,6.32,13.64,1.54,2.47,3,0,0.778333556045925,0.151479473724128,0.0701869702299477,2.4864801418619,0.362040384413971,2,16,5,3,2.12443975744793,-3,0,0,0
"822","E0",10,"10.01.2020","Yes","Sheffield United","West Ham",1,0,13,7,3,2,11,6,1,0,0,0,2.02,3.43,3.94,2.03,1.8,3,0,0.475825305616585,0.280223649371866,0.243951045011549,1.70769956622162,1.01207678440651,1,6,1,3,0.695622781815109,5,1,0,0
"823","E0",10,"11.01.2020","Yes","Crystal Palace","Arsenal",1,1,6,7,3,4,14,22,2,3,0,1,4.19,3.87,1.83,1.8,2.03,1,1,0.228712324520186,0.247623937917204,0.523663737562611,0.933760911477761,1.81861515060504,0,-1,-1,0,-0.884854239127276,-8,-1,-1,0
"824","E0",10,"11.01.2020","Yes","Chelsea","Burnley",3,0,18,7,8,2,7,4,0,3,0,0,1.29,5.61,11.06,1.66,2.24,3,0,0.742620366746498,0.170762972032617,0.0866166612208845,2.39862407227211,0.430612955695271,3,11,6,3,1.96801111657684,3,-3,0,0
"825","E0",10,"11.01.2020","Yes","Everton","Brighton",1,0,14,9,6,2,7,7,2,1,0,0,1.9,3.63,4.16,1.83,2,3,0,0.505013076135885,0.264331913128976,0.23065501073514,1.77937114153663,0.956296945334394,1,5,4,3,0.823074196202235,0,1,0,0
"826","E0",10,"11.01.2020","Yes","Leicester","Southampton",1,2,5,16,5,10,9,17,0,3,0,0,1.64,4.02,5.46,1.64,2.28,0,3,0.585368195346753,0.238806925464845,0.175824879188402,1.9949115115051,0.766281563030051,-1,-11,-5,-3,1.22862994847505,-8,-3,0,0
"827","E0",10,"11.01.2020","Yes","Man United","Norwich",4,0,13,8,6,3,18,7,0,0,0,0,1.36,5.16,8.82,1.58,2.39,3,0,0.705337548819044,0.185902919843779,0.108759531337177,2.30191556630091,0.51218151385531,4,5,3,3,1.7897340524456,11,0,0,0
"828","E0",10,"11.01.2020","Yes","Wolves","Newcastle",1,1,9,5,4,1,13,12,0,3,0,0,1.46,4.35,7.91,2.01,1.82,1,1,0.657804431818399,0.220780338035601,0.121415230146,2.1941936334908,0.585026028473602,0,4,3,0,1.6091676050172,1,-3,0,0
"829","E0",10,"11.01.2020","Yes","Tottenham","Liverpool",0,1,14,13,4,7,4,8,0,2,0,0,4.59,4.22,1.7,1.62,2.3,0,3,0.208869530785983,0.227182736091863,0.563947733122154,0.853791328449812,1.91902593545833,-1,1,-3,-3,-1.06523460700851,-4,-2,0,0
"830","E0",10,"12.01.2020","Yes","Bournemouth","Watford",0,3,10,18,1,6,3,13,1,1,0,0,2.61,3.37,2.75,1.89,1.93,0,3,0.367164935996228,0.284362161112806,0.348472902890966,1.38585696910149,1.3297808697857,-3,-8,-5,-3,0.0560760993157878,-10,0,0,0
"831","E0",10,"12.01.2020","Yes","Aston Villa","Man City",1,6,7,22,1,12,5,12,2,1,0,0,14.5,8.39,1.17,1.27,3.74,0,3,0.0661313977780368,0.114291450271935,0.819577151950028,0.312685643606045,2.57302290612202,-5,-15,-11,-3,-2.26033726251597,-7,1,0,0
"832","E0",10,"18.01.2020","Yes","Watford","Tottenham",0,0,15,17,2,5,13,13,2,3,0,0,3.18,3.52,2.25,1.81,2.02,1,1,0.301500650967315,0.272378428998881,0.426120920033805,1.17688038190082,1.55074118910029,0,-2,-3,0,-0.37386080719947,0,-1,0,0
"833","E0",10,"18.01.2020","Yes","Arsenal","Sheffield United",1,1,11,12,4,4,9,13,1,2,0,0,1.85,3.61,4.46,1.99,1.83,1,1,0.518870387140228,0.26590310698322,0.215226505876552,1.8225142684039,0.911582624612876,0,-1,0,0,0.910931643791029,-4,-1,0,0
"834","E0",10,"18.01.2020","Yes","Brighton","Aston Villa",1,1,10,8,2,3,11,13,3,3,0,0,1.65,4.29,4.94,1.65,2.26,1,1,0.581861012956419,0.223792697290931,0.19434628975265,1.96937573616019,0.806831566548881,0,2,-1,0,1.16254416961131,-2,0,0,0
"835","E0",10,"18.01.2020","Yes","Man City","Crystal Palace",2,2,25,5,6,3,9,7,1,2,0,0,1.1,10.64,24.53,1.29,3.53,1,1,0.870908303418709,0.0900375125714831,0.0390541840098076,2.70276242282761,0.207200064600906,0,20,3,0,2.4955623582267,2,-1,0,0
"836","E0",10,"18.01.2020","Yes","Norwich","Bournemouth",1,0,16,6,5,3,10,10,2,2,1,1,2.22,3.56,3.19,1.79,2.04,3,0,0.431123630482814,0.268846758334789,0.300029611182397,1.56221764978323,1.16893559188198,1,10,2,3,0.39328205790125,0,0,0,0
"837","E0",10,"18.01.2020","Yes","Southampton","Wolves",2,3,11,8,5,4,13,12,2,1,0,0,2.39,3.37,3.05,2.02,1.8,0,3,0.401154463104405,0.284498269085913,0.314347267809681,1.48796165839913,1.22754007251496,-1,3,1,-3,0.260421585884171,1,1,0,0
"838","E0",10,"18.01.2020","Yes","West Ham","Everton",1,1,12,11,6,3,11,13,1,0,0,0,2.96,3.46,2.4,1.84,1.97,1,1,0.32374773875616,0.276963383444576,0.399288877799264,1.24820659971306,1.47483001684237,0,1,3,0,-0.226623417129312,-2,1,0,0
"839","E0",10,"18.01.2020","Yes","Newcastle","Chelsea",1,0,7,19,2,4,9,14,1,1,0,0,6.02,4.53,1.52,1.68,2.2,3,0,0.158996550179418,0.211293428715254,0.629710021105328,0.688283079253509,2.10042349203124,1,-12,-2,3,-1.41214041277773,-5,0,0,0
"840","E0",10,"19.01.2020","Yes","Burnley","Leicester",2,1,8,18,5,8,14,8,1,0,0,0,4.19,3.71,1.87,1.85,1.96,3,0,0.228831812229739,0.258438084431969,0.512730103338292,0.944933521121186,1.79662839444685,1,-10,-3,3,-0.851694873325659,6,1,0,0
"841","E0",10,"19.01.2020","Yes","Liverpool","Man United",2,0,16,9,5,4,7,10,1,3,0,0,1.37,5.12,8.31,1.66,2.23,3,0,0.698109647345286,0.186798870481063,0.115091482173651,2.28112781251692,0.532073317002017,2,7,1,3,1.7490544955149,-3,-2,0,0
"842","E0",10,"21.01.2020","Yes","Aston Villa","Watford",2,1,16,8,5,2,11,18,2,2,0,0,2.86,3.46,2.49,1.89,1.93,3,0,0.33611366863813,0.277828061359841,0.386058270002029,1.28616906727423,1.43600287136593,1,8,3,3,-0.149833804091696,-7,0,0,0
"843","E0",10,"21.01.2020","Yes","Bournemouth","Brighton",3,1,11,21,3,8,9,12,1,1,0,0,2.94,3.35,2.47,1.98,1.85,3,0,0.325956360570882,0.286063194053251,0.387980445375867,1.2639322757659,1.45000453018085,2,-10,-5,3,-0.186072254414957,-3,0,0,0
"844","E0",10,"21.01.2020","Yes","Crystal Palace","Southampton",0,2,6,15,0,6,12,13,1,2,0,0,2.73,3.26,2.72,2.21,1.68,0,3,0.351976374014592,0.294753221183998,0.35327040480141,1.35068234322777,1.35456443558823,-2,-9,-6,-3,-0.003882092360455,-1,-1,0,0
"845","E0",10,"21.01.2020","Yes","Everton","Newcastle",2,2,17,8,8,2,13,10,1,1,0,0,1.6,3.99,6.06,1.95,1.87,1,1,0.600590172729847,0.240838164503197,0.158571662766956,2.04260868269274,0.716553152804066,0,9,6,0,1.32605552988867,3,0,0,0
"846","E0",10,"21.01.2020","Yes","Sheffield United","Man City",0,1,4,18,1,5,13,13,4,3,0,0,7.41,4.82,1.43,1.6,2.36,0,3,0.129547731326508,0.199159479072495,0.671292789600997,0.587802673052019,2.21303784787549,-1,-14,-4,-3,-1.62523517482347,0,1,0,0
"847","E0",10,"21.01.2020","Yes","Chelsea","Arsenal",2,2,19,2,8,2,11,6,2,1,0,1,1.74,3.95,4.71,1.68,2.2,1,1,0.552506615111856,0.243382660834083,0.204110724054061,1.90090250616965,0.855714832996267,0,17,6,0,1.04518767317338,5,1,-1,0
"848","E0",10,"22.01.2020","Yes","Leicester","West Ham",4,1,19,6,8,2,10,19,1,1,0,0,1.53,4.49,5.97,1.62,2.32,3,0,0.626158924153977,0.21336818573621,0.160472890109813,2.09184495819814,0.69478685606565,3,13,6,3,1.39705810213249,-9,0,0,0
"849","E0",10,"22.01.2020","Yes","Tottenham","Norwich",2,1,14,12,3,2,12,7,0,1,0,0,1.42,4.89,7.5,1.54,2.49,3,0,0.675802671148063,0.196245356447904,0.127951972404033,2.22365336989209,0.580101273660004,1,2,1,3,1.64355209623209,5,-1,0,0
"850","E0",10,"22.01.2020","Yes","Man United","Burnley",0,2,24,5,7,2,11,7,0,2,0,0,1.41,4.65,8.43,1.81,2.02,0,3,0.680047465142786,0.206207941043296,0.113744593813918,2.24635033647165,0.54744172248505,-2,19,5,-3,1.6989086139866,4,-2,0,0
"851","E0",10,"23.01.2020","Yes","Wolves","Liverpool",1,2,10,13,3,6,6,11,0,1,0,0,5.63,3.92,1.64,1.8,2.02,0,3,0.170382385056557,0.244707354048066,0.584910260895377,0.755854509217738,1.9994381367342,-1,-3,-3,-3,-1.24358362751646,-5,-1,0,0
"852","E0",10,"29.01.2020","Yes","West Ham","Liverpool",0,2,7,13,4,5,6,6,2,0,0,0,8.76,5.55,1.33,1.56,2.44,0,3,0.109112598170296,0.172220965760684,0.71866643606902,0.499558760271573,2.32822027396774,-2,-6,-1,-3,-1.82866151369617,0,2,0,0
"853","E0",10,"01.02.2020","Yes","Leicester","Chelsea",2,2,14,7,4,3,16,14,2,2,0,0,2.52,3.59,2.72,1.69,2.18,1,1,0.380456635237279,0.267061482116419,0.352481882646302,1.40843138782826,1.32450713005533,0,7,1,0,0.0839242577729293,2,0,0,0
"854","E0",10,"01.02.2020","Yes","Bournemouth","Aston Villa",2,1,16,18,6,5,10,15,1,3,1,0,2.13,3.57,3.39,1.78,2.04,3,0,0.449446839800796,0.268157358200475,0.28239580199873,1.61649787760286,1.11534476419666,1,-2,1,3,0.501153113406197,-5,-2,1,0
"855","E0",10,"01.02.2020","Yes","Crystal Palace","Sheffield United",0,1,13,10,3,3,9,15,3,2,0,0,3.11,3.06,2.52,2.63,1.48,0,3,0.307648114901257,0.312675044883303,0.37967684021544,1.23561938958707,1.45170556552962,-1,3,0,-3,-0.216086175942549,-6,1,0,0
"856","E0",10,"01.02.2020","Yes","Liverpool","Southampton",4,0,16,17,9,4,9,15,0,2,0,0,1.28,5.86,10.73,1.53,2.49,3,0,0.747539619321627,0.163285104561721,0.0891752761166526,2.4059039625266,0.430810932911678,4,-1,5,3,1.97509302961492,-6,-2,0,0
"857","E0",10,"01.02.2020","Yes","Newcastle","Norwich",0,0,15,19,5,4,10,15,2,1,0,0,2.24,3.39,3.31,1.99,1.83,1,1,0.427806732268604,0.282680554655361,0.289512713076034,1.56610075146117,1.15121869388346,0,-4,1,0,0.41488205757771,-5,1,0,0
"858","E0",10,"01.02.2020","Yes","Watford","Everton",2,3,11,12,2,5,17,14,2,2,0,1,2.75,3.31,2.64,2.01,1.81,0,3,0.348130943511986,0.289232656996363,0.362636399491652,1.33362548753232,1.37714185547132,-1,-1,-3,-3,-0.0435163679389983,3,0,-1,0
"859","E0",10,"01.02.2020","Yes","West Ham","Brighton",3,3,12,19,6,6,8,9,1,1,0,0,2.56,3.37,2.8,1.92,1.9,1,1,0.373981419829418,0.284092710612258,0.341925869558325,1.40603697010051,1.30987031928723,0,-7,0,0,0.0961666508132788,-1,0,0,0
"860","E0",10,"01.02.2020","Yes","Man United","Wolves",0,0,15,14,5,3,14,15,3,2,0,0,2.23,3.24,3.48,2.18,1.69,1,1,0.429354779747761,0.29551270334491,0.27513251690733,1.58357704258819,1.1209102540669,0,1,2,0,0.462666788521294,-1,1,0,0
"861","E0",10,"02.02.2020","Yes","Burnley","Arsenal",0,0,15,13,2,2,8,11,1,3,0,0,3.75,3.53,2.02,1.9,1.91,1,1,0.255182853727754,0.271086600985574,0.473730545286672,1.03663516216884,1.69227823684559,0,2,0,0,-0.655643074676754,-3,-2,0,0
"862","E0",10,"02.02.2020","Yes","Tottenham","Man City",2,0,3,18,3,5,8,14,2,3,0,1,5.64,4.45,1.56,1.49,2.61,3,0,0.169987070992008,0.215444287729196,0.614568641278796,0.725405500705219,2.05915021156559,2,-15,-2,3,-1.33374471086037,-6,-1,-1,0
"863","E0",10,"08.02.2020","Yes","Everton","Crystal Palace",3,1,14,10,8,2,11,12,0,1,0,0,1.63,3.77,6.02,2.09,1.75,3,0,0.587156010772745,0.253863208901744,0.158980780325511,2.01533124121998,0.730805549878276,2,4,6,3,1.2845256913417,-1,-1,0,0
"864","E0",10,"08.02.2020","Yes","Brighton","Watford",1,1,10,5,2,2,9,12,2,2,0,0,2.15,3.37,3.53,1.97,1.85,1,1,0.445028450007669,0.2839202277497,0.271051322242631,1.61900557777271,1.09707419447759,0,5,0,0,0.521931383295113,-3,0,0,0
"865","E0",10,"09.02.2020","Yes","Sheffield United","Bournemouth",2,1,16,10,6,2,10,8,2,2,0,0,1.72,3.54,5.58,2.28,1.63,3,0,0.557376494091355,0.270815697694105,0.17180780821454,1.94294517996817,0.786239122337724,1,6,4,3,1.15670605763045,2,0,0,0
"866","E0",10,"14.02.2020","Yes","Wolves","Leicester",0,0,15,9,3,3,13,10,2,2,0,1,2.55,3.29,2.91,2.03,1.8,1,1,0.377164265538392,0.292330965690851,0.330504768770756,1.42382376230603,1.28384527200312,0,6,0,0,0.139978490302909,3,0,-1,0
"867","E0",10,"15.02.2020","Yes","Southampton","Burnley",1,2,10,9,2,6,8,11,2,2,0,0,1.79,3.69,4.7,1.96,1.86,0,3,0.535921214050202,0.259972621449827,0.204106164499971,1.86773626360043,0.872291114949739,-1,1,-4,-3,0.995445148650695,-3,0,0,0
"868","E0",10,"15.02.2020","Yes","Norwich","Liverpool",0,1,5,17,1,6,5,11,1,2,0,0,10.02,6,1.29,1.51,2.56,0,3,0.095808916913616,0.160000891245739,0.744190191840645,0.447427641986587,2.39257146676767,-1,-12,-5,-3,-1.94514382478109,-6,-1,0,0
"869","E0",10,"16.02.2020","Yes","Aston Villa","Tottenham",2,3,18,23,4,10,12,10,2,0,0,0,4.01,3.78,1.89,1.69,2.18,0,3,0.239089184060721,0.253636938646426,0.507273877292853,0.970904490828589,1.77545857052498,-1,-5,-6,-3,-0.804554079696395,2,2,0,0
"870","E0",10,"16.02.2020","Yes","Arsenal","Newcastle",4,0,15,10,7,2,15,9,2,0,0,0,1.43,4.6,7.72,1.72,2.13,3,0,0.668403300608324,0.207786243449979,0.123810455941697,2.21299614527495,0.579217611275071,4,5,5,3,1.63377853399988,6,2,0,0
"871","E0",10,"17.02.2020","Yes","Chelsea","Man United",0,2,17,9,1,3,11,11,4,3,0,0,1.86,3.6,4.35,1.89,1.93,0,3,0.51433638782146,0.265740467041088,0.219923145137452,1.80874963050547,0.925509902453444,-2,8,-2,-3,0.883239728052025,0,1,0,0
"872","E0",10,"19.02.2020","Yes","Man City","West Ham",2,0,20,3,7,0,5,7,0,1,0,0,1.13,9.37,18.28,1.23,4.04,3,0,0.845727580518456,0.101992760510764,0.0522796589707799,2.63917550206613,0.258831737423103,2,17,7,3,2.38034376464303,-2,-1,0,0
"873","E0",10,"22.02.2020","Yes","Chelsea","Tottenham",2,1,17,5,7,3,14,14,1,2,0,0,1.73,3.94,4.72,1.81,2.02,3,0,0.553828926756923,0.243178691190222,0.202992382052855,1.90466547146099,0.852155837348788,1,12,4,3,1.0525096341122,0,-1,0,0
"874","E0",10,"22.02.2020","Yes","Burnley","Bournemouth",3,0,16,12,10,4,9,9,4,3,0,0,2.15,3.28,3.65,2.23,1.66,3,0,0.445527789665631,0.292038032860093,0.262434177474276,1.62862140185699,1.07934056528292,3,4,6,3,0.549280836574066,0,1,0,0
"875","E0",10,"22.02.2020","Yes","Crystal Palace","Newcastle",1,0,18,8,9,2,15,11,2,6,0,1,1.96,3.3,4.35,2.51,1.53,3,0,0.489113768782582,0.29050393539814,0.220382295819278,1.75784524174589,0.951650822855975,1,10,7,3,0.806194418889911,4,-4,-1,0
"876","E0",10,"22.02.2020","Yes","Sheffield United","Brighton",1,1,14,8,3,2,3,6,0,2,0,0,1.96,3.34,4.31,2.23,1.66,1,1,0.489816056129081,0.28743696706976,0.22274697680116,1.756885135457,0.955677897473239,0,6,1,0,0.801207237983763,-3,-2,0,0
"877","E0",10,"22.02.2020","Yes","Southampton","Aston Villa",2,0,28,4,9,1,13,17,1,4,0,0,1.64,4.23,5.1,1.59,2.37,3,0,0.585043200937241,0.226825259937843,0.188131539124917,1.98195486274956,0.791219877312593,2,24,8,3,1.19073498543697,-4,-3,0,0
"878","E0",10,"22.02.2020","Yes","Leicester","Man City",0,1,10,18,3,7,14,10,0,0,0,0,4.49,4.15,1.73,1.54,2.47,0,3,0.213798402058325,0.231314415720935,0.55488718222074,0.87270962189591,1.89597596238315,-1,-8,-4,-3,-1.02326634048724,4,0,0,0
"879","E0",10,"23.02.2020","Yes","Man United","Watford",3,0,21,7,9,2,6,15,0,1,0,0,1.6,3.97,5.98,1.91,1.91,3,0,0.598594070689803,0.241246980630651,0.160158948679546,2.03702919270006,0.721723826669289,3,14,7,3,1.31530536603077,-9,-1,0,0
"880","E0",10,"23.02.2020","Yes","Wolves","Norwich",3,0,19,6,6,4,11,6,2,3,0,0,1.52,4.27,6.55,1.87,1.95,3,0,0.629709849622537,0.224159009701699,0.146131140675764,2.11328855856931,0.662552431728992,3,13,2,3,1.45073612684032,5,-1,0,0
"881","E0",10,"23.02.2020","Yes","Arsenal","Everton",3,2,9,17,4,5,12,12,0,4,0,0,2.04,3.6,3.63,1.73,2.11,3,0,0.469781286398343,0.266209395625728,0.264009317975929,1.67555325482076,1.05823734955351,1,-8,-1,3,0.617315905267244,0,-4,0,0
"882","E0",10,"24.02.2020","Yes","Liverpool","West Ham",3,2,25,7,7,4,4,10,0,3,0,0,1.17,7.81,16.2,1.38,3.03,3,0,0.818310408456689,0.122589395376994,0.0591001961663164,2.57752062074706,0.299889983875944,1,18,3,3,2.27763063687112,-6,-3,0,0
"883","E0",10,"28.02.2020","Yes","Norwich","Leicester",1,0,11,19,6,4,13,16,1,2,0,0,4.66,4.02,1.74,1.72,2.13,3,0,0.20672411958719,0.239635422208036,0.553640458204773,0.859807780969607,1.90055679682236,1,-8,2,3,-1.04074901585275,-3,-1,0,0
"884","E0",10,"29.02.2020","Yes","Brighton","Crystal Palace",0,1,24,12,8,3,8,9,1,1,0,0,2.08,3.24,3.93,2.31,1.62,0,3,0.460566864881288,0.295672555232432,0.24376057988628,1.6773731498763,1.02695429489127,-1,12,5,-3,0.650418854985025,-1,0,0,0
"885","E0",10,"29.02.2020","Yes","Bournemouth","Chelsea",2,2,9,23,5,6,8,5,2,2,0,0,4.68,3.84,1.76,1.8,2.03,1,1,0.205008736167734,0.249854397204426,0.545136866627839,0.864880605707629,1.88526499708794,0,-14,-1,0,-1.02038439138031,3,0,0,0
"886","E0",10,"29.02.2020","Yes","Newcastle","Burnley",0,0,21,8,4,1,11,9,4,3,0,0,2.64,3.11,2.9,2.34,1.6,1,1,0.362421339419901,0.307650268832327,0.329928391747772,1.39491428709203,1.29743544407564,0,13,3,0,0.0974788430163871,2,1,0,0
"887","E0",10,"29.02.2020","Yes","West Ham","Southampton",3,1,14,10,7,2,8,11,1,1,0,0,2.71,3.54,2.55,1.75,2.07,3,0,0.35357155446929,0.270672009212366,0.375756436318344,1.33138667262024,1.3979413181674,2,4,5,3,-0.0665546455471606,-3,0,0,0
"888","E0",10,"29.02.2020","Yes","Watford","Liverpool",3,0,14,7,5,1,4,8,0,0,0,0,7.52,4.84,1.42,1.64,2.26,3,0,0.127396752428264,0.197938755838956,0.67466449173278,0.580129013123749,2.2219322310373,3,7,4,3,-1.64180321791355,-4,0,0,0
"889","E0",10,"01.03.2020","Yes","Everton","Man United",1,1,16,14,5,5,11,11,3,4,0,0,2.54,3.33,2.85,1.98,1.83,1,1,0.37679105277576,0.287402184399528,0.335806762824712,1.41777534272681,1.29482247287366,0,2,0,0,0.122952869853143,0,-1,0,0
"890","E0",10,"01.03.2020","Yes","Tottenham","Wolves",2,3,13,14,5,4,12,14,3,2,0,0,2.44,3.17,3.13,2.22,1.66,0,3,0.392269343443728,0.301936024606529,0.305794631949743,1.47874405493771,1.21931992045576,-1,-1,1,-3,0.259424134481955,-2,1,0,0
"891","E0",10,"07.03.2020","Yes","Liverpool","Bournemouth",2,1,14,6,6,4,10,12,0,1,0,0,1.25,6.24,11.93,1.47,2.68,3,0,0.766225759270943,0.153490737033442,0.0802835036956144,2.45216801484627,0.394341248120285,1,8,2,3,2.05782676672599,-2,-1,0,0
"892","E0",10,"07.03.2020","Yes","Arsenal","West Ham",1,0,9,14,2,6,11,9,1,2,0,0,1.56,4.37,5.78,1.6,2.35,3,0,0.614675148323542,0.219426368737924,0.165898482938534,2.06345181370855,0.717121817553526,1,-5,-4,3,1.34632999615503,2,-1,0,0
"893","E0",10,"07.03.2020","Yes","Crystal Palace","Watford",1,0,10,10,3,4,12,19,4,4,0,0,2.57,3.19,2.95,2.28,1.63,3,0,0.37357633692334,0.300969023790904,0.325454639285757,1.42169803456092,1.27733294164817,1,0,-1,3,0.144365092912748,-7,0,0,0
"894","E0",10,"07.03.2020","Yes","Sheffield United","Norwich",1,0,10,12,4,5,12,8,0,0,0,0,1.66,3.78,5.71,2.06,1.77,3,0,0.578077627674277,0.25386477829082,0.168057594034904,1.98809766131365,0.75803756039553,1,-2,-1,3,1.23006010091812,4,0,0,0
"895","E0",10,"07.03.2020","Yes","Southampton","Newcastle",0,1,6,14,3,7,14,15,0,3,1,0,1.67,3.95,5.27,1.81,2.01,0,3,0.574820718011592,0.243025468121357,0.182153813867051,1.96748762215613,0.78948690972251,-1,-8,-4,-3,1.17800071243362,-1,-3,1,0
"896","E0",10,"07.03.2020","Yes","Wolves","Brighton",0,0,11,7,1,1,4,7,1,3,0,0,1.65,3.95,5.48,1.99,1.82,1,1,0.581795702248323,0.243028584483477,0.1751757132682,1.98841569122845,0.768555724288076,0,4,0,0,1.21985996694037,-3,-2,0,0
"897","E0",10,"07.03.2020","Yes","Burnley","Tottenham",1,1,21,13,8,2,16,11,5,4,0,0,2.72,3.3,2.69,2.06,1.77,1,1,0.352684566424842,0.2906975820229,0.356617851552257,1.34875128129743,1.36055113667967,0,8,6,0,-0.0117998553822438,5,1,0,0
"898","E0",10,"08.03.2020","Yes","Chelsea","Everton",4,0,17,3,11,1,8,10,1,2,0,0,1.87,3.74,4.2,1.71,2.14,3,0,0.514075887392901,0.25703794369645,0.228886168910649,1.79926560587515,0.943696450428397,4,14,10,3,0.855569155446756,-2,-1,0,0
"899","E0",10,"08.03.2020","Yes","Man United","Man City",2,0,12,7,6,2,11,9,2,4,0,0,5.04,4.28,1.64,1.66,2.22,3,0,0.190449316257868,0.22426741914478,0.585283264597352,0.795615367918385,1.98011721293684,2,5,4,3,-1.18450184501845,2,-2,0,0
"900","E0",10,"09.03.2020","Yes","Leicester","Aston Villa",4,0,15,4,7,1,15,12,2,1,0,0,1.38,5.12,8.05,1.52,2.48,3,0,0.693981875919758,0.187049802493997,0.118968321586244,2.26899543025327,0.54395476725273,4,11,6,3,1.72504066300054,3,1,0,0
"901","E0",10,"17.06.2020","No","Aston Villa","Sheffield United",0,0,14,5,6,1,11,14,1,1,0,0,3.3,3.33,2.27,2.08,1.76,1,1,0.290298051775983,0.287682754012235,0.422019194211782,1.15857690934018,1.55374033664758,0,9,5,0,-0.395163427307395,-3,0,0,0
"902","E0",10,"17.06.2020","No","Man City","Arsenal",3,0,20,3,12,0,9,7,1,1,0,1,1.35,5.5,8.11,1.38,3.04,3,0,0.708257579967767,0.173845042355725,0.117897377676509,2.29861778225902,0.52753717538525,3,17,12,3,1.77108060687377,2,0,-1,0
"903","E0",10,"19.06.2020","No","Norwich","Southampton",0,3,9,22,1,9,9,15,1,1,0,0,2.84,3.4,2.53,1.92,1.91,0,3,0.338086404225883,0.282401584706326,0.37951201106779,1.29666079738398,1.4209376179097,-3,-13,-8,-3,-0.12427682052572,-6,0,0,0
"904","E0",10,"19.06.2020","No","Tottenham","Man United",1,1,10,12,3,6,17,18,0,1,0,0,3.03,3.4,2.43,1.94,1.89,1,1,0.318665170151464,0.283986901634981,0.397347928213554,1.23998241208937,1.47603068627564,0,-2,-3,0,-0.23604827418627,-1,-1,0,0
"905","E0",10,"20.06.2020","No","Watford","Leicester",1,1,8,15,4,2,15,12,0,1,0,0,3.59,3.52,2.09,1.91,1.92,1,1,0.26755210625275,0.272872744729368,0.459575149017882,1.07552906348762,1.65159819178301,0,-7,2,0,-0.576069128295396,3,-1,0,0
"906","E0",10,"20.06.2020","No","Brighton","Arsenal",2,1,9,13,5,6,13,8,2,1,0,0,3.04,3.37,2.39,1.93,1.89,3,0,0.3150555257836,0.284204391211319,0.400740083005081,1.22937096856212,1.48642464022656,1,-4,-1,3,-0.257053671664444,5,1,0,0
"907","E0",10,"20.06.2020","No","West Ham","Wolves",0,2,7,10,2,6,8,7,1,1,0,0,3.57,3.36,2.15,2.06,1.78,0,3,0.26860310767549,0.285390801905208,0.446006090419302,1.09120012493168,1.62340907316311,-2,-3,-4,-3,-0.532208948231436,1,0,0,0
"908","E0",10,"20.06.2020","No","Bournemouth","Crystal Palace",0,2,12,7,1,2,13,15,3,2,0,0,2.51,3.24,2.98,2.12,1.73,0,3,0.382120835543032,0.296025709016361,0.321853455440607,1.44238821564546,1.26158607533818,-2,5,-1,-3,0.180802140307273,-2,1,0,0
"909","E0",10,"21.06.2020","No","Newcastle","Sheffield United",3,0,12,7,8,1,9,10,2,0,0,1,3.31,3.1,2.38,2.46,1.55,3,0,0.289142839227489,0.308729934788061,0.402127225984449,1.17615845247053,1.51511161274141,3,5,7,3,-0.33895316027088,-1,2,-1,0
"910","E0",10,"21.06.2020","No","Aston Villa","Chelsea",1,2,8,19,4,5,9,17,2,1,0,0,6,4.5,1.53,1.59,2.38,0,3,0.15987460815047,0.213166144200627,0.626959247648903,0.692789968652038,2.09404388714734,-1,-11,-1,-3,-1.4012539184953,-8,1,0,0
"911","E0",10,"21.06.2020","No","Everton","Liverpool",0,0,9,10,3,3,15,12,2,2,0,0,5.66,4.23,1.59,1.66,2.23,1,1,0.169554464805669,0.22687429569742,0.603571239496911,0.735537690114428,2.03758801418815,0,-1,0,0,-1.30205032407372,3,0,0,0
"912","E0",10,"22.06.2020","No","Man City","Burnley",5,0,19,1,7,0,8,7,1,1,0,0,1.13,8.97,19.85,1.32,3.35,3,0,0.845378264570834,0.106496927420852,0.0481248080083145,2.64263172113335,0.250871351445795,5,18,7,3,2.39176036968756,1,0,0,0
"913","E0",10,"23.06.2020","No","Leicester","Brighton",0,0,11,10,2,2,10,13,2,2,0,0,1.64,3.97,5.64,1.95,1.88,1,1,0.586896349262933,0.242445847050683,0.170657803686385,2.00313489483948,0.754419258109837,0,1,0,0,1.24871563672964,-3,0,0,0
"914","E0",10,"23.06.2020","No","Tottenham","West Ham",2,0,15,10,4,2,12,7,2,2,0,0,1.67,4.01,5.21,1.79,2.05,3,0,0.575706471568911,0.239758056738175,0.184535471692914,1.96687747144491,0.793364471816917,2,5,2,3,1.17351299962799,5,0,0,0
"915","E0",10,"24.06.2020","No","Man United","Sheffield United",3,0,15,4,6,1,10,6,1,0,0,0,1.43,4.39,8.62,2,1.83,3,0,0.670405927070249,0.218378240480742,0.111215832449009,2.22959602169149,0.552025737827768,3,11,5,3,1.67757028386372,4,1,0,0
"916","E0",10,"24.06.2020","No","Newcastle","Aston Villa",1,1,13,14,3,2,15,13,2,2,0,0,2.33,3.33,3.17,2.09,1.76,1,1,0.410725610966068,0.287384586651933,0.301889802381999,1.51956141955014,1.19305399379793,0,-1,1,0,0.326507425752205,2,0,0,0
"917","E0",10,"24.06.2020","No","Norwich","Everton",0,1,9,12,1,5,8,13,0,1,0,0,3.94,3.66,1.94,1.82,2.01,0,3,0.243461206128019,0.262086653591365,0.494452140280616,0.992470271975422,1.74544307443321,-1,-3,-4,-3,-0.752972802457791,-5,-1,0,0
"918","E0",10,"24.06.2020","No","Wolves","Bournemouth",1,0,10,4,2,0,11,11,3,3,0,0,1.58,4.03,6.11,2.07,1.77,3,0,0.605821205821206,0.237517991364145,0.156660802814649,2.05498160882776,0.707500399808092,1,6,2,3,1.34748120901967,0,0,0,0
"919","E0",10,"24.06.2020","No","Liverpool","Crystal Palace",4,0,21,3,7,0,7,5,0,0,0,0,1.24,6.13,13.09,1.69,2.19,3,0,0.771002503014667,0.155961354606556,0.0730361423787767,2.46896886365056,0.375069781742886,4,18,7,3,2.09389908190767,2,0,0,0
"920","E0",10,"25.06.2020","No","Burnley","Watford",1,0,9,10,5,4,13,15,1,0,0,0,3.02,3.22,2.48,2.18,1.7,3,0,0.316893918951094,0.297211066842331,0.385895014206575,1.24789282369561,1.45489610946205,1,-1,1,3,-0.207003285766441,-2,1,0,0
"921","E0",10,"25.06.2020","No","Southampton","Arsenal",0,2,12,10,3,5,10,14,0,2,1,0,2.64,3.47,2.65,1.8,2.03,0,3,0.36270870887454,0.275951294359881,0.361339996765579,1.3640774209835,1.35997128465662,-2,2,-2,-3,0.0041061363268815,-4,-2,1,0
"922","E0",10,"25.06.2020","No","Chelsea","Man City",2,1,15,11,10,2,13,3,1,1,0,1,4.14,4.07,1.8,1.63,2.29,3,0,0.231631665812987,0.235615502817142,0.532752831369871,0.930510500256104,1.83387399692675,1,4,8,3,-0.903363496670651,10,0,-1,0
"923","E0",10,"27.06.2020","No","Aston Villa","Wolves",0,1,11,9,1,2,16,16,1,1,0,0,4.79,3.68,1.78,2.08,1.76,0,3,0.200294766968976,0.26070976461451,0.538995468416514,0.861594065521438,1.87769616986405,-1,2,-1,-3,-1.01610210434261,0,0,0,0
"924","E0",10,"28.06.2020","No","Watford","Southampton",1,3,8,11,0,7,18,9,3,0,0,0,2.49,3.32,2.92,2,1.83,0,3,0.384210526315789,0.288157894736842,0.327631578947368,1.44078947368421,1.27105263157895,-2,-3,-7,-3,0.169736842105263,9,3,0,0
"925","E0",10,"29.06.2020","No","Crystal Palace","Burnley",0,1,17,8,4,4,12,13,1,1,0,0,2.29,3.16,3.41,2.42,1.57,0,3,0.417320852487713,0.302425554492678,0.280253593019608,1.55438811195582,1.1431863335515,-1,9,0,-3,0.411201778404316,-1,0,0,0
"926","E0",10,"30.06.2020","No","Brighton","Man United",0,3,8,12,2,6,10,9,0,1,0,0,6.31,3.85,1.61,2.1,1.76,0,3,0.152480498682693,0.249909596542283,0.597609904775025,0.707351092590361,2.04273931086736,-3,-4,-4,-3,-1.335388218277,1,-1,0,0
"927","E0",10,"01.07.2020","No","Arsenal","Norwich",4,0,13,8,8,2,10,10,1,4,0,0,1.44,4.69,7.23,1.7,2.18,3,0,0.663919645217187,0.203847396399307,0.132232958383506,2.19560633205087,0.600546271549825,4,5,6,3,1.59506006050104,0,-3,0,0
"928","E0",10,"01.07.2020","No","Bournemouth","Newcastle",1,4,12,12,1,7,11,10,2,0,0,0,2.4,3.16,3.21,2.38,1.59,0,3,0.398858113528052,0.302930212806115,0.298211673665833,1.49950455339027,1.19756523380361,-3,0,-6,-3,0.301939319586656,1,2,0,0
"929","E0",10,"01.07.2020","No","Everton","Leicester",2,1,7,15,2,3,13,10,1,1,0,0,2.54,3.28,2.9,2.08,1.76,3,0,0.377322564777938,0.292194912968281,0.33048252225378,1.4241626073021,1.28364247972962,1,-8,-1,3,0.140520127572473,3,0,0,0
"930","E0",10,"01.07.2020","No","West Ham","Chelsea",3,2,10,17,4,6,10,9,2,1,0,0,5.48,4.27,1.59,1.72,2.14,3,0,0.174522712141504,0.22397762588652,0.601499661971976,0.747545762311032,2.02847661180245,1,-7,-2,3,-1.28093084949142,1,1,0,0
"931","E0",10,"02.07.2020","No","Sheffield United","Tottenham",3,1,7,9,5,2,13,13,2,0,0,0,4.1,3.41,1.98,2.15,1.71,3,0,0.234024706420619,0.281378679274058,0.484596614305323,0.983452798535916,1.73516852219003,2,-2,3,3,-0.75171572365411,0,2,0,0
"932","E0",10,"02.07.2020","No","Man City","Liverpool",4,0,14,11,6,3,8,7,2,2,0,0,2.07,3.85,3.32,1.57,2.42,3,0,0.462715257440115,0.248784566987283,0.288500175572602,1.63693033930763,1.11428509370509,4,3,3,3,0.52264524560254,1,0,0,0
"933","E0",10,"04.07.2020","No","Norwich","Brighton",0,1,12,8,1,2,11,13,2,2,0,0,3.39,3.32,2.23,2.08,1.77,0,3,0.282385069856321,0.288338971931605,0.429275958212075,1.13549418150057,1.57616684656783,-1,4,-1,-3,-0.440672665067263,-2,0,0,0
"934","E0",10,"04.07.2020","No","Leicester","Crystal Palace",3,0,15,7,4,1,18,8,2,1,0,0,1.68,3.63,5.84,2.21,1.69,3,0,0.571271504333204,0.264390117707929,0.164338377958867,1.97820463070754,0.75740525158453,3,8,3,3,1.22079937912301,10,1,0,0
"935","E0",10,"04.07.2020","No","Man United","Bournemouth",5,2,19,7,10,3,13,12,0,1,0,0,1.17,7.46,17.41,1.53,2.54,3,0,0.816967287617981,0.128130258245716,0.0549024541363032,2.57903212109966,0.292837620654625,3,12,7,3,2.28619450044503,1,-1,0,0
"936","E0",10,"04.07.2020","No","Wolves","Arsenal",0,2,10,8,1,5,6,11,2,4,0,0,2.27,3.3,3.32,2.1,1.75,0,3,0.421653825134509,0.29004672213798,0.288299452727511,1.55500819754151,1.15494508032051,-2,2,-4,-3,0.400063117220995,-5,-2,0,0
"937","E0",10,"04.07.2020","No","Chelsea","Watford",3,0,21,7,9,3,9,12,0,2,0,0,1.43,4.61,7.96,1.73,2.13,3,0,0.671211453301311,0.208206589635765,0.120581957062924,2.2218409495397,0.569952460824537,3,14,6,3,1.65188848871516,-3,-2,0,0
"938","E0",10,"05.07.2020","No","Burnley","Sheffield United",1,1,9,10,4,3,8,14,0,0,0,0,2.91,2.97,2.75,2.65,1.49,1,1,0.329166112514962,0.322516292060114,0.348317595424924,1.310014629605,1.36746907833488,0,-1,1,0,-0.0574544487298843,-6,0,0,0
"939","E0",10,"05.07.2020","No","Newcastle","West Ham",2,2,11,17,4,7,9,11,0,0,0,0,2.66,3.28,2.74,2,1.82,1,1,0.359482248284027,0.291531335498632,0.348986416217341,1.36997808035071,1.33849058415065,0,-6,-3,0,0.0314874962000609,-2,0,0,0
"940","E0",10,"05.07.2020","No","Liverpool","Aston Villa",2,0,6,9,4,3,18,8,1,1,0,0,1.35,5.45,8.4,1.49,2.62,3,0,0.71001512155403,0.175875305339072,0.114109573106898,2.30592067000116,0.518204024659765,2,-3,1,3,1.7877166453414,10,0,0,0
"941","E0",10,"05.07.2020","No","Southampton","Man City",1,0,8,26,4,6,6,7,1,2,0,0,9.03,5.56,1.33,1.54,2.47,3,0,0.106229574136457,0.172527527779174,0.721242898084368,0.491216250188546,2.33625622203228,1,-18,-2,3,-1.84503997184373,-1,-1,0,0
"942","E0",10,"06.07.2020","No","Tottenham","Everton",1,0,12,11,2,3,14,18,3,2,0,0,2.13,3.51,3.45,1.86,1.97,3,0,0.449594012096101,0.272830554348916,0.277575433554984,1.62161259063722,1.10555685501387,1,1,-1,3,0.51605573562335,-4,1,0,0
"943","E0",10,"07.07.2020","No","Crystal Palace","Chelsea",2,3,13,14,4,6,11,10,1,0,0,0,8.43,4.5,1.43,1.83,2,0,3,0.114045394852273,0.213645039689924,0.672309565457803,0.555781224246742,2.23057373606333,-1,-1,-2,-3,-1.67479251181659,1,1,0,0
"944","E0",10,"07.07.2020","No","Watford","Norwich",2,1,9,12,4,3,11,15,2,4,0,0,1.75,3.71,5.02,2.05,1.8,3,0,0.549358881707997,0.25913154797547,0.191509570316533,1.90720819309946,0.833660258925069,1,-3,1,3,1.07354793417439,-4,-2,0,0
"945","E0",10,"07.07.2020","No","Arsenal","Leicester",1,1,11,13,7,5,10,14,1,0,1,0,2.38,3.43,3.03,1.88,1.95,1,1,0.403330526201407,0.279861997772405,0.316807476026188,1.48985357637663,1.23028442585097,0,-2,2,0,0.259569150525658,-4,1,1,0
"946","E0",10,"08.07.2020","No","Man City","Newcastle",5,0,23,6,9,1,12,7,0,0,0,0,1.13,9.15,22.2,1.39,3.01,3,0,0.851499965416853,0.105157919226344,0.0433421153568038,2.6596578154769,0.235184265296755,5,17,8,3,2.42447355018015,5,0,0,0
"947","E0",10,"08.07.2020","No","Sheffield United","Wolves",1,0,7,6,3,1,5,6,2,0,0,0,3.96,3.08,2.14,2.69,1.47,3,0,0.24176888315042,0.310845706907682,0.447385409941898,1.03615235635894,1.65300193673338,1,1,2,3,-0.616849580374435,-1,2,0,0
"948","E0",10,"08.07.2020","No","West Ham","Burnley",0,1,21,8,5,4,7,7,1,1,0,0,2.02,3.42,3.89,2.06,1.78,0,3,0.473950837192732,0.279935874599216,0.246113288208051,1.70178838617741,1.01827573922337,-1,13,1,-3,0.683512646954044,0,0,0,0
"949","E0",10,"08.07.2020","No","Brighton","Liverpool",1,3,12,19,2,8,7,15,1,4,0,0,5.99,4.26,1.56,1.73,2.12,0,3,0.160106390667688,0.225126122089073,0.614767487243238,0.705445294092138,2.06942858381879,-2,-7,-6,-3,-1.36398328972665,-8,-3,0,0
"950","E0",10,"09.07.2020","No","Bournemouth","Tottenham",0,0,9,9,2,0,11,14,3,2,0,0,5.03,4,1.68,1.73,2.12,1,1,0.190420057579398,0.239453222406093,0.570126720014508,0.810713395144289,1.94983338244962,0,0,2,0,-1.13911998730533,-3,1,0,0
"951","E0",10,"09.07.2020","No","Everton","Southampton",1,1,11,17,4,4,13,14,3,3,0,0,2.07,3.51,3.62,1.92,1.9,1,1,0.462627388013239,0.272831536520628,0.264541075466134,1.66071370056034,1.06645476291903,0,-6,0,0,0.594258937641315,-1,0,0,0
"952","E0",10,"09.07.2020","No","Aston Villa","Man United",0,3,9,14,1,6,7,13,2,3,0,0,9.26,5.15,1.35,1.65,2.25,0,3,0.10354842312991,0.186186096734557,0.710265480135533,0.496831366124288,2.31698253714115,-3,-5,-5,-3,-1.82015117101687,-6,-1,0,0
"953","E0",10,"11.07.2020","No","Norwich","West Ham",0,4,11,19,2,7,9,8,1,0,0,0,3.76,3.65,1.99,1.83,2.01,0,3,0.255129101261332,0.262817923491126,0.482052975247542,1.02820522727512,1.70897684923375,-4,-8,-5,-3,-0.68077162195863,1,1,0,0
"954","E0",10,"11.07.2020","No","Watford","Newcastle",2,1,17,8,5,4,23,15,1,4,0,0,1.82,3.58,4.65,2.06,1.78,3,0,0.526377365172518,0.267599666093291,0.20602296873419,1.84673176161085,0.885668572295861,1,9,1,3,0.961063189314985,8,-3,0,0
"955","E0",10,"11.07.2020","No","Liverpool","Burnley",1,1,23,6,9,2,7,4,1,2,0,0,1.25,6.27,11.44,1.52,2.54,1,1,0.764159234997012,0.152344345095098,0.0834964199078903,2.44482205008613,0.402833604818769,0,17,7,0,2.04198844526736,3,-1,0,0
"956","E0",10,"11.07.2020","No","Sheffield United","Chelsea",3,0,9,15,4,4,8,6,1,0,0,0,6.07,3.93,1.6,1.98,1.85,3,0,0.157771527357854,0.243682740728288,0.598545731913858,0.71699732280185,2.03931993646986,3,-6,0,3,-1.32232261366801,2,1,0,0
"957","E0",10,"11.07.2020","No","Brighton","Man City",0,5,3,26,0,8,7,3,1,0,0,0,9.95,5.62,1.31,1.52,2.55,0,3,0.0964703199996855,0.170797096796596,0.732732583203718,0.460208056795653,2.36899484640775,-5,-23,-8,-3,-1.9087867896121,4,1,0,0
"958","E0",10,"12.07.2020","No","Wolves","Everton",3,0,14,6,7,2,9,9,0,2,0,0,2.06,3.25,4.01,2.49,1.55,3,0,0.465644327410578,0.295146865989474,0.239208806599948,1.69207984822121,1.01277328578932,3,8,5,3,0.679306562431891,0,-2,0,0
"959","E0",10,"12.07.2020","No","Aston Villa","Crystal Palace",2,0,12,9,9,5,21,21,2,4,0,1,2.29,3.35,3.24,2.01,1.82,3,0,0.418344889786511,0.285973073913764,0.295682036299725,1.5410077432733,1.17301918281294,2,3,4,3,0.367988560460357,0,-2,-1,0
"960","E0",10,"12.07.2020","No","Tottenham","Arsenal",2,1,15,13,9,4,16,11,5,3,0,0,2.6,3.48,2.68,1.77,2.08,3,0,0.368015657554139,0.274954226908264,0.357030115537597,1.37900119957068,1.34604457352106,1,2,5,3,0.0329566260496246,5,2,0,0
"961","E0",10,"12.07.2020","No","Bournemouth","Leicester",4,1,10,13,4,5,11,12,2,1,0,1,5.14,3.82,1.7,1.89,1.92,3,0,0.186251677813852,0.250610896325444,0.563137425860704,0.809365929766999,1.94002317390756,3,-3,-1,3,-1.13065724414056,-1,1,-1,0
"962","E0",10,"13.07.2020","No","Man United","Southampton",2,2,8,9,4,5,14,15,1,3,0,0,1.29,5.73,10.41,1.61,2.33,1,1,0.741262260795651,0.166881032535147,0.0918567066692018,2.3906678149221,0.442451152542752,0,-1,-1,0,1.94821666237935,-1,-2,0,0
"963","E0",10,"14.07.2020","No","Chelsea","Norwich",1,0,22,2,6,0,10,9,2,2,0,0,1.13,9.5,20.76,1.36,3.17,3,0,0.852239581217715,0.101371655450107,0.0463887633321781,2.65809039910325,0.240537945446641,1,20,6,3,2.41755245365661,1,0,0,0
"964","E0",10,"15.07.2020","No","Burnley","Wolves",1,1,9,14,1,5,10,8,0,0,0,0,4.65,3.3,1.9,2.52,1.53,1,1,0.205911330049261,0.290147783251232,0.503940886699507,0.907881773399015,1.80197044334975,0,-5,-4,0,-0.894088669950739,2,0,0,0
"965","E0",10,"15.07.2020","No","Man City","Bournemouth",2,1,8,15,4,3,10,10,1,1,0,0,1.15,8.68,16.72,1.29,3.65,3,0,0.83245344144417,0.110290490513917,0.0572560680419136,2.60765081484643,0.282058694639657,1,-7,1,3,2.32559212020677,0,0,0,0
"966","E0",10,"15.07.2020","No","Newcastle","Tottenham",1,3,22,8,6,5,6,13,2,3,0,0,4.56,3.77,1.79,1.87,1.95,0,3,0.210214971699494,0.254265323859335,0.53551970444117,0.884910238957819,1.86082443718285,-2,14,1,-3,-0.975914198225027,-7,-1,0,0
"967","E0",10,"15.07.2020","No","Arsenal","Liverpool",2,1,3,24,2,8,14,10,3,1,0,0,3.89,3.89,1.89,1.58,2.41,3,0,0.246414602346806,0.246414602346806,0.507170795306389,0.985658409387223,1.76792698826597,1,-21,-6,3,-0.782268578878749,4,2,0,0
"968","E0",10,"16.07.2020","No","Everton","Aston Villa",1,1,9,15,1,1,15,13,2,1,0,0,2.02,3.57,3.74,1.87,1.95,1,1,0.474848851269649,0.268681983071342,0.256469165659008,1.69322853688029,1.03808948004837,0,-6,0,0,0.655139056831922,2,1,0,0
"969","E0",10,"16.07.2020","No","Leicester","Sheffield United",2,0,15,5,7,1,12,10,1,2,0,0,2.02,3.34,4.01,2.14,1.72,3,0,0.47426382062577,0.286830214869478,0.238905964504752,1.70962167674679,1.00354810838373,2,10,6,3,0.706073568363055,2,-1,0,0
"970","E0",10,"16.07.2020","No","Crystal Palace","Man United",0,2,13,17,5,5,10,15,1,2,0,0,9.84,5,1.35,1.77,2.08,0,3,0.0974954502123234,0.191871046017853,0.710633503769824,0.484357396654823,2.32377155732732,-2,-4,0,-3,-1.8394141606725,-5,-1,0,0
"971","E0",10,"16.07.2020","No","Southampton","Brighton",1,1,21,10,6,2,6,10,1,0,0,0,2.18,3.31,3.53,2.13,1.73,1,1,0.439333721870241,0.289349702017259,0.2713165761125,1.60735086762798,1.10329943035476,0,11,4,0,0.504051437273223,-4,1,0,0
"972","E0",10,"17.07.2020","No","West Ham","Watford",3,1,10,14,4,3,11,11,0,2,0,0,2.42,3.04,3.31,2.03,1.8,3,0,0.395699465972457,0.314997601201759,0.289302932825784,1.50209599911913,1.18290639967911,2,-4,1,3,0.319189599440018,0,-2,0,0
"973","E0",10,"18.07.2020","No","Norwich","Burnley",0,2,6,23,2,8,9,16,0,0,2,0,3.32,3.33,2.25,2.05,1.78,0,3,0.287972603687433,0.287107821093777,0.42491957521879,1.15102563215608,1.56186654675015,-2,-17,-6,-3,-0.410840914594071,-7,0,2,0
"974","E0",10,"19.07.2020","No","Bournemouth","Southampton",0,2,11,16,3,8,12,11,2,2,0,0,2.39,3.65,2.84,1.71,2.16,0,3,0.400585846172871,0.262301417083058,0.337112736744071,1.46405895560167,1.27363962731527,-2,-5,-5,-3,0.1904193282864,1,0,0,0
"975","E0",10,"19.07.2020","No","Tottenham","Leicester",3,0,7,24,3,6,15,10,2,1,0,0,2.32,3.42,3.11,1.95,1.87,3,0,0.412482839392224,0.279812920289462,0.307704240318315,1.51726143846613,1.20292564124441,3,-17,-3,3,0.314335797221727,5,1,0,0
"976","E0",10,"20.07.2020","No","Brighton","Newcastle",0,0,11,12,3,1,13,12,4,2,0,0,1.93,3.42,4.23,2.12,1.73,1,1,0.494904399766003,0.279288155423504,0.225807444810493,1.76400135472151,0.956710489854983,0,-1,2,0,0.807290864866529,1,2,0,0
"977","E0",10,"20.07.2020","No","Sheffield United","Everton",0,1,8,5,0,2,11,19,1,3,0,0,2.17,3.29,3.52,2.32,1.62,0,3,0.439357323064666,0.289788872659673,0.270853804275661,1.60786084185367,1.10235028548666,-1,3,-2,-3,0.505510556367016,-8,-2,0,0
"978","E0",10,"20.07.2020","No","Wolves","Crystal Palace",2,0,11,7,5,3,11,15,2,1,0,0,1.5,4.03,7.72,2.29,1.64,3,0,0.638362134412331,0.237603772113771,0.124034093473898,2.15269017535076,0.609706052535466,2,4,2,3,1.5429841228153,-4,1,0,0
"979","E0",10,"21.07.2020","No","Watford","Man City",0,4,2,26,0,10,14,11,2,0,0,0,8.62,5.6,1.33,1.48,2.67,0,3,0.110858738460897,0.170643272416595,0.718497989122507,0.503219487799287,2.32613723978412,-4,-24,-10,-3,-1.82291775198483,3,2,0,0
"980","E0",10,"21.07.2020","No","Aston Villa","Arsenal",1,0,8,7,3,0,13,19,2,4,0,0,3.24,3.78,2.11,1.66,2.25,3,0,0.294751546597485,0.252644182797845,0.45260427060467,1.1368988225903,1.61045699461185,1,1,3,3,-0.473558172021552,-6,-2,0,0
"981","E0",10,"22.07.2020","No","Man United","West Ham",1,1,11,12,4,3,10,9,3,1,0,0,1.24,6.38,11.56,1.47,2.68,1,1,0.768271137852298,0.149319155319255,0.0824097068284471,2.45413256887615,0.396548275804597,0,-1,1,0,2.05758429307155,1,2,0,0
"982","E0",10,"22.07.2020","No","Liverpool","Chelsea",5,3,10,10,7,5,8,11,1,0,0,0,2.04,3.7,3.51,1.6,2.34,3,0,0.468922636972205,0.258541129573864,0.272536233453931,1.66530904049048,1.07614982993566,2,0,2,3,0.589159210554821,-3,1,0,0
"983","E0",10,"26.07.2020","No","Arsenal","Watford",3,2,13,19,5,6,9,12,3,3,0,0,1.93,3.89,3.72,1.61,2.34,3,0,0.496287481008708,0.246230035564732,0.257482483426561,1.73509247859085,1.01867748584441,1,-6,-1,3,0.716414992746441,-3,0,0,0
"984","E0",10,"26.07.2020","No","Burnley","Brighton",1,2,13,14,2,4,11,11,3,0,0,0,2.32,3.44,3.09,1.91,1.91,0,3,0.412332423038729,0.278084657398213,0.309582919563059,1.5150819265144,1.20683341608739,-1,-1,-2,-3,0.308248510427011,0,3,0,0
"985","E0",10,"26.07.2020","No","Chelsea","Wolves",2,0,11,5,3,1,10,16,2,3,0,0,1.84,3.76,4.23,1.9,1.92,3,0,0.51965601965602,0.254299754299754,0.226044226044226,1.81326781326781,0.932432432432432,2,6,2,3,0.880835380835381,-6,-1,0,0
"986","E0",10,"26.07.2020","No","Crystal Palace","Tottenham",1,1,13,7,2,2,11,13,3,2,0,0,6.12,4.23,1.55,1.76,2.08,1,1,0.156367382858615,0.226233660306081,0.617398956835304,0.695335808881925,2.07843053081199,0,6,0,0,-1.38309472193007,-2,1,0,0
"987","E0",10,"26.07.2020","No","Everton","Bournemouth",1,3,13,13,5,7,11,9,1,0,0,0,2.24,3.78,2.98,1.58,2.39,0,3,0.426571943590287,0.25278337397943,0.320644682430283,1.53249920475029,1.21471742127028,-2,0,-2,-3,0.317781783480013,2,1,0,0
"988","E0",10,"26.07.2020","No","Leicester","Man United",0,2,14,7,3,3,12,11,1,4,1,0,3.17,3.49,2.24,1.85,1.99,0,3,0.300888702432866,0.273300053499194,0.42581124406794,1.17596616079779,1.55073378570301,-2,7,0,-3,-0.374767624905222,1,-3,1,0
"989","E0",10,"26.07.2020","No","Man City","Norwich",5,0,31,5,10,4,7,4,1,1,0,0,1.07,12.8,30.42,1.21,4.36,3,0,0.893840385251964,0.0747194697046564,0.0314401450433794,2.75624062546055,0.169039904834795,5,26,6,3,2.58720072062575,3,0,0,0
"990","E0",10,"26.07.2020","No","Newcastle","Liverpool",1,3,3,14,2,6,11,5,1,0,0,0,7.6,4.99,1.4,1.54,2.49,0,3,0.125760576057606,0.191539153915392,0.682700270027003,0.568820882088209,2.2396399639964,-2,-11,-4,-3,-1.67081908190819,6,1,0,0
"991","E0",10,"26.07.2020","No","Southampton","Sheffield United",3,1,13,5,4,3,9,16,0,1,0,0,2.18,3.47,3.34,1.87,1.95,3,0,0.43841637791463,0.275431614943485,0.286152007141884,1.59068074868738,1.13388763636914,2,8,1,3,0.456793112318237,-7,-1,0,0
"992","E0",10,"26.07.2020","No","West Ham","Aston Villa",1,1,10,13,1,4,16,13,2,1,0,0,3.05,3.57,2.28,1.66,2.24,1,1,0.313277217776854,0.267645802302354,0.419076979920792,1.20747745563292,1.52487674206473,0,-3,-3,0,-0.317399286431813,3,1,0,0
"993","E1",10,"02.08.2019","Yes","Luton","Middlesbrough",3,3,12,17,4,8,14,20,2,2,0,0,2.32,3.28,3.19,2.06,1.76,1,1,0.410746812386157,0.290528233151184,0.298724954462659,1.52276867030965,1.18670309653916,0,-5,-4,0,0.336065573770492,-6,0,0,0
"994","E1",10,"03.08.2019","Yes","Barnsley","Fulham",1,0,17,15,4,4,16,14,3,1,0,0,3.3,3.45,2.17,1.85,1.96,3,0,0.287582829155863,0.275079227888217,0.437337942955921,1.13782771535581,1.58709305675598,1,2,0,3,-0.449265341400173,2,2,0,0
"995","E1",10,"03.08.2019","Yes","Blackburn","Charlton",1,2,14,9,2,5,15,13,0,3,0,0,1.8,3.64,4.48,2.01,1.81,0,3,0.527345164795364,0.260775081492213,0.211879753712423,1.8428105758783,0.896414342629482,-1,5,-3,-3,0.946396233248823,2,-3,0,0
"996","E1",10,"03.08.2019","Yes","Brentford","Birmingham",0,1,15,1,3,1,10,12,1,3,0,0,1.72,3.75,4.92,1.86,1.95,0,3,0.553017768505863,0.253650816488022,0.193331415006115,1.91270412200561,0.833645061506366,-1,14,2,-3,1.07905906049924,-2,-2,0,0
"997","E1",10,"03.08.2019","Yes","Millwall","Preston",1,0,8,5,3,0,11,18,2,3,0,0,2.58,3.17,2.84,2.16,1.69,3,0,0.367332283361759,0.298964445133545,0.333703271504696,1.40096129521882,1.30007425964763,1,3,3,3,0.100887035571187,-7,-1,0,0
"998","E1",10,"03.08.2019","Yes","Reading","Sheffield Weds",1,3,13,13,4,5,12,15,0,3,0,1,2.56,3.19,2.86,2.13,1.71,0,3,0.370698131760079,0.297488155895235,0.331813712344686,1.40958255117547,1.29292929292929,-2,0,-1,-3,0.116653258246179,-3,-3,-1,0
"999","E1",10,"03.08.2019","Yes","Stoke","QPR",1,2,13,5,1,3,18,14,1,3,0,0,1.8,3.51,4.69,2.09,1.74,0,3,0.527254907612926,0.270387132109193,0.202357960277882,1.85215185494797,0.877461012942838,-1,8,-2,-3,0.974690842005131,4,-2,0,0
"1000","E1",10,"03.08.2019","Yes","Swansea","Hull",2,1,19,12,8,4,9,10,2,2,0,0,2.03,3.45,3.7,1.87,1.94,3,0,0.467933796440551,0.27533495848531,0.25673124507414,1.67913634780696,1.04552869370773,1,7,4,3,0.633607654099232,-1,0,0,0
"1001","E1",10,"03.08.2019","Yes","Wigan","Cardiff",3,2,12,13,4,4,9,15,2,4,0,0,2.99,3.19,2.46,2.08,1.74,3,0,0.31718328759261,0.297297188057023,0.385519524350367,1.24884705083485,1.45385576110812,1,-1,0,3,-0.205008710273272,-6,-2,0,0
"1002","E1",10,"03.08.2019","Yes","Nott'm Forest","West Brom",1,2,15,12,4,3,8,6,0,1,0,0,2.42,3.29,2.97,1.91,1.9,0,3,0.392098874420658,0.288413153829177,0.319487971750166,1.46470977709115,1.24687706907967,-1,3,1,-3,0.217832708011477,2,-1,0,0
"1003","E1",10,"04.08.2019","Yes","Bristol City","Leeds",1,3,13,18,3,4,8,12,3,2,0,0,3.02,3.32,2.36,1.94,1.87,0,3,0.313548469714432,0.285215776667947,0.401235753617621,1.22586118581124,1.48892303752081,-2,-5,-1,-3,-0.263061851709566,-4,1,0,0
"1004","E1",10,"05.08.2019","Yes","Huddersfield","Derby",1,2,14,11,2,3,18,14,0,0,0,0,2.19,3.34,3.35,2.04,1.77,0,3,0.433009160181269,0.283919179879335,0.283071659939396,1.58294666042314,1.13313415969752,-1,3,-1,-3,0.449812500725616,4,0,0,0
"1005","E1",10,"10.08.2019","Yes","Leeds","Nott'm Forest",1,1,14,6,4,1,12,12,2,2,0,0,1.5,4.18,6.67,1.79,2.02,1,1,0.631417079600323,0.226585076411599,0.141997843988079,2.12083631521257,0.652578608375835,0,8,3,0,1.46825770683673,0,0,0,0
"1006","E1",10,"10.08.2019","Yes","Birmingham","Bristol City",1,1,12,8,3,5,6,11,2,3,0,0,2.59,3.18,2.8,2.12,1.72,1,1,0.365034724215118,0.297308155885898,0.337657119898984,1.39241232853125,1.31027951558285,0,4,-2,0,0.0821328129484016,-5,-1,0,0
"1007","E1",10,"10.08.2019","Yes","Cardiff","Luton",2,1,16,8,4,2,13,11,2,2,0,0,1.88,3.45,4.3,1.91,1.9,3,0,0.504506036388369,0.274919231423227,0.220574732188403,1.78843734058834,0.936643427988437,1,8,2,3,0.851793912599898,2,0,0,0
"1008","E1",10,"10.08.2019","Yes","Charlton","Stoke",3,1,5,12,3,3,10,11,0,0,0,0,3.31,3.35,2.19,2.01,1.8,3,0,0.285757130782624,0.282345105340443,0.431897763876933,1.13961649768831,1.57803839697124,2,-7,0,3,-0.43842189928293,-1,0,0,0
"1009","E1",10,"10.08.2019","Yes","Derby","Swansea",0,0,17,13,3,3,8,14,2,1,0,0,2.23,3.31,3.27,1.96,1.85,1,1,0.424507100807543,0.28599723105765,0.289495668134807,1.55951853348028,1.15448423546207,0,4,0,0,0.405034298018206,-6,1,0,0
"1010","E1",10,"10.08.2019","Yes","Fulham","Blackburn",2,0,12,9,2,0,9,15,0,2,0,0,1.76,3.86,4.41,1.67,2.19,3,0,0.53906858615863,0.245792930476474,0.215138483364896,1.86299868895237,0.891208380571161,2,3,2,3,0.971790308381204,-6,-2,0,0
"1011","E1",10,"10.08.2019","Yes","Hull","Reading",2,1,14,13,5,4,23,12,2,2,0,0,2.06,3.49,3.52,1.83,1.98,3,0,0.459667582150314,0.271322412386718,0.269010005462968,1.65032515883766,1.07835242877562,1,1,1,3,0.571972730062038,11,0,0,0
"1012","E1",10,"10.08.2019","Yes","Middlesbrough","Brentford",0,1,14,9,5,2,10,17,0,1,0,0,2.4,3.32,2.94,1.91,1.89,0,3,0.39382201994771,0.28469061682967,0.32148736322262,1.4661566766728,1.24915270649753,-1,5,3,-3,0.217003970175269,-7,-1,0,0
"1013","E1",10,"10.08.2019","Yes","Preston","Wigan",3,0,16,11,5,6,13,18,1,2,0,0,2.15,3.29,3.48,2.09,1.74,3,0,0.440274258114879,0.287717220348629,0.272008521536491,1.60853999469327,1.1037427849581,3,5,-1,3,0.504797209735163,-5,-1,0,0
"1014","E1",10,"10.08.2019","Yes","QPR","Huddersfield",1,1,17,6,5,4,14,20,2,5,0,0,2.67,3.23,2.68,2.04,1.78,1,1,0.354246381378371,0.292829052099148,0.352924566522481,1.35556819623426,1.35160275166659,0,11,1,0,0.00396544456766867,-6,-3,0,0
"1015","E1",10,"10.08.2019","Yes","Sheffield Weds","Barnsley",2,0,16,11,7,3,10,22,1,1,0,0,2.22,3.28,3.32,2.03,1.78,3,0,0.42634760547499,0.288564537851975,0.285087856673035,1.56760735427694,1.14382810787108,2,5,4,3,0.423779246405863,-12,0,0,0
"1016","E1",10,"10.08.2019","Yes","West Brom","Millwall",1,1,10,9,4,2,17,15,1,2,0,0,1.9,3.48,4.1,1.9,1.9,1,1,0.497663062434601,0.271712591559121,0.230624346006278,1.76470177886292,0.963585629577956,0,1,2,0,0.801116149284967,2,-1,0,0
"1017","E1",10,"16.08.2019","Yes","Huddersfield","Fulham",1,2,6,17,1,8,13,14,2,2,0,0,3.25,3.29,2.28,2.05,1.77,0,3,0.292973281205451,0.289411296023622,0.417615422770928,1.16833113963997,1.5422575643364,-1,-11,-7,-3,-0.37392642469643,-1,0,0,0
"1018","E1",10,"17.08.2019","Yes","Barnsley","Charlton",2,2,13,12,3,5,15,21,4,3,0,0,2.01,3.46,3.74,1.93,1.88,1,1,0.472063737578614,0.274233558535553,0.253702703885833,1.6904247712714,1.03534167019305,0,1,-2,0,0.655083101078344,-6,1,0,0
"1019","E1",10,"17.08.2019","Yes","Blackburn","Middlesbrough",1,0,14,9,3,2,16,11,5,3,0,0,2.43,3.22,3.01,2.09,1.74,3,0,0.39032503594283,0.294562061286049,0.315112902771122,1.46553716911454,1.23990076959941,1,5,1,3,0.225636399515124,5,2,0,0
"1020","E1",10,"17.08.2019","Yes","Brentford","Hull",1,1,15,20,4,4,18,11,1,1,0,0,1.68,3.97,4.86,1.66,2.22,1,1,0.565338162127951,0.239236300346337,0.195425537525712,1.93525078673019,0.825512912923472,0,-5,0,0,1.10973787380672,7,0,0,0
"1021","E1",10,"17.08.2019","Yes","Bristol City","QPR",2,0,9,15,3,2,11,11,2,2,0,0,2.07,3.33,3.73,2.03,1.79,3,0,0.459436066446952,0.285595392656214,0.254968540896834,1.66390359199707,1.05050101534672,2,-6,1,3,0.613402576650355,0,0,0,0
"1022","E1",10,"17.08.2019","Yes","Luton","West Brom",1,2,8,24,4,3,10,6,2,0,0,0,2.69,3.38,2.6,1.8,2.01,0,3,0.353297794501934,0.281174871955681,0.365527333542385,1.34106825546148,1.37775687258284,-1,-16,1,-3,-0.0366886171213545,4,2,0,0
"1023","E1",10,"17.08.2019","Yes","Millwall","Sheffield Weds",1,0,3,21,2,9,6,16,1,1,1,0,2.55,3.07,2.97,2.32,1.6,3,0,0.371857144604994,0.308871569623041,0.319271285771965,1.42444300343802,1.26668542693894,1,-18,-7,3,0.157757576499089,-10,0,1,0
"1024","E1",10,"17.08.2019","Yes","Nott'm Forest","Birmingham",3,0,14,9,5,2,8,10,0,2,0,0,2.02,3.28,3.92,2.15,1.7,3,0,0.469228074273035,0.288975826229125,0.24179609949784,1.69666004904823,1.01436412472264,3,5,3,3,0.682295924325587,-2,-2,0,0
"1025","E1",10,"17.08.2019","Yes","Stoke","Derby",2,2,19,8,5,6,13,17,3,3,0,0,2.29,3.16,3.34,2.21,1.66,1,1,0.414883998836451,0.300659606751732,0.284456394411818,1.54531160326108,1.15402878998719,0,11,-1,0,0.391282813273898,-4,0,0,0
"1026","E1",10,"17.08.2019","Yes","Swansea","Preston",3,2,13,17,4,5,12,10,0,1,0,0,2.29,3.32,3.18,1.95,1.86,3,0,0.41495759081226,0.286220747879541,0.2988216613082,1.53109352031632,1.18268573180414,1,-4,-1,3,0.34840778851218,2,-1,0,0
"1027","E1",10,"17.08.2019","Yes","Wigan","Leeds",0,2,6,20,2,6,17,19,3,2,1,0,4.29,3.56,1.86,1.9,1.91,0,3,0.221655385727771,0.267107192351724,0.511237421920504,0.932073349535038,1.80081945811324,-2,-14,-4,-3,-0.8687461085782,-2,1,1,0
"1028","E1",10,"18.08.2019","Yes","Reading","Cardiff",3,0,14,14,6,7,6,13,1,2,0,0,3.41,3.29,2.19,2.05,1.77,3,0,0.278276217658805,0.288426110096208,0.433297672244988,1.12325476307262,1.58831912683117,3,0,-1,3,-0.46506436375855,-7,-1,0,0
"1029","E1",10,"20.08.2019","Yes","Birmingham","Barnsley",2,0,14,6,6,1,13,11,1,1,0,0,2.24,3.3,3.33,2.07,1.76,3,0,0.425267606287877,0.288666496389347,0.286065897322776,1.56446931525298,1.14686418835768,2,8,5,3,0.417605126895302,2,0,0,0
"1030","E1",10,"20.08.2019","Yes","Derby","Bristol City",1,2,18,8,4,3,12,8,2,1,0,0,2.15,3.33,3.48,1.93,1.88,0,3,0.441801150595313,0.2852469891231,0.272951860281587,1.61065044090904,1.10410256996786,-1,10,1,-3,0.506547870941178,4,1,0,0
"1031","E1",10,"20.08.2019","Yes","Hull","Blackburn",0,1,12,13,1,5,19,5,4,1,0,0,2.37,3.42,2.97,1.8,2.01,0,3,0.401451285881976,0.278198698111194,0.32035001600683,1.48255255575712,1.23924874613168,-1,-1,-4,-3,0.24330380962544,14,3,0,0
"1032","E1",10,"20.08.2019","Yes","Middlesbrough","Wigan",1,0,13,11,3,1,17,11,2,2,0,0,1.95,3.34,4.17,2.1,1.73,3,0,0.487458132526958,0.284593819888493,0.227948047584549,1.74696821746937,0.968437962642139,1,2,2,3,0.778530254827228,6,0,0,0
"1033","E1",10,"20.08.2019","Yes","Sheffield Weds","Luton",1,0,9,10,3,2,21,3,2,1,0,0,1.86,3.56,4.3,1.89,1.92,3,0,0.5115010892955,0.267244951148772,0.221253959555728,1.80174821903527,0.931006829815956,1,-1,1,3,0.870741389219316,18,1,0,0
"1034","E1",10,"21.08.2019","Yes","Cardiff","Huddersfield",2,1,24,8,6,3,15,12,1,1,0,0,2.05,3.34,3.78,2.09,1.74,3,0,0.463800273316386,0.284667832424728,0.251531894258886,1.67606865237388,1.03926351520139,1,16,3,3,0.636805137172498,3,0,0,0
"1035","E1",10,"21.08.2019","Yes","Charlton","Nott'm Forest",1,1,8,14,3,3,9,19,3,3,0,0,2.65,3.25,2.72,2.04,1.78,1,1,0.358467995377223,0.292289288538351,0.349242716084426,1.36769327467002,1.34001743679163,0,-6,0,0,0.0276758378783888,-10,0,0,0
"1036","E1",10,"21.08.2019","Yes","Fulham","Millwall",4,0,11,7,7,1,11,11,2,1,0,0,1.66,3.87,5.25,1.83,1.98,3,0,0.57302287014866,0.245792755671002,0.181184374180338,1.96486136611698,0.789345878212016,4,4,6,3,1.17551548790497,0,1,0,0
"1037","E1",10,"21.08.2019","Yes","Leeds","Brentford",1,0,11,5,4,1,8,13,2,1,0,0,1.61,4.16,5.26,1.72,2.12,3,0,0.590631562467947,0.228585772974374,0.18078266455768,2.00048046037821,0.770933766647412,1,6,3,3,1.2295466937308,-5,1,0,0
"1038","E1",10,"21.08.2019","Yes","Preston","Stoke",3,1,8,8,5,2,16,6,2,2,0,0,2.43,3.19,3.04,2.16,1.69,3,0,0.39045759265597,0.297433213214422,0.312109194129608,1.46880599118233,1.23376079560325,2,0,3,3,0.235045195579087,10,0,0,0
"1039","E1",10,"21.08.2019","Yes","QPR","Swansea",1,3,22,10,3,5,10,13,2,3,0,0,2.53,3.28,2.83,2.03,1.79,0,3,0.375187444170941,0.28939763224161,0.335414923587449,1.41495996475443,1.29564240300396,-2,12,-2,-3,0.119317561750476,-3,-1,0,0
"1040","E1",10,"21.08.2019","Yes","West Brom","Reading",1,1,20,10,4,5,9,11,2,2,0,0,1.65,3.95,5.23,1.72,2.11,1,1,0.57696443283853,0.241010459286981,0.182025107874489,1.97190375780257,0.787085782910447,0,10,-1,0,1.18481797489213,-2,0,0,0
"1041","E1",10,"24.08.2019","Yes","Derby","West Brom",1,1,11,13,4,4,12,18,1,1,0,0,2.45,3.38,2.83,1.84,1.97,1,1,0.386014471406261,0.279803389037082,0.334182139556657,1.43784680325586,1.28234980770705,0,-2,0,0,0.155496995548812,-6,0,0,0
"1042","E1",10,"24.08.2019","Yes","Barnsley","Luton",1,3,17,16,5,7,17,12,3,1,0,0,2.25,3.46,3.09,1.78,2.03,0,3,0.420442881917818,0.273409388530373,0.306147729551809,1.53473803428383,1.1918525771858,-2,1,-2,-3,0.342885457098026,5,2,0,0
"1043","E1",10,"24.08.2019","Yes","Blackburn","Cardiff",0,0,9,13,2,3,9,14,1,3,0,0,2.33,3.3,3.1,2.02,1.8,1,1,0.406888871211519,0.287288203006921,0.305822925781561,1.50795481664148,1.2047569803516,0,-4,-1,0,0.303197836289874,-5,-2,0,0
"1044","E1",10,"24.08.2019","Yes","Charlton","Brentford",1,0,3,22,1,4,12,10,1,3,0,0,3.06,3.4,2.31,1.9,1.91,3,0,0.310108739428111,0.2790978654853,0.410793395086589,1.20942408376963,1.51147805074507,1,-19,-3,3,-0.302053966975433,2,-2,0,0
"1045","E1",10,"24.08.2019","Yes","Fulham","Nott'm Forest",1,2,20,11,6,3,8,11,2,4,0,0,1.65,3.89,5.18,1.86,1.95,0,3,0.573823104765105,0.243395404334813,0.182781490900082,1.96486471863013,0.791739877035058,-1,9,3,-3,1.17312484159507,-3,-2,0,0
"1046","E1",10,"24.08.2019","Yes","Huddersfield","Reading",0,2,10,11,2,4,8,18,1,1,0,0,2.15,3.29,3.5,2.04,1.78,0,3,0.440959656882455,0.288165125318322,0.270875217799223,1.61104409596569,1.10079077871599,-2,-1,-2,-3,0.510253317249698,-10,0,0,0
"1047","E1",10,"24.08.2019","Yes","Hull","Bristol City",1,3,16,10,6,4,11,13,0,3,0,0,2.46,3.35,2.84,1.87,1.93,0,3,0.384537657529485,0.282376906723144,0.333085435747371,1.4359898793116,1.28163321396526,-2,6,2,-3,0.154356665346342,-2,-3,0,0
"1048","E1",10,"24.08.2019","Yes","Middlesbrough","Millwall",1,1,11,12,2,4,13,10,0,2,0,0,1.99,3.39,3.88,2.21,1.66,1,1,0.476211509567169,0.279545989391937,0.244242501040894,1.70818051809345,1.01227349251462,0,-1,-2,0,0.695907025578827,3,-2,0,0
"1049","E1",10,"24.08.2019","Yes","Preston","Sheffield Weds",2,1,8,11,4,3,10,16,0,3,0,0,2.43,3.21,3,2.09,1.73,3,0,0.389558379145884,0.29489933374595,0.315542287108166,1.4635744711836,1.24152619507045,1,-3,1,3,0.222048276113154,-6,-3,0,0
"1050","E1",10,"24.08.2019","Yes","QPR","Wigan",3,1,20,9,5,3,13,16,2,4,0,0,1.95,3.53,3.87,1.9,1.91,3,0,0.486314170680394,0.268643805333362,0.245042023986245,1.72758631737454,1.0037698772921,2,11,2,3,0.723816440082446,-3,-2,0,0
"1051","E1",10,"24.08.2019","Yes","Stoke","Leeds",0,3,7,21,2,10,9,11,0,2,0,0,3.53,3.52,2.05,1.93,1.87,0,3,0.268471357722458,0.269234060443261,0.462294581834282,1.07464813361063,1.65611780594611,-3,-14,-8,-3,-0.58146967233547,-2,-2,0,0
"1052","E1",10,"25.08.2019","Yes","Swansea","Birmingham",3,0,12,4,6,0,8,13,1,5,0,0,1.91,3.47,4.09,2.03,1.78,3,0,0.495681390337351,0.272839036179925,0.231479573482724,1.75988320719198,0.967277756628097,3,8,6,3,0.792605450563882,-5,-4,0,0
"1053","E1",10,"30.08.2019","Yes","Cardiff","Fulham",1,1,9,11,2,4,16,8,1,3,0,1,2.83,3.43,2.48,1.78,2.03,1,1,0.337131465577032,0.278158031365306,0.384710503057662,1.2895524280964,1.43228954053829,0,-2,-2,0,-0.142737112441889,8,-2,-1,0
"1054","E1",10,"31.08.2019","Yes","Bristol City","Middlesbrough",2,2,18,22,5,6,13,11,1,1,0,0,2.01,3.43,3.79,1.99,1.82,1,1,0.472511894852773,0.276894725555123,0.250593379592104,1.69443041011344,1.02867486433143,0,-4,-1,0,0.665755545782007,2,0,0,0
"1055","E1",10,"31.08.2019","Yes","Birmingham","Stoke",2,1,12,7,4,3,24,12,2,1,0,0,2.84,3.1,2.64,2.42,1.56,3,0,0.334237265984905,0.306204463031333,0.359558270983762,1.30891626098605,1.38487927598262,1,5,1,3,-0.0759630149965693,12,1,0,0
"1056","E1",10,"31.08.2019","Yes","Brentford","Derby",3,0,22,5,8,0,12,13,0,2,0,0,1.98,3.5,3.82,1.9,1.91,3,0,0.479837494078296,0.271450925221436,0.248711580700268,1.71096340745632,1.01758566732224,3,17,8,3,0.693377740134082,-1,-2,0,0
"1057","E1",10,"31.08.2019","Yes","Leeds","Swansea",0,1,21,7,3,2,15,10,2,2,0,0,1.59,4.13,5.55,1.69,2.17,0,3,0.598274201504984,0.230328324550345,0.171397473944671,2.0251509290653,0.744520746384358,-1,14,1,-3,1.28063018268094,5,0,0,0
"1058","E1",10,"31.08.2019","Yes","Luton","Huddersfield",2,1,13,13,4,3,18,14,2,2,0,0,2.08,3.45,3.55,1.92,1.89,3,0,0.456868413690199,0.275445304485685,0.267686281824116,1.64605054555628,1.07850414995803,1,0,1,3,0.567546395598246,4,0,0,0
"1059","E1",10,"31.08.2019","Yes","Millwall","Hull",1,1,13,7,5,3,10,14,2,4,0,1,2.16,3.28,3.51,2.14,1.7,1,1,0.43976897689769,0.28960396039604,0.270627062706271,1.60891089108911,1.10148514851485,0,6,2,0,0.507425742574257,-4,-2,-1,0
"1060","E1",10,"31.08.2019","Yes","Nott'm Forest","Preston",1,1,10,12,2,5,11,7,4,1,0,0,2.23,3.24,3.39,2.07,1.76,1,1,0.426241341172362,0.293369811979743,0.280388846847896,1.57209383549683,1.13453635252343,0,-2,-3,0,0.437557482973398,4,3,0,0
"1061","E1",10,"31.08.2019","Yes","Reading","Charlton",0,2,19,14,3,5,14,14,1,3,0,0,1.99,3.57,3.69,1.84,1.97,0,3,0.476935776428548,0.265854956608631,0.257209266962821,1.69666228589427,1.03748275749709,-2,5,-2,-3,0.65917952839718,0,-2,0,0
"1062","E1",10,"31.08.2019","Yes","Sheffield Weds","QPR",1,2,7,11,2,5,22,13,4,3,0,0,2.02,3.36,3.84,1.98,1.83,0,3,0.4700944386149,0.282616299405386,0.247289261979713,1.69289961525009,1.02448408534453,-1,-4,-3,-3,0.668415529905561,9,1,0,0
"1063","E1",10,"31.08.2019","Yes","West Brom","Blackburn",3,2,21,7,8,4,15,16,2,2,0,0,1.84,3.69,4.22,1.76,2.06,3,0,0.51688563443116,0.257742430177055,0.225371935391785,1.80839933347053,0.933858236352411,1,14,4,3,0.874541097118123,-1,0,0,0
"1064","E1",10,"31.08.2019","Yes","Wigan","Barnsley",0,0,12,13,4,3,12,18,1,4,0,1,2.2,3.43,3.25,1.88,1.93,1,1,0.431346373362741,0.276665312360942,0.291988314276317,1.57070443244917,1.15263025518989,0,-1,1,0,0.418074177259272,-6,-3,-1,0
"1065","E1",10,"13.09.2019","Yes","Derby","Cardiff",1,1,13,13,5,4,13,10,2,2,0,0,2.55,3.4,2.76,1.83,1.99,1,1,0.373983739837398,0.280487804878049,0.345528455284553,1.40243902439024,1.31707317073171,0,0,1,0,0.0853658536585367,3,0,0,0
"1066","E1",10,"14.09.2019","Yes","Fulham","West Brom",1,1,17,9,6,3,13,10,2,1,0,0,2.04,3.55,3.55,1.7,2.16,1,1,0.465268676277851,0.267365661861075,0.267365661861075,1.66317169069463,1.0694626474443,0,8,3,0,0.593709043250327,3,1,0,0
"1067","E1",10,"14.09.2019","Yes","Blackburn","Millwall",2,0,14,14,8,3,10,6,0,1,0,0,2.12,3.35,3.55,2.14,1.71,3,0,0.448426688787919,0.283780471710564,0.267792839501518,1.62906053807432,1.08715899021512,2,0,5,3,0.541901547859203,4,-1,0,0
"1068","E1",10,"14.09.2019","Yes","Charlton","Birmingham",0,1,12,11,3,6,7,18,1,3,0,0,2.25,3.29,3.27,2.13,1.71,0,3,0.421591563701344,0.288322497972044,0.290085938326613,1.55309718907607,1.15858031295188,-1,1,-3,-3,0.394516876124193,-11,-2,0,0
"1069","E1",10,"14.09.2019","Yes","Hull","Wigan",2,2,16,10,3,3,15,16,2,6,0,0,2.02,3.45,3.71,1.82,1.99,1,1,0.469487614946429,0.2748884006353,0.255623984418271,1.68335124547459,1.04176035389011,0,6,0,0,0.641590891584473,-1,-4,0,0
"1070","E1",10,"14.09.2019","Yes","Middlesbrough","Reading",1,0,10,18,2,7,12,17,0,3,0,0,2.09,3.42,3.57,1.97,1.84,3,0,0.455260361317747,0.278214665249734,0.266524973432519,1.64399574920298,1.07778958554729,1,-8,-5,3,0.566206163655686,-5,-3,0,0
"1071","E1",10,"14.09.2019","Yes","Preston","Brentford",2,0,4,8,2,2,12,16,2,1,0,0,2.7,3.35,2.6,1.91,1.89,3,0,0.351564076690212,0.28335015136226,0.365085771947528,1.3380423814329,1.37860746720484,2,-4,0,3,-0.0405650857719477,-4,1,0,0
"1072","E1",10,"14.09.2019","Yes","QPR","Luton",3,2,18,14,3,3,15,15,2,1,0,0,1.99,3.59,3.69,1.68,2.18,3,0,0.477643207147828,0.264766011761609,0.257590781090563,1.69769563320509,1.0375383550333,1,4,0,3,0.660157278171794,0,1,0,0
"1073","E1",10,"14.09.2019","Yes","Stoke","Bristol City",1,2,12,12,4,3,13,12,2,3,1,0,2.15,3.3,3.51,2.05,1.78,0,3,0.441686209460619,0.287765257678888,0.270548532860493,1.61282388606074,1.09941085626037,-1,0,1,-3,0.513413029800378,1,-1,1,0
"1074","E1",10,"14.09.2019","Yes","Swansea","Nott'm Forest",0,1,9,14,1,2,7,17,2,1,0,0,1.95,3.64,3.79,1.79,2.03,0,3,0.487751068621593,0.261295215332996,0.250953716045411,1.72454842119778,1.01415636346923,-1,-5,-1,-3,0.710392057728547,-10,1,0,0
"1075","E1",10,"15.09.2019","Yes","Huddersfield","Sheffield Weds",0,2,9,13,6,4,8,14,2,3,0,0,2.68,3.19,2.72,2.13,1.71,0,3,0.353929742694448,0.297345363768376,0.348724893537176,1.35913459185172,1.3435200443799,-2,-4,2,-3,0.0156145474718137,-6,-1,0,0
"1076","E1",10,"15.09.2019","Yes","Barnsley","Leeds",0,2,17,21,6,7,11,11,1,0,0,0,6.38,4.3,1.5,1.71,2.13,0,3,0.148432825516638,0.220232889952594,0.631334284530768,0.665531366502508,2.1142357435449,-2,-4,-1,-3,-1.44870437704239,0,1,0,0
"1077","E1",10,"21.09.2019","Yes","Leeds","Derby",1,1,13,4,5,1,8,12,0,4,0,0,1.39,4.94,7.49,1.59,2.35,1,1,0.681683103560723,0.191809618208382,0.126507278230895,2.23685892889055,0.571331452901067,0,9,4,0,1.66552747598948,-4,-4,0,0
"1078","E1",10,"21.09.2019","Yes","Birmingham","Preston",0,1,7,4,2,3,12,12,0,0,0,0,2.77,3.15,2.67,2.29,1.61,0,3,0.342839323493085,0.301480928912966,0.355679747593949,1.32999889939222,1.36852017169481,-1,3,-1,-3,-0.0385212723025936,0,0,0,0
"1079","E1",10,"21.09.2019","Yes","Brentford","Stoke",0,0,12,11,2,4,13,6,1,2,0,0,1.87,3.61,4.15,1.89,1.92,1,1,0.507973159459798,0.263132910855907,0.228893929684295,1.7870523892353,0.949814699908791,0,1,-2,0,0.837237689326511,7,-1,0,0
"1080","E1",10,"21.09.2019","Yes","Bristol City","Swansea",0,0,11,15,2,2,8,10,1,1,0,1,2.4,3.52,2.83,1.75,2.08,1,1,0.395276490381563,0.269506697987429,0.335216811631008,1.45533616913212,1.27515713288045,0,-4,0,0,0.180179036251667,-2,0,-1,0
"1081","E1",10,"21.09.2019","Yes","Cardiff","Middlesbrough",1,0,9,11,1,0,10,12,1,2,0,0,2.06,3.39,3.63,1.89,1.91,3,0,0.459735718368582,0.279367427681203,0.260896853950215,1.65857458278695,1.06205798953185,1,-2,1,3,0.596516593255102,-2,-1,0,0
"1082","E1",10,"21.09.2019","Yes","Luton","Hull",0,3,6,14,2,4,7,17,0,2,0,0,2.18,3.67,3.1,1.62,2.29,0,3,0.43530663156767,0.25857451139442,0.30611885703791,1.56449440609743,1.17693108250815,-3,-8,-2,-3,0.387563323589281,-10,-2,0,0
"1083","E1",10,"21.09.2019","Yes","Millwall","QPR",1,2,13,14,5,3,8,8,2,3,0,0,2.54,3.24,2.84,2.03,1.79,0,3,0.373368824255015,0.292702720249302,0.333928455495683,1.41280919301435,1.29448808673635,-1,-1,2,-3,0.118321106277998,0,-1,0,0
"1084","E1",10,"21.09.2019","Yes","Nott'm Forest","Barnsley",1,0,11,13,1,5,6,10,2,3,0,0,1.72,3.8,4.84,1.82,2,3,0,0.553096280613963,0.250348842804215,0.196554876581822,1.9096376846461,0.84001347254968,1,-2,-4,3,1.06962421209642,-4,-1,0,0
"1085","E1",10,"21.09.2019","Yes","Reading","Blackburn",1,2,16,9,3,5,14,14,2,2,0,0,2.4,3.38,2.92,1.83,1.98,0,3,0.394948298492173,0.280436661651247,0.32461503985658,1.46528155712777,1.25428178122099,-1,7,-2,-3,0.210999775906778,0,0,0,0
"1086","E1",10,"21.09.2019","Yes","Sheffield Weds","Fulham",1,1,12,9,5,2,15,11,2,1,0,0,2.81,3.36,2.49,1.91,1.9,1,1,0.337288197090091,0.282077331494987,0.380634471414922,1.29394192276526,1.42398074573975,0,3,3,0,-0.130038822974493,4,1,0,0
"1087","E1",10,"21.09.2019","Yes","Wigan","Charlton",2,0,17,13,4,3,16,13,1,1,0,0,2.17,3.42,3.32,1.89,1.92,3,0,0.437040515469473,0.277303484961625,0.285655999568902,1.58842503137004,1.13427148366833,2,4,1,3,0.454153547701711,3,0,0,0
"1088","E1",10,"22.09.2019","Yes","West Brom","Huddersfield",4,2,17,5,7,2,13,9,0,0,0,0,1.65,3.93,5.15,1.82,1.99,3,0,0.574634811123887,0.241258890166518,0.184106298709595,1.96516332353818,0.793577786295303,2,12,5,3,1.17158553724288,4,0,0,0
"1089","E1",10,"27.09.2019","Yes","Fulham","Wigan",2,0,21,5,6,0,14,16,2,3,0,0,1.5,4.41,6.43,1.63,2.29,3,0,0.635559201457763,0.216176599135294,0.148264199406943,2.12285420350858,0.660969197356123,2,16,6,3,1.46188500615246,-2,-1,0,0
"1090","E1",10,"27.09.2019","Yes","Stoke","Nott'm Forest",2,3,23,6,8,4,9,16,0,4,0,0,2.39,3.12,3.23,2.47,1.54,0,3,0.39904807536202,0.30568105772924,0.29527086690874,1.5028252838153,1.19149365845546,-1,17,4,-3,0.311331625359842,-7,-4,0,0
"1091","E1",10,"28.09.2019","Yes","QPR","West Brom",0,2,5,15,0,7,21,10,1,2,1,0,2.59,3.47,2.64,1.68,2.19,0,3,0.366641719063304,0.273660533825348,0.359697747111348,1.37358569101526,1.35275377515939,-2,-10,-7,-3,0.0208319158558694,11,-1,1,0
"1092","E1",10,"28.09.2019","Yes","Blackburn","Luton",1,2,16,8,2,5,11,8,1,2,0,0,1.78,3.85,4.34,1.68,2.19,0,3,0.534052264184715,0.246912475389297,0.219035260425989,1.84906926794344,0.904018256667263,-1,8,-3,-3,0.945051011276177,3,-1,0,0
"1093","E1",10,"28.09.2019","Yes","Charlton","Leeds",1,0,3,19,3,4,9,15,3,1,0,0,6.42,4.52,1.48,1.68,2.18,3,0,0.147968573046433,0.21016775198188,0.641863674971687,0.654073471121178,2.13575877689694,1,-16,-1,3,-1.48168530577576,-6,2,0,0
"1094","E1",10,"28.09.2019","Yes","Derby","Birmingham",3,2,7,17,4,6,9,18,3,1,0,0,2.23,3.21,3.41,2.12,1.72,3,0,0.425774154274623,0.295787029293585,0.278438816431792,1.57310949211745,1.13110347858896,1,-10,-2,3,0.442006013528494,-9,2,0,0
"1095","E1",10,"28.09.2019","Yes","Huddersfield","Millwall",1,1,15,15,6,4,12,12,1,0,0,1,2.46,3.06,3.13,2.35,1.59,1,1,0.386120652121329,0.310410720332833,0.303468627545837,1.46877267669682,1.22081660297035,0,0,2,0,0.247956073726477,0,1,-1,0
"1096","E1",10,"28.09.2019","Yes","Hull","Cardiff",2,2,12,8,3,3,11,11,2,0,0,0,2.5,3.36,2.81,1.8,2.02,1,1,0.379690025978622,0.282507459805522,0.337802514215856,1.42157753774139,1.29591500245309,0,4,0,0,0.125662535288298,0,2,0,0
"1097","E1",10,"28.09.2019","Yes","Middlesbrough","Sheffield Weds",1,4,9,12,2,6,10,19,0,3,0,0,2.44,3.13,3.08,2.22,1.66,0,3,0.388838695105031,0.303120260720854,0.308041044174115,1.46963634603595,1.2272433932432,-3,-3,-4,-3,0.242392952792746,-9,-3,0,0
"1098","E1",10,"28.09.2019","Yes","Preston","Bristol City",3,3,9,15,3,7,11,12,1,1,0,0,2.04,3.46,3.66,1.9,1.91,1,1,0.46577216754204,0.274617116123053,0.259610716334908,1.67193361874917,1.05344926512778,0,-6,-4,0,0.618484353621397,-1,0,0,0
"1099","E1",10,"28.09.2019","Yes","Swansea","Reading",1,1,17,12,4,5,8,14,0,3,0,0,1.88,3.59,4.16,1.76,2.07,1,1,0.506175350117271,0.265072328195117,0.228752321687613,1.78359837854693,0.951329293257955,0,5,-1,0,0.832269085288974,-6,-3,0,0
"1100","E1",10,"29.09.2019","Yes","Barnsley","Brentford",1,3,10,13,3,5,11,8,0,0,0,0,3.73,3.55,1.99,1.75,2.07,0,3,0.254772131401761,0.267690154965794,0.477537713632446,1.03200654917108,1.70030329586313,-2,-3,-2,-3,-0.668296746692055,3,0,0,0
"1101","E1",10,"01.10.2019","Yes","Blackburn","Nott'm Forest",1,1,21,10,6,4,9,10,2,1,0,0,2.08,3.46,3.56,1.92,1.89,1,1,0.457576748194597,0.275075039377099,0.267348212428304,1.64780528396089,1.07711967666201,0,11,2,0,0.570685607298879,-1,1,0,0
"1102","E1",10,"01.10.2019","Yes","Hull","Sheffield Weds",1,0,8,12,2,3,11,10,1,3,0,0,2.75,3.42,2.54,1.85,1.96,3,0,0.346407835130479,0.278544311873923,0.375047852995598,1.31776781726536,1.40368787086072,1,-4,-1,3,-0.0859200535953548,1,-2,0,0
"1103","E1",10,"01.10.2019","Yes","Leeds","West Brom",1,0,19,10,9,4,6,12,1,5,0,0,1.8,3.75,4.42,1.7,2.15,3,0,0.529874364630287,0.254339695022538,0.215785940347176,1.8439627889134,0.901697516064064,1,9,5,3,0.942265272849334,-6,-4,0,0
"1104","E1",10,"01.10.2019","Yes","Middlesbrough","Preston",1,1,14,9,3,1,16,17,2,2,0,0,2.66,3.2,2.75,2.1,1.73,1,1,0.357331384253056,0.297031713160352,0.345636902586592,1.36902586591952,1.33394242092013,0,5,2,0,0.0350834449993909,-1,0,0,0
"1105","E1",10,"01.10.2019","Yes","Wigan","Birmingham",1,0,12,12,3,0,9,14,0,0,0,0,2.49,3.18,2.99,2.21,1.67,3,0,0.382292985947772,0.299342621072312,0.318364392979917,1.44622157891563,1.25443580001206,1,0,3,3,0.191785778903564,-5,0,0,0
"1106","E1",10,"01.10.2019","Yes","Reading","Fulham",1,4,8,16,2,7,10,12,1,0,1,0,3.53,3.59,2.05,1.74,2.1,0,3,0.269888186822254,0.26537752074723,0.464734292430516,1.07504208121399,1.65958039803878,-3,-8,-5,-3,-0.584538316824784,-2,1,1,0
"1107","E1",10,"01.10.2019","Yes","Stoke","Huddersfield",0,1,18,4,0,1,12,12,1,2,0,0,1.79,3.57,4.73,2.18,1.69,0,3,0.531961276623896,0.266725682116744,0.20131304125936,1.86260951198843,0.870664805894824,-1,14,-1,-3,0.991944706093608,0,-1,0,0
"1108","E1",10,"02.10.2019","Yes","Barnsley","Derby",2,2,12,12,7,6,22,14,2,0,0,0,2.55,3.42,2.71,1.81,2,1,1,0.372221352064483,0.277533464258605,0.350245183676912,1.39419752045205,1.32826901528934,0,0,1,0,0.065928505162713,8,2,0,0
"1109","E1",10,"02.10.2019","Yes","Brentford","Bristol City",1,1,18,8,6,3,6,8,1,1,0,0,1.8,3.87,4.16,1.72,2.11,1,1,0.526923530104866,0.245080711676682,0.227995758218452,1.82585130199128,0.929067986332037,0,10,3,0,0.896783315659244,-2,0,0,0
"1110","E1",10,"02.10.2019","Yes","Cardiff","QPR",3,0,10,14,4,4,18,12,2,1,0,0,2.15,3.49,3.32,1.77,2.05,3,0,0.441767098896993,0.272148785853448,0.286084115249559,1.59745008254443,1.13040113160212,3,-4,0,3,0.467048950942303,6,1,0,0
"1111","E1",10,"02.10.2019","Yes","Charlton","Swansea",1,2,8,13,3,4,14,14,4,1,0,0,3.21,3.33,2.26,1.94,1.87,0,3,0.295480512137952,0.284832565754603,0.419686922107445,1.17127410216846,1.54389333207694,-1,-5,-1,-3,-0.37261922990848,0,3,0,0
"1112","E1",10,"02.10.2019","Yes","Luton","Millwall",1,1,13,13,4,4,7,18,0,2,0,0,2.45,3.32,2.9,1.87,1.94,1,1,0.387179796517473,0.285720030562593,0.327100172919934,1.44725942011501,1.2670205493224,0,0,0,0,0.180238870792616,-11,-2,0,0
"1113","E1",10,"04.10.2019","Yes","Birmingham","Middlesbrough",2,1,26,5,8,3,18,11,2,3,0,0,2.5,3.1,3.06,2.28,1.63,3,0,0.381178172466447,0.30740175198907,0.311420075544483,1.45093626938841,1.24166197862252,1,21,5,3,0.209274290765892,7,-1,0,0
"1114","E1",10,"05.10.2019","Yes","Fulham","Charlton",2,2,20,14,7,5,12,14,2,1,0,0,1.4,4.78,7.86,1.66,2.21,1,1,0.679807768859424,0.199106877908618,0.121085353231958,2.23853018448689,0.562362937604493,0,6,2,0,1.6761672468824,-2,1,0,0
"1115","E1",10,"05.10.2019","Yes","Bristol City","Reading",1,0,15,16,3,3,14,9,1,2,0,0,2.04,3.49,3.6,1.74,2.09,3,0,0.464858145007326,0.271722239488523,0.263419615504151,1.6662966745105,1.06198108600098,1,-1,0,3,0.604315588509523,5,-1,0,0
"1116","E1",10,"05.10.2019","Yes","Derby","Luton",2,0,10,7,2,1,10,10,1,0,0,0,2.05,3.51,3.57,1.69,2.16,3,0,0.463332926599297,0.270607549723236,0.266059523677467,1.66060632952113,1.06878612075564,2,3,1,3,0.591820208765489,0,1,0,0
"1117","E1",10,"05.10.2019","Yes","Huddersfield","Hull",3,0,8,14,5,4,13,11,3,1,0,0,2.56,3.23,2.83,2.05,1.77,3,0,0.370759901843477,0.293853049139102,0.335387049017421,1.40613275466953,1.30001419619136,3,-6,1,3,0.106118558478168,2,2,0,0
"1118","E1",10,"05.10.2019","Yes","Millwall","Leeds",2,1,12,5,7,1,14,14,4,1,0,1,5.11,3.8,1.68,1.94,1.87,3,0,0.185652634150313,0.249653936975816,0.56469342887387,0.806611839426757,1.94373422359743,1,7,6,3,-1.13712238417067,0,3,-1,0
"1119","E1",10,"05.10.2019","Yes","Nott'm Forest","Brentford",1,0,13,11,4,3,7,9,0,1,0,0,2.84,3.27,2.53,2.02,1.8,3,0,0.334332857818316,0.290368598227528,0.375298543954157,1.29336717168247,1.41626423009,1,2,1,3,-0.122897058407523,-2,-1,0,0
"1120","E1",10,"05.10.2019","Yes","Preston","Barnsley",5,1,20,6,10,1,10,9,1,3,0,0,1.66,3.9,5.2,1.74,2.1,3,0,0.573108008817046,0.243938280675974,0.18295371050698,1.96326230712711,0.792799412196914,4,14,9,3,1.1704628949302,1,-2,0,0
"1121","E1",10,"05.10.2019","Yes","QPR","Blackburn",4,2,10,8,5,2,14,7,4,4,0,0,2.32,3.47,3,1.67,2.19,3,0,0.409513618983179,0.273795849003163,0.316690532013658,1.5023367059527,1.22386744504414,2,2,3,3,0.278469260908562,7,0,0,0
"1122","E1",10,"05.10.2019","Yes","Sheffield Weds","Wigan",1,0,8,5,2,3,15,9,1,1,0,0,1.7,3.72,5.09,1.81,2,3,0,0.558354319145548,0.255161920039632,0.18648376081482,1.93022487747628,0.814613202484091,1,3,-1,3,1.11561167499219,6,0,0,0
"1123","E1",10,"05.10.2019","Yes","Swansea","Stoke",1,2,22,18,6,9,11,17,2,1,0,0,1.99,3.43,3.87,1.99,1.83,0,3,0.477466718942776,0.277014218861844,0.245519062195381,1.70941437569017,1.01357140544799,-1,4,-3,-3,0.695842970242185,-6,1,0,0
"1124","E1",10,"05.10.2019","Yes","West Brom","Cardiff",4,2,15,18,8,8,6,13,1,1,0,0,1.79,3.79,4.33,1.67,2.2,3,0,0.530309738087929,0.250462910600895,0.219227351311176,1.84139212486468,0.908144964534423,2,-3,0,3,0.933247160330258,-7,0,0,0
"1125","E1",10,"18.10.2019","Yes","Cardiff","Sheffield Weds",1,1,14,12,4,5,11,22,0,3,0,0,2.36,3.23,3.16,2.11,1.72,1,1,0.403635040652979,0.294916004935303,0.301448954411718,1.50582112689424,1.19926286817046,0,2,-1,0,0.306558258723781,-11,-3,0,0
"1126","E1",10,"19.10.2019","Yes","Blackburn","Huddersfield",2,2,13,12,3,2,18,19,1,3,0,0,1.93,3.53,4.05,1.94,1.86,1,1,0.494245641449359,0.270224954106873,0.235529404443768,1.75296187845495,0.976813167438178,0,1,1,0,0.77614871101677,-1,-2,0,0
"1127","E1",10,"19.10.2019","Yes","Barnsley","Swansea",1,1,19,12,5,8,8,5,1,1,0,0,3.74,3.7,1.95,1.71,2.13,1,1,0.25453326748042,0.257284978480209,0.488181754039371,1.02088478092147,1.72183024059832,0,7,-3,0,-0.700945459676851,3,0,0,0
"1128","E1",10,"19.10.2019","Yes","Brentford","Millwall",3,2,23,8,10,4,13,13,3,6,0,0,1.75,3.6,4.91,1.94,1.86,3,0,0.542733008888957,0.263828545987688,0.193438445123355,1.89202757265456,0.844143881357754,1,15,6,3,1.04788369129681,0,-3,0,0
"1129","E1",10,"19.10.2019","Yes","Charlton","Derby",3,0,10,4,7,2,16,13,1,2,0,0,2.64,3.33,2.68,1.92,1.89,3,0,0.359988382787163,0.285396195362796,0.354615421850041,1.36536134372428,1.34924246091292,3,6,5,3,0.0161188828113654,3,-1,0,0
"1130","E1",10,"19.10.2019","Yes","Hull","QPR",2,3,11,15,3,8,14,10,1,0,0,0,2.45,3.49,2.81,1.66,2.21,0,3,0.388516712291864,0.272740958485692,0.338742329222444,1.43829109536128,1.28896794615302,-1,-4,-5,-3,0.149323149208261,4,1,0,0
"1131","E1",10,"19.10.2019","Yes","Leeds","Birmingham",1,0,15,16,5,4,13,18,2,2,0,0,1.41,4.42,8.58,1.87,1.94,3,0,0.674154187465336,0.215058236272879,0.110787576261786,2.23752079866889,0.547420965058236,1,-1,1,3,1.69009983361065,-5,0,0,0
"1132","E1",10,"19.10.2019","Yes","Luton","Bristol City",3,0,12,10,5,2,10,11,2,2,0,0,2.59,3.47,2.64,1.69,2.16,3,0,0.366641719063304,0.273660533825348,0.359697747111348,1.37358569101526,1.35275377515939,3,2,3,3,0.0208319158558694,-1,0,0,0
"1133","E1",10,"19.10.2019","Yes","Middlesbrough","West Brom",0,1,17,19,7,4,10,14,2,4,0,0,3.67,3.55,2,1.87,1.94,0,3,0.258477892859093,0.267215173744471,0.474306933396436,1.04264885232175,1.69013597393378,-1,-2,3,-3,-0.647487121612028,-4,-2,0,0
"1134","E1",10,"19.10.2019","Yes","Reading","Preston",1,0,12,12,6,4,9,14,2,2,0,0,2.87,3.35,2.46,1.9,1.9,3,0,0.330755306894849,0.283363501727826,0.385881191377324,1.27562942241237,1.4410070758598,1,0,2,3,-0.165377653447425,-5,0,0,0
"1135","E1",10,"19.10.2019","Yes","Stoke","Fulham",2,0,9,10,5,4,15,12,2,2,0,0,2.95,3.28,2.44,1.98,1.83,3,0,0.321708230829836,0.289341244191468,0.388950524978695,1.25446593668098,1.45619281912755,2,-1,1,3,-0.201726882446578,3,0,0,0
"1136","E1",10,"20.10.2019","Yes","Wigan","Nott'm Forest",1,0,16,18,6,2,10,10,3,1,0,0,2.78,3.2,2.62,2.1,1.73,3,0,0.34131804784315,0.296520054063737,0.362161898093113,1.32047419759319,1.38300574834308,1,-2,4,3,-0.06253155074989,0,2,0,0
"1137","E1",10,"22.10.2019","Yes","Birmingham","Blackburn",1,0,12,13,6,1,12,6,2,1,0,0,2.45,3.25,2.98,2.03,1.79,3,0,0.38819969136421,0.292642844259174,0.319157464376616,1.4572419183518,1.25011523738902,1,-1,5,3,0.207126680962783,6,1,0,0
"1138","E1",10,"22.10.2019","Yes","Millwall","Cardiff",2,2,12,16,5,7,13,14,1,1,0,0,2.7,3.16,2.75,2.14,1.71,1,1,0.35257840710837,0.301253702276139,0.346167890615491,1.35898892360125,1.33975737412261,0,-4,-2,0,0.0192315494786384,-1,0,0,0
"1139","E1",10,"22.10.2019","Yes","Preston","Leeds",1,1,10,22,2,3,9,9,1,0,0,0,3.53,3.46,2.09,1.89,1.92,1,1,0.269597992759918,0.27505228741113,0.455349719828952,1.08384626569088,1.64110144689799,0,-12,-1,0,-0.557255181207103,0,1,0,0
"1140","E1",10,"22.10.2019","Yes","QPR","Reading",2,2,13,11,6,5,10,22,2,2,0,0,1.94,3.72,3.76,1.67,2.22,1,1,0.490806501417624,0.255958229233922,0.253235269348455,1.72837773348679,1.01566403727929,0,2,1,0,0.712713696207507,-12,0,0,0
"1141","E1",10,"22.10.2019","Yes","Sheffield Weds","Stoke",1,0,11,12,4,1,17,12,2,1,0,0,2.34,3.15,3.28,2.29,1.62,3,0,0.407121072416483,0.302432796652245,0.290446130931272,1.5237960139017,1.17377118944606,1,-1,3,3,0.350024824455635,5,1,0,0
"1142","E1",10,"22.10.2019","Yes","Swansea","Brentford",0,3,17,14,5,7,7,6,2,1,0,0,2.52,3.33,2.83,1.86,1.95,0,3,0.37775533027887,0.285868898589415,0.336375771131715,1.41913488942603,1.29499621198456,-3,3,-2,-3,0.124138677441466,1,1,0,0
"1143","E1",10,"22.10.2019","Yes","West Brom","Barnsley",2,2,11,11,3,3,9,20,3,8,0,0,1.34,5.34,8.5,1.47,2.65,1,1,0.709933120202203,0.178148011436508,0.111918868361289,2.30794737204312,0.513904616520374,0,0,0,0,1.79404275552274,-11,-5,0,0
"1144","E1",10,"23.10.2019","Yes","Bristol City","Charlton",2,1,23,10,8,5,13,12,2,5,1,0,1.98,3.46,3.87,1.96,1.85,3,0,0.479873564701329,0.274609727777061,0.24551670752161,1.71423042188105,1.01115985034189,1,13,3,3,0.703070571539157,1,-3,1,0
"1145","E1",10,"23.10.2019","Yes","Derby","Wigan",1,0,11,16,4,3,8,16,2,2,0,0,2.04,3.33,3.83,2.02,1.8,3,0,0.466146204537231,0.285567044221006,0.248286751241763,1.6840056578327,1.03042729794629,1,-5,1,3,0.653578359886405,-8,0,0,0
"1146","E1",10,"23.10.2019","Yes","Fulham","Luton",3,2,20,13,8,3,12,8,1,0,0,0,1.47,4.46,6.69,1.63,2.27,3,0,0.645441389290883,0.21273516642547,0.141823444283647,2.14905933429812,0.638205499276411,1,7,5,3,1.51085383502171,4,1,0,0
"1147","E1",10,"23.10.2019","Yes","Huddersfield","Middlesbrough",0,0,10,13,2,2,12,14,1,3,0,0,2.27,3.26,3.26,2.11,1.73,1,1,0.417948717948718,0.291025641025641,0.291025641025641,1.54487179487179,1.16410256410256,0,-3,0,0,0.380769230769231,-2,-2,0,0
"1148","E1",10,"23.10.2019","Yes","Nott'm Forest","Hull",1,2,16,18,2,6,8,9,3,2,0,1,1.98,3.51,3.8,1.86,1.95,0,3,0.479580609669277,0.27053265160831,0.249886738722413,1.70927448061614,1.02019286777555,-1,-2,-4,-3,0.689081612840593,-1,1,-1,0
"1149","E1",10,"26.10.2019","Yes","Sheffield Weds","Leeds",0,0,11,9,4,3,16,9,2,0,0,0,3.5,3.37,2.13,2,1.81,1,1,0.271608628694458,0.282086112887419,0.446305258418123,1.09691199897079,1.62100188814179,0,2,1,0,-0.524089889170996,7,2,0,0
"1150","E1",10,"26.10.2019","Yes","Birmingham","Luton",2,1,20,9,6,4,8,10,1,3,0,0,1.99,3.42,3.88,1.97,1.84,3,0,0.477382125871509,0.277774979673773,0.244842894454717,1.7099213572883,1.01230366303793,1,11,2,3,0.697617694250376,-2,-2,0,0
"1151","E1",10,"26.10.2019","Yes","Huddersfield","Barnsley",2,1,11,14,4,2,7,13,1,1,0,0,1.92,3.58,3.99,1.89,1.92,3,0,0.49565905352793,0.26582831921051,0.23851262726156,1.7528054797943,0.981366200995191,1,-3,2,3,0.771439278799109,-6,0,0,0
"1152","E1",10,"26.10.2019","Yes","Hull","Derby",2,0,14,10,4,3,11,8,4,1,0,0,2.12,3.55,3.34,1.73,2.1,3,0,0.448046010021236,0.267565504576062,0.284388485402701,1.61170353463977,1.12073096078417,2,4,1,3,0.490972573855606,3,3,0,0
"1153","E1",10,"26.10.2019","Yes","Middlesbrough","Fulham",0,0,14,7,1,1,16,9,3,2,0,1,3.45,3.41,2.13,1.93,1.89,1,1,0.275372209142298,0.278602381683557,0.446025409174145,1.10471900911045,1.61667860920599,0,7,0,0,-0.51195960009554,7,1,-1,0
"1154","E1",10,"26.10.2019","Yes","Millwall","Stoke",2,0,8,4,4,1,10,18,1,0,0,0,2.72,3.08,2.77,2.24,1.64,3,0,0.349032057471076,0.30823610270173,0.342731839827194,1.35533227511496,1.33643162218331,2,4,3,3,0.0189006529316469,-8,1,0,0
"1155","E1",10,"26.10.2019","Yes","Preston","Blackburn",3,2,12,8,8,1,8,17,0,2,0,0,1.94,3.57,3.9,1.81,2.01,3,0,0.489991131382237,0.266269690443009,0.243739178174754,1.73624308458972,0.997487224967271,1,4,7,3,0.738755859622451,-9,-2,0,0
"1156","E1",10,"26.10.2019","Yes","West Brom","Charlton",2,2,13,13,5,5,12,9,2,3,1,0,1.42,4.69,7.42,1.65,2.24,1,1,0.669278406031233,0.202638664512655,0.128082929456112,2.21047388260636,0.586887452880991,0,0,0,0,1.62358642972536,3,-1,1,0
"1157","E1",10,"27.10.2019","Yes","Swansea","Cardiff",1,0,19,8,5,3,12,15,0,1,0,0,2.31,3.27,3.17,1.88,1.94,3,0,0.410655922796259,0.29009638582855,0.299247691375192,1.52206415421733,1.18783945995412,1,11,2,3,0.334224694263201,-3,-1,0,0
"1158","E1",10,"27.10.2019","Yes","Bristol City","Wigan",2,2,9,19,4,7,8,15,1,2,0,0,1.94,3.45,4.06,1.92,1.89,1,1,0.490159712210075,0.275626041068854,0.23421424672107,1.74610517769908,0.978268781232065,0,-10,-3,0,0.767836396467015,-7,-1,0,0
"1159","E1",10,"28.10.2019","Yes","QPR","Brentford",1,3,8,12,6,9,11,15,0,3,0,0,2.78,3.52,2.44,1.68,2.17,0,3,0.341399815562693,0.269628263427354,0.388971921009953,1.29382771011543,1.43654402645721,-2,-4,-3,-3,-0.142716316341781,-4,-3,0,0
"1160","E1",10,"01.11.2019","Yes","Barnsley","Bristol City",2,2,24,9,6,3,9,11,2,0,0,0,2.62,3.55,2.59,1.62,2.29,1,1,0.363687785042699,0.268411830087851,0.367900384869449,1.35947518521595,1.3721129846962,0,15,3,0,-0.0126377994802485,-2,2,0,0
"1161","E1",10,"02.11.2019","Yes","Wigan","Swansea",1,2,14,6,2,2,19,8,4,2,0,0,2.87,3.31,2.49,1.94,1.87,0,3,0.331160925590347,0.287139533668972,0.381699540740681,1.28062231044001,1.43223815589102,-1,8,0,-3,-0.151615845451002,11,2,0,0
"1162","E1",10,"02.11.2019","Yes","Blackburn","Sheffield Weds",2,1,15,17,6,5,10,16,0,0,0,0,2.47,3.24,2.94,2.07,1.76,3,0,0.384248614371808,0.292930270832829,0.322821114795363,1.44567611394825,1.26139361521892,1,-2,1,3,0.184282498729337,-6,0,0,0
"1163","E1",10,"02.11.2019","Yes","Brentford","Huddersfield",0,1,10,4,3,2,12,15,1,5,0,0,1.51,4.18,6.59,1.95,1.87,0,3,0.628780909815129,0.227143343019341,0.14407574716553,2.11348607246473,0.659370584515932,-1,6,1,-3,1.4541154879488,-3,-4,0,0
"1164","E1",10,"02.11.2019","Yes","Cardiff","Birmingham",4,2,12,25,6,6,12,18,1,3,1,1,2.02,3.29,3.94,2.09,1.74,3,0,0.470218230360719,0.288705418033025,0.241076351606257,1.69936010911518,1.01193447285179,2,-13,0,3,0.687425636263386,-6,-2,0,0
"1165","E1",10,"02.11.2019","Yes","Derby","Middlesbrough",2,0,23,10,10,1,10,13,0,1,0,1,2.22,3.31,3.32,2,1.82,3,0,0.427465594099845,0.286698978520138,0.285835427380017,1.56909576081967,1.14420526066019,2,13,9,3,0.424890500159484,-3,-1,-1,0
"1166","E1",10,"02.11.2019","Yes","Fulham","Hull",0,3,8,10,1,5,8,14,2,2,0,0,1.6,4.17,5.29,1.55,2.44,0,3,0.593066865975002,0.227555632028778,0.17937750199622,2.00675622995378,0.765688138017438,-3,-2,-4,-3,1.24106809193635,-6,0,0,0
"1167","E1",10,"02.11.2019","Yes","Leeds","QPR",2,0,18,6,6,1,18,20,1,4,0,0,1.48,4.39,6.76,1.65,2.23,3,0,0.642646778580462,0.21665540599068,0.140697815428859,2.14459574173206,0.638748852277255,2,12,5,3,1.50584688945481,-2,-3,0,0
"1168","E1",10,"02.11.2019","Yes","Luton","Nott'm Forest",1,2,9,12,3,4,9,10,0,1,0,0,2.65,3.4,2.62,1.8,2.02,0,3,0.358312215920518,0.279272756526286,0.362415027553196,1.35420940428784,1.36651783918587,-1,-3,-1,-3,-0.0123084348980331,-1,-1,0,0
"1169","E1",10,"02.11.2019","Yes","Reading","Millwall",2,1,12,14,6,2,11,13,1,0,0,0,2.2,3.31,3.38,2.01,1.8,3,0,0.431864678952204,0.28703996788364,0.281095353164156,1.58263400474025,1.13032602737611,1,-2,4,3,0.452307977364142,-2,1,0,0
"1170","E1",10,"03.11.2019","Yes","Charlton","Preston",0,1,8,16,1,5,16,11,3,5,0,0,3.04,3.3,2.37,2,1.82,0,3,0.312118382300122,0.287527237027991,0.400354380671887,1.22388238392836,1.48859037904365,-1,-8,-4,-3,-0.264707995115293,5,-2,0,0
"1171","E1",10,"04.11.2019","Yes","Stoke","West Brom",0,2,8,9,3,3,18,18,2,1,0,0,2.94,3.24,2.46,2.02,1.8,0,3,0.322317659047896,0.292473431358276,0.385208909593827,1.25942640850197,1.44810016013976,-2,-1,0,-3,-0.188673751637793,0,1,0,0
"1172","E1",10,"09.11.2019","Yes","Nott'm Forest","Derby",1,0,19,11,4,7,14,18,3,3,0,0,2.17,3.4,3.37,1.98,1.83,3,0,0.438182868112999,0.279663771707414,0.282153360179587,1.59421237604641,1.12612385224617,1,8,-3,3,0.468088523800236,-4,0,0,0
"1173","E1",10,"09.11.2019","Yes","Barnsley","Stoke",2,4,12,11,4,9,14,7,3,1,0,0,2.84,3.29,2.52,1.91,1.9,0,3,0.334425118590468,0.288683081093291,0.376891800316241,1.29195843686469,1.41935848204201,-2,1,-5,-3,-0.127400045177321,7,2,0,0
"1174","E1",10,"09.11.2019","Yes","Birmingham","Fulham",0,1,16,10,4,3,12,8,3,2,0,0,3.12,3.28,2.35,1.99,1.82,0,3,0.304982273993416,0.290105089896176,0.404912636110408,1.20505191187642,1.5048429982274,-1,6,1,-3,-0.299791086350975,4,1,0,0
"1175","E1",10,"09.11.2019","Yes","Hull","West Brom",0,1,10,9,3,2,11,10,3,3,0,0,3.06,3.55,2.25,1.65,2.22,0,3,0.310368945619864,0.267529288337122,0.422101766043014,1.19863612519671,1.53383458646617,-1,1,1,-3,-0.335198461269453,1,0,0,0
"1176","E1",10,"09.11.2019","Yes","Leeds","Blackburn",2,1,15,4,4,1,9,12,1,2,0,0,1.43,4.54,7.46,1.76,2.06,3,0,0.663716675419962,0.209056133447257,0.127227191132781,2.20020615970714,0.5907377068456,1,11,3,3,1.60946845286154,-3,-1,0,0
"1177","E1",10,"09.11.2019","Yes","Millwall","Charlton",2,1,8,6,5,5,14,13,1,1,0,0,2.03,3.42,3.76,2.14,1.71,3,0,0.468721978815073,0.278218016665087,0.25306000451984,1.68438395311031,1.03739803022461,1,2,0,3,0.6469859228857,1,0,0,0
"1178","E1",10,"09.11.2019","Yes","Preston","Huddersfield",3,1,21,8,4,1,11,17,4,2,0,0,1.81,3.47,4.75,2.1,1.74,3,0,0.52557819181332,0.274148855095709,0.200272953090971,1.85088343053567,0.874967714368621,2,13,3,3,0.97591571616705,-6,2,0,0
"1179","E1",10,"09.11.2019","Yes","QPR","Middlesbrough",2,2,14,9,7,4,20,9,4,2,0,0,1.89,3.72,3.94,1.74,2.1,1,1,0.503078855777746,0.255596515435468,0.241324628786787,1.7648330827687,0.979570401795828,0,5,3,0,0.785262680972877,11,2,0,0
"1180","E1",10,"09.11.2019","Yes","Reading","Luton",3,0,17,4,7,1,12,13,0,1,0,0,1.91,3.66,3.9,1.69,2.17,3,0,0.497116349047141,0.259424105650284,0.243459545302574,1.75077315279171,0.989802741558008,3,13,6,3,0.760970411233701,-1,-1,0,0
"1181","E1",10,"09.11.2019","Yes","Sheffield Weds","Swansea",2,2,20,13,7,6,10,9,1,0,0,0,2.17,3.34,3.44,2.08,1.76,1,1,0.438497530741693,0.28489210829625,0.276610360962057,1.60038470052133,1.11472319118242,0,7,1,0,0.485661509338911,1,1,0,0
"1182","E1",10,"09.11.2019","Yes","Wigan","Brentford",0,3,5,7,1,5,16,17,1,1,1,1,3.57,3.41,2.09,2.03,1.79,0,3,0.266307698631263,0.27880307452012,0.454889226848617,1.07772617041391,1.64347075506597,-3,-2,-4,-3,-0.565744584652062,-1,0,0,0
"1183","E1",10,"10.11.2019","Yes","Cardiff","Bristol City",0,1,16,6,3,2,15,13,1,2,0,0,2.02,3.52,3.64,1.83,1.99,0,3,0.469746297111013,0.269570318228479,0.260683384660507,1.67880920956152,1.05162047221,-1,10,1,-3,0.627188737351518,2,-1,0,0
"1184","E1",10,"22.11.2019","Yes","Fulham","QPR",2,1,11,19,4,7,13,15,1,0,0,0,1.84,3.72,4.19,1.69,2.16,3,0,0.517126060010882,0.255782782370974,0.227091157618144,1.80716096240362,0.937056255225406,1,-8,-3,3,0.870104707178215,-2,1,0,0
"1185","E1",10,"23.11.2019","Yes","Charlton","Cardiff",2,2,15,23,4,8,12,16,1,3,0,0,2.9,3.29,2.47,1.99,1.82,1,1,0.327273532740241,0.288478189953404,0.384248277306356,1.27029878817413,1.44122302187247,0,-8,-4,0,-0.170924233698344,-4,-2,0,0
"1186","E1",10,"23.11.2019","Yes","Blackburn","Barnsley",3,2,9,16,5,5,8,14,1,1,0,0,1.79,3.79,4.37,1.67,2.21,3,0,0.531376027874117,0.250966514484082,0.217657457641801,1.84509459810643,0.903938887409485,1,-7,0,3,0.941155710696949,-6,0,0,0
"1187","E1",10,"23.11.2019","Yes","Brentford","Reading",1,0,11,6,4,1,13,15,3,3,0,0,1.71,3.67,5.08,1.87,1.94,3,0,0.554768330749477,0.258488786262018,0.186742882988505,1.92279377851045,0.818717435227533,1,5,3,3,1.10407634328292,-2,0,0,0
"1188","E1",10,"23.11.2019","Yes","Bristol City","Nott'm Forest",0,0,7,12,0,3,15,13,1,2,0,1,2.31,3.31,3.14,1.97,1.85,1,1,0.410921642041838,0.28677613085095,0.302302227107212,1.51954105697646,1.19368281217259,0,-5,-3,0,0.325858244803878,2,-1,-1,0
"1189","E1",10,"23.11.2019","Yes","Derby","Preston",1,0,13,12,4,2,15,9,0,2,0,0,2.82,3.24,2.55,2,1.82,3,0,0.335992972695996,0.292438328087256,0.371568699216748,1.30041724617524,1.4071444257375,1,1,2,3,-0.106727179562258,6,-2,0,0
"1190","E1",10,"23.11.2019","Yes","Huddersfield","Birmingham",1,1,17,10,6,2,9,16,1,1,0,0,2.69,3,2.86,2.39,1.57,1,1,0.35245692877741,0.316036379470411,0.331506691752179,1.37340716580264,1.31055645472695,0,7,4,0,0.062850711075692,-7,0,0,0
"1191","E1",10,"23.11.2019","Yes","Luton","Leeds",1,2,11,21,5,12,7,11,0,1,0,0,6.25,4.33,1.51,1.67,2.21,0,3,0.151918175206734,0.219281430725656,0.62880039406761,0.675035956345859,2.10568261292848,-1,-10,-7,-3,-1.43064665658263,-4,-1,0,0
"1192","E1",10,"23.11.2019","Yes","Stoke","Wigan",2,1,16,10,4,2,13,20,3,2,0,0,1.81,3.44,4.77,2.21,1.67,3,0,0.524764222598173,0.27611140782055,0.199124369581277,1.85040407561507,0.873484516564382,1,6,2,3,0.976919559050686,-7,1,0,0
"1193","E1",10,"23.11.2019","Yes","Swansea","Millwall",0,1,10,13,4,5,14,10,1,2,0,0,1.97,3.44,3.91,2.01,1.81,0,3,0.481577091217656,0.27578688072639,0.242636028055954,1.72051815437936,1.00369496489425,-1,-3,-1,-3,0.716823189485103,4,-1,0,0
"1194","E1",10,"23.11.2019","Yes","West Brom","Sheffield Weds",2,1,9,15,3,2,10,20,1,3,0,1,1.92,3.5,4.04,1.87,1.94,3,0,0.494115344832406,0.271057560593777,0.234827094573817,1.753403595091,0.975538844315227,1,-6,1,3,0.777864750775768,-10,-2,-1,0
"1195","E1",10,"24.11.2019","Yes","Middlesbrough","Hull",2,2,10,12,5,4,10,16,2,1,1,0,2.42,3.41,2.85,1.75,2.08,1,1,0.390808156765604,0.277347724156235,0.331844119078162,1.44977219445305,1.27288008139072,0,-2,1,0,0.176892113062326,-6,1,1,0
"1196","E1",10,"26.11.2019","Yes","Cardiff","Stoke",1,0,7,12,3,1,11,9,1,1,0,0,2.41,3.13,3.16,2.21,1.67,3,0,0.394847044076376,0.304019609017274,0.30113334690635,1.4885607412464,1.20741964973632,1,-5,2,3,0.281141091510078,2,0,0,0
"1197","E1",10,"26.11.2019","Yes","Fulham","Derby",3,0,17,8,8,0,9,11,1,2,0,0,1.59,4.09,5.57,1.68,2.18,3,0,0.597296326496367,0.232200772403233,0.170502901100399,2.02408975189234,0.743709475704431,3,9,8,3,1.2803802761879,-2,-1,0,0
"1198","E1",10,"26.11.2019","Yes","Huddersfield","Swansea",1,1,14,6,5,2,14,11,3,2,1,0,2.67,3.24,2.72,2.04,1.78,1,1,0.356418345061878,0.293715117689881,0.349866537248241,1.36297015287552,1.3433147294346,0,8,3,0,0.0196554234409123,3,1,1,0
"1199","E1",10,"26.11.2019","Yes","Luton","Charlton",2,1,16,10,4,2,9,11,3,1,0,0,2.09,3.66,3.34,1.69,2.17,3,0,0.455210319351764,0.259942504766444,0.284847175881792,1.62557346282173,1.11448403241182,1,6,2,3,0.511089430409914,-2,2,0,0
"1200","E1",10,"26.11.2019","Yes","Millwall","Wigan",2,2,9,14,5,7,7,13,2,1,0,0,1.96,3.33,4.17,2.34,1.6,1,1,0.48576406015511,0.285915182553759,0.228320757291131,1.74320736301909,0.970877454427152,0,-5,-2,0,0.772329908591938,-6,1,0,0
"1201","E1",10,"26.11.2019","Yes","Reading","Leeds",0,1,8,16,2,2,12,12,1,1,0,0,4.49,3.7,1.79,1.86,1.95,0,3,0.211779452628617,0.256997227649322,0.531223319722061,0.892335585535172,1.85066718681551,-1,-8,0,-3,-0.958331601280333,0,0,0,0
"1202","E1",10,"27.11.2019","Yes","Blackburn","Brentford",1,0,7,16,4,4,15,14,2,1,0,0,3.08,3.32,2.33,1.94,1.87,3,0,0.307730252689199,0.285484692253835,0.406785055056966,1.20867545032143,1.50583985742473,1,-9,0,3,-0.297164407103303,1,1,0,0
"1203","E1",10,"27.11.2019","Yes","Hull","Preston",4,0,21,13,10,4,11,9,1,1,0,0,2.61,3.37,2.68,1.84,1.97,3,0,0.363853179223353,0.281797269368829,0.354349551407818,1.37335680703889,1.34484592359228,4,8,6,3,0.0285108834466061,2,0,0,0
"1204","E1",10,"27.11.2019","Yes","Middlesbrough","Barnsley",1,0,12,14,5,2,9,13,3,0,0,0,1.96,3.64,3.71,1.65,2.23,3,0,0.483848314606742,0.260533707865168,0.25561797752809,1.71207865168539,1.02738764044944,1,-2,3,3,0.684691011235955,-4,3,0,0
"1205","E1",10,"27.11.2019","Yes","QPR","Nott'm Forest",0,4,11,14,4,8,11,8,1,2,1,0,2.22,3.49,3.14,1.73,2.1,0,3,0.426783294128643,0.271478198557475,0.301738507313882,1.5518280809434,1.17669372049912,-4,-3,-4,-3,0.375134360444285,3,-1,1,0
"1206","E1",10,"27.11.2019","Yes","Sheffield Weds","Birmingham",1,1,24,7,5,2,7,10,1,3,0,0,1.94,3.41,4.08,2.17,1.69,1,1,0.489139835603339,0.278278968055858,0.232581196340803,1.74569847486587,0.976022557078268,0,17,3,0,0.769675917787606,-3,-2,0,0
"1207","E1",10,"27.11.2019","Yes","West Brom","Bristol City",4,1,15,9,7,1,12,11,0,2,0,0,1.64,3.95,5.3,1.66,2.21,3,0,0.579836587730231,0.240742279462678,0.17942113280709,1.98025204265337,0.77900567788395,3,6,6,3,1.20124636476942,1,-2,0,0
"1208","E1",10,"29.11.2019","Yes","Swansea","Fulham",1,2,18,10,7,4,12,18,0,1,0,0,2.87,3.49,2.4,1.71,2.14,0,3,0.331325182058757,0.272465121062646,0.396209696878597,1.26644066723892,1.46109421169844,-1,8,3,-3,-0.19465354445952,-6,-1,0,0
"1209","E1",10,"30.11.2019","Yes","Charlton","Sheffield Weds",1,3,8,18,2,8,9,12,2,2,0,0,3.69,3.47,2.02,2.03,1.8,0,3,0.257060603282296,0.273358393692124,0.46958100302558,1.04454020353901,1.68210140276886,-2,-10,-6,-3,-0.637561199229852,-3,0,0,0
"1210","E1",10,"30.11.2019","Yes","Barnsley","Hull",3,1,11,6,5,1,9,15,0,1,0,0,2.72,3.65,2.43,1.58,2.36,3,0,0.349095331619902,0.260147753974283,0.390756914405816,1.30743374883399,1.43241849719173,2,5,4,3,-0.124984748357742,-6,-1,0,0
"1211","E1",10,"30.11.2019","Yes","Birmingham","Millwall",1,1,10,11,3,5,13,11,0,0,0,0,2.16,3.2,3.6,2.24,1.65,1,1,0.43956043956044,0.296703296703297,0.263736263736264,1.61538461538462,1.08791208791209,0,-1,-2,0,0.527472527472527,2,0,0,0
"1212","E1",10,"30.11.2019","Yes","Brentford","Luton",7,0,21,4,12,1,7,10,0,0,0,0,1.47,4.5,6.68,1.64,2.25,3,0,0.646526693422462,0.211198719851338,0.1422745867262,2.15077880011872,0.638022480029939,7,17,11,3,1.51275632008878,-3,0,0,0
"1213","E1",10,"30.11.2019","Yes","Bristol City","Huddersfield",5,2,12,11,8,5,6,11,0,1,0,0,2.15,3.27,3.52,2.08,1.75,3,0,0.440861162285657,0.289862843704637,0.269275994009705,1.61244633056161,1.09769082573375,3,1,3,3,0.514755504827856,-5,-1,0,0
"1214","E1",10,"30.11.2019","Yes","Derby","QPR",1,1,13,13,4,2,10,14,1,3,0,0,2.37,3.5,2.87,1.72,2.13,1,1,0.399532254921068,0.27054041261798,0.329927332460952,1.46913717738118,1.26032241000084,0,0,2,0,0.208814767380349,-4,-2,0,0
"1215","E1",10,"30.11.2019","Yes","Leeds","Middlesbrough",4,0,16,7,10,1,11,19,2,3,0,0,1.32,5.23,9.76,1.66,2.23,3,0,0.720650105320224,0.181884921419254,0.0974649732605222,2.34383523737993,0.47427984120082,4,9,9,3,1.86955539617911,-8,-1,0,0
"1216","E1",10,"30.11.2019","Yes","Nott'm Forest","Cardiff",0,1,32,10,2,4,12,14,0,1,0,0,2.25,3.3,3.25,2.02,1.8,0,3,0.42120765832106,0.287187039764359,0.29160530191458,1.55081001472754,1.1620029455081,-1,22,-2,-3,0.38880706921944,-2,-1,0,0
"1217","E1",10,"30.11.2019","Yes","Stoke","Blackburn",1,2,16,6,4,5,9,5,0,0,0,0,1.96,3.37,4.04,2.06,1.77,0,3,0.483851249537998,0.281409035339607,0.234739715122395,1.7329627839536,0.985628180706792,-1,10,-1,-3,0.747334603246809,4,0,0,0
"1218","E1",10,"30.11.2019","Yes","Wigan","Reading",1,3,9,21,7,5,15,11,2,2,0,0,2.61,3.21,2.78,2.12,1.72,0,3,0.363380935511062,0.295459265322078,0.34115979916686,1.38560207185526,1.31893866282266,-2,-12,2,-3,0.0666634090326048,4,0,0,0
"1219","E1",10,"02.12.2019","Yes","Preston","West Brom",0,1,7,11,2,4,10,10,0,1,0,0,2.92,3.41,2.38,1.8,2.01,0,3,0.324338797726855,0.277732929431794,0.397928272841351,1.25074932261236,1.47151774795585,-1,-4,-2,-3,-0.22076842534349,0,-1,0,0
"1220","E1",10,"06.12.2019","Yes","Millwall","Nott'm Forest",2,2,16,10,5,5,10,9,1,2,0,0,2.53,3.12,2.96,2.27,1.64,1,1,0.375146236838685,0.304205121539061,0.320648641622254,1.42964383205512,1.26615104640582,0,6,0,0,0.163492785649292,1,-1,0,0
"1221","E1",10,"07.12.2019","Yes","Huddersfield","Leeds",0,2,10,14,3,4,10,15,2,3,0,0,6.51,3.89,1.55,2.03,1.78,0,3,0.145485825417009,0.243473707831551,0.61104046675144,0.679931184082579,2.07659510808587,-2,-4,-1,-3,-1.39666392400329,-5,-1,0,0
"1222","E1",10,"07.12.2019","Yes","Blackburn","Derby",1,0,11,13,3,1,9,13,1,1,0,0,2.02,3.49,3.67,1.87,1.94,3,0,0.469658801312726,0.271836899327136,0.258504299360138,1.68081330326531,1.04734979740755,1,-2,2,3,0.633463505857764,-4,0,0,0
"1223","E1",10,"07.12.2019","Yes","Cardiff","Barnsley",3,2,11,14,2,2,10,18,1,5,0,0,1.75,3.88,4.44,1.64,2.25,3,0,0.541953994060502,0.24443801278502,0.213607993154477,1.87029999496653,0.885261992248452,1,-3,0,3,0.985038002718076,-8,-4,0,0
"1224","E1",10,"07.12.2019","Yes","Fulham","Bristol City",1,2,21,12,5,3,15,6,6,2,0,0,1.65,4.07,4.99,1.62,2.29,0,3,0.576014725610707,0.233519483355692,0.190465791033601,1.96156366018781,0.804916856456494,-1,9,2,-3,1.15664680373132,9,4,0,0
"1225","E1",10,"07.12.2019","Yes","Hull","Stoke",2,1,23,6,6,4,12,7,0,0,0,0,2.48,3.33,2.84,1.89,1.92,3,0,0.381973278187957,0.284472591563404,0.333554130248639,1.43039242612728,1.28513498230932,1,17,2,3,0.145257443817956,5,0,0,0
"1226","E1",10,"07.12.2019","Yes","Luton","Wigan",2,1,18,11,5,1,9,18,1,2,0,1,2.4,3.44,2.87,1.77,2.05,3,0,0.394646797352179,0.275334974896869,0.330018227750951,1.45927536695341,1.26538965814972,1,7,4,3,0.193885708803684,-9,-1,-1,0
"1227","E1",10,"07.12.2019","Yes","Middlesbrough","Charlton",1,0,23,5,3,2,15,20,1,3,0,0,1.91,3.61,3.94,1.81,2,3,0,0.496559476886876,0.262722604114663,0.24071791899846,1.75240103477529,0.984876361110044,1,18,1,3,0.767524673665248,-5,-2,0,0
"1228","E1",10,"07.12.2019","Yes","QPR","Preston",2,0,11,8,6,3,14,19,2,2,0,0,2.31,3.51,2.96,1.69,2.16,3,0,0.410083954008834,0.269884311612651,0.320031734378515,1.50013617363915,1.2299795147482,2,3,3,3,0.270156658890955,-5,0,0,0
"1229","E1",10,"07.12.2019","Yes","Reading","Birmingham",2,3,14,16,4,5,19,7,1,1,0,0,2.19,3.37,3.32,1.97,1.84,0,3,0.432995994504538,0.281383153698794,0.285620851796668,1.58037113721241,1.1382457090888,-1,-2,-1,-3,0.442125428123609,12,0,0,0
"1230","E1",10,"07.12.2019","Yes","Sheffield Weds","Brentford",2,1,12,12,3,2,10,7,1,2,0,0,2.6,3.21,2.79,2.11,1.72,3,0,0.364714793593393,0.295407620979072,0.339877585427535,1.38955200175925,1.31504037726168,1,0,1,3,0.0745116244975748,3,-1,0,0
"1231","E1",10,"08.12.2019","Yes","West Brom","Swansea",5,1,19,11,9,4,15,11,1,2,0,0,1.62,4.04,5.2,1.6,2.31,3,0,0.583931867203309,0.234150897244891,0.1819172355518,1.98594649885482,0.779902603900291,4,8,5,3,1.20604389495453,4,-1,0,0
"1232","E1",10,"10.12.2019","Yes","Bristol City","Millwall",1,2,10,14,5,3,6,14,0,0,0,0,2.22,3.24,3.44,2.05,1.77,0,3,0.42908620530352,0.294003511041301,0.276910283655179,1.58126212695186,1.12473436200684,-1,-4,2,-3,0.456527764945024,-8,0,0,0
"1233","E1",10,"10.12.2019","Yes","Charlton","Huddersfield",0,1,6,15,0,5,16,15,3,2,0,0,2.72,3.23,2.68,2.1,1.73,0,3,0.350013747594171,0.29474841902667,0.355237833379159,1.34478966180918,1.36046191916415,-1,-9,-5,-3,-0.0156722573549626,1,1,0,0
"1234","E1",10,"10.12.2019","Yes","Leeds","Hull",2,0,12,11,2,2,8,11,2,1,0,0,1.39,4.81,8.1,1.58,2.35,3,0,0.684656599755034,0.197852946706756,0.11749045353821,2.25182274597186,0.550324307321385,2,1,0,3,1.70149843865047,-3,1,0,0
"1235","E1",10,"10.12.2019","Yes","Nott'm Forest","Middlesbrough",1,1,9,9,3,3,13,20,4,2,0,0,1.78,3.64,4.69,1.94,1.86,1,1,0.535176651305684,0.261707263550581,0.203116085143735,1.86723721746763,0.871055518981786,0,0,0,0,0.996181698485846,-7,2,0,0
"1236","E1",10,"10.12.2019","Yes","Preston","Fulham",2,1,19,15,7,1,13,12,4,1,1,1,3.09,3.5,2.26,1.79,2.02,3,0,0.307681535996017,0.271638841779341,0.420679622224643,1.19468344976739,1.53367770845327,1,4,6,3,-0.338994258685877,1,3,0,0
"1237","E1",10,"10.12.2019","Yes","Stoke","Luton",3,0,15,4,8,1,16,10,1,2,0,0,1.61,4.09,5.37,1.76,2.07,3,0,0.590508120955318,0.232449407026421,0.177042472018261,2.00397376989237,0.763576823081204,3,11,7,3,1.24039694681117,6,-1,0,0
"1238","E1",10,"11.12.2019","Yes","Barnsley","Reading",1,1,21,14,8,6,11,17,2,1,0,0,2.62,3.45,2.62,1.72,2.11,1,1,0.362394957983193,0.275210084033613,0.362394957983193,1.36239495798319,1.36239495798319,0,7,2,0,0,-6,1,0,0
"1239","E1",10,"11.12.2019","Yes","Birmingham","QPR",0,2,16,6,2,2,15,15,2,2,0,0,2.3,3.39,3.09,1.86,1.94,0,3,0.412745132806128,0.280033570930411,0.307221296263461,1.51826896934879,1.20169745972079,-2,10,0,-3,0.316571509628001,0,0,0,0
"1240","E1",10,"11.12.2019","Yes","Brentford","Cardiff",2,1,16,10,5,3,13,11,2,2,0,0,1.68,3.69,5.33,1.92,1.88,3,0,0.564818085482162,0.257152949487814,0.178028965030025,1.9516072059343,0.791239844577888,1,6,2,3,1.16036736135641,2,0,0,0
"1241","E1",10,"11.12.2019","Yes","Derby","Sheffield Weds",1,1,11,12,2,3,12,14,3,3,0,1,3.05,3.29,2.37,1.99,1.82,1,1,0.31114152663775,0.288444272414935,0.400414200947315,1.22186885232818,1.48968687525688,0,-1,-1,0,-0.267818022928696,-2,0,-1,0
"1242","E1",10,"11.12.2019","Yes","Swansea","Blackburn",1,1,14,8,3,2,11,11,0,0,1,1,2.16,3.43,3.34,1.8,2.01,1,1,0.439281578563924,0.276632131107311,0.284086290328765,1.59447686679908,1.12889100209361,0,6,1,0,0.465585864705476,0,0,0,0
"1243","E1",10,"11.12.2019","Yes","Wigan","West Brom",1,1,14,6,5,2,14,14,1,2,0,0,5.22,3.82,1.67,1.83,1.97,1,1,0.182075051659379,0.248804128183759,0.569120820156862,0.795029283161896,1.95616658865434,0,8,3,0,-1.16113730549245,0,-1,0,0
"1244","E1",10,"13.12.2019","Yes","Charlton","Hull",2,2,5,15,2,5,7,11,2,2,0,0,3.78,3.63,1.96,1.75,2.08,1,1,0.251895910780669,0.262304832713755,0.485799256505576,1.01799256505576,1.71970260223048,0,-10,-3,0,-0.701710037174721,-4,0,0,0
"1245","E1",10,"14.12.2019","Yes","Birmingham","West Brom",2,3,16,9,6,3,11,12,2,2,0,0,4.02,3.64,1.89,1.89,1.91,0,3,0.236329533977781,0.261001298513923,0.502669167508296,0.969989900447266,1.76900880103881,-1,7,3,-3,-0.799018900591545,-1,0,0,0
"1246","E1",10,"14.12.2019","Yes","Barnsley","QPR",5,3,13,12,7,6,9,14,4,3,0,0,2.57,3.54,2.61,1.58,2.36,3,0,0.368913431477067,0.267826982739001,0.363259585783932,1.3745672771702,1.3576057400908,2,1,1,3,0.0169615370794054,-5,1,0,0
"1247","E1",10,"14.12.2019","Yes","Brentford","Fulham",1,0,23,11,7,2,6,13,1,1,0,0,2.15,3.45,3.35,1.85,1.95,3,0,0.441505109349632,0.275140865246872,0.283354025403495,1.59965619329577,1.12520294145736,1,12,5,3,0.474453251838411,-7,0,0,0
"1248","E1",10,"14.12.2019","Yes","Bristol City","Blackburn",0,2,6,8,1,5,16,16,1,2,0,0,2.16,3.43,3.34,1.84,1.96,0,3,0.439281578563924,0.276632131107311,0.284086290328765,1.59447686679908,1.12889100209361,-2,-2,-4,-3,0.465585864705476,0,-1,0,0
"1249","E1",10,"14.12.2019","Yes","Derby","Millwall",0,1,11,7,1,2,13,9,1,2,0,0,2.46,3.16,3.03,2.24,1.64,0,3,0.386046399109756,0.300529791712026,0.313423809178218,1.45866898904129,1.24080121924668,-1,4,-1,-3,0.217867769794615,4,-1,0,0
"1250","E1",10,"14.12.2019","Yes","Leeds","Cardiff",3,3,25,10,8,3,5,17,1,1,0,1,1.35,4.94,9.11,1.75,2.07,1,1,0.703497996745395,0.192251476843377,0.104250526411228,2.30274546707956,0.50500305607706,0,15,5,0,1.7977424110025,-12,0,-1,0
"1251","E1",10,"14.12.2019","Yes","Nott'm Forest","Sheffield Weds",0,4,9,13,3,6,6,12,0,0,0,0,2.47,3.2,2.97,2.14,1.7,0,3,0.384094665756004,0.296473070130416,0.319432264113579,1.44875706739843,1.25476986247115,-4,-4,-3,-3,0.193987204927275,-6,0,0,0
"1252","E1",10,"14.12.2019","Yes","Preston","Luton",2,1,11,10,3,3,13,16,0,3,0,0,1.7,3.99,4.72,1.67,2.2,3,0,0.559836859909988,0.238526982919042,0.20163615717097,1.91803756264901,0.843435454431953,1,1,0,3,1.07460210821705,-3,-3,0,0
"1253","E1",10,"14.12.2019","Yes","Stoke","Reading",0,0,11,3,0,0,12,12,1,3,0,0,2.01,3.4,3.8,1.99,1.82,1,1,0.471670560747664,0.278840537383178,0.249488901869159,1.69385221962617,1.02730724299065,0,8,0,0,0.666544976635514,0,-2,0,0
"1254","E1",10,"14.12.2019","Yes","Swansea","Middlesbrough",3,1,10,8,7,3,13,19,2,1,0,2,1.88,3.54,4.18,1.85,1.95,3,0,0.504837807224641,0.268105954119301,0.227056238656059,1.78261937579322,0.949274670087476,2,2,4,3,0.833344705705747,-6,1,-2,0
"1255","E1",10,"14.12.2019","Yes","Wigan","Huddersfield",1,1,7,4,2,4,13,20,1,2,0,0,2.48,3.21,2.95,2.19,1.67,1,1,0.382663266831809,0.295640156306195,0.321696576861995,1.44362995680162,1.26072988689218,0,3,-2,0,0.182900069909441,-7,-1,0,0
"1256","E1",10,"20.12.2019","Yes","Middlesbrough","Stoke",2,1,7,12,4,3,15,15,2,4,0,0,2.89,3.13,2.58,2.23,1.66,3,0,0.328571486697074,0.303377506886436,0.36805100641649,1.28909196697766,1.40753052613591,1,-5,1,3,-0.118438559158248,0,-2,0,0
"1257","E1",10,"21.12.2019","Yes","Cardiff","Preston",0,0,3,16,1,3,11,11,1,2,0,0,2.32,3.28,3.15,1.97,1.83,1,1,0.409194601102592,0.28943032760915,0.301375071288258,1.51701413091693,1.19355554147392,0,-13,-2,0,0.323458589443002,0,-1,0,0
"1258","E1",10,"21.12.2019","Yes","Fulham","Leeds",2,1,7,15,3,7,15,15,3,4,0,0,3.47,3.65,2.04,1.76,2.06,3,0,0.273847658907772,0.260342842852047,0.465809498240181,1.08188581957536,1.65777133757259,1,-8,-4,3,-0.575885517997227,0,-1,0,0
"1259","E1",10,"21.12.2019","Yes","Huddersfield","Nott'm Forest",2,1,13,15,5,5,5,10,3,3,0,0,2.64,3.14,2.8,2.22,1.65,3,0,0.359244246861925,0.302039748953975,0.3387160041841,1.37977248953975,1.31818776150628,1,-2,0,3,0.0615847280334727,-5,0,0,0
"1260","E1",10,"21.12.2019","Yes","Hull","Birmingham",3,0,14,12,6,2,6,8,2,2,0,0,1.95,3.48,3.94,1.86,1.94,3,0,0.486554389252028,0.27263823535674,0.240807375391232,1.73230140311282,0.995060361530436,3,2,4,3,0.737241041582388,-2,0,0,0
"1261","E1",10,"21.12.2019","Yes","Luton","Swansea",0,1,14,20,1,4,6,12,1,2,0,0,3.16,3.57,2.19,1.62,2.28,0,3,0.300473868077894,0.265965664741217,0.433560467180888,1.1673872689749,1.56664706628388,-1,-6,-3,-3,-0.399259797308983,-6,-1,0,0
"1262","E1",10,"21.12.2019","Yes","Millwall","Barnsley",1,2,16,13,1,6,10,17,2,4,0,0,1.87,3.62,4.14,1.79,2.02,0,3,0.50806156349583,0.262451691640111,0.229486744864059,1.7866363821276,0.950911926232287,-1,3,-5,-3,0.835724455895315,-7,-2,0,0
"1263","E1",10,"21.12.2019","Yes","QPR","Charlton",2,2,21,11,9,4,13,14,3,4,0,0,1.62,4.16,5.09,1.6,2.32,1,1,0.585584937803172,0.22804028827912,0.186374773917709,1.98479510168863,0.787164610032246,0,10,5,0,1.19763049165639,-1,-1,0,0
"1264","E1",10,"21.12.2019","Yes","Reading","Derby",3,0,14,16,7,6,8,17,2,7,0,1,2.11,3.36,3.52,1.99,1.81,3,0,0.448952323109626,0.281931369571819,0.269116307318555,1.6287883389007,1.08928029152748,3,-2,1,3,0.539508047373216,-9,-5,-1,0
"1265","E1",10,"21.12.2019","Yes","West Brom","Brentford",1,1,12,15,4,3,13,3,2,1,0,0,2.23,3.36,3.26,1.76,2.06,1,1,0.425941624345743,0.282693399491371,0.291364976162886,1.5605182725286,1.15678832798003,0,-3,1,0,0.403729944548572,10,1,0,0
"1266","E1",10,"22.12.2019","Yes","Sheffield Weds","Bristol City",1,0,15,3,6,1,14,14,1,3,0,0,1.72,3.9,4.61,1.83,1.98,3,0,0.551229143799707,0.243106186496281,0.205664669704012,1.8967936178954,0.860100195608317,1,12,5,3,1.03669342228708,0,-2,0,0
"1267","E1",10,"23.12.2019","Yes","Blackburn","Wigan",0,0,10,12,4,4,12,14,1,2,0,0,1.79,3.56,4.61,1.97,1.83,1,1,0.528794073959511,0.265882413592002,0.205323512448487,1.85226463547054,0.881852950937463,0,-2,0,0,0.970411684533073,-2,-1,0,0
"1268","E1",10,"26.12.2019","Yes","Barnsley","West Brom",1,1,22,7,8,2,8,15,1,3,0,0,4.25,3.89,1.78,1.56,2.39,1,1,0.223205046789828,0.243861554976033,0.532933398234139,0.913476695345516,1.84266174967845,0,15,6,0,-0.929185054332935,-7,-2,0,0
"1269","E1",10,"26.12.2019","Yes","Blackburn","Birmingham",1,1,11,13,3,3,16,23,3,3,0,0,2.12,3.31,3.54,2.01,1.8,1,1,0.446557467015252,0.286012637484089,0.267429895500659,1.62568503852984,1.08830232398607,0,-2,0,0,0.537382714543778,-7,0,0,0
"1270","E1",10,"26.12.2019","Yes","Brentford","Swansea",3,1,19,16,4,4,8,12,0,2,0,0,1.6,4.07,5.4,1.72,2.11,3,0,0.591920280096957,0.232695933207649,0.175383786695395,2.00845677349852,0.758847293293832,2,3,0,3,1.24960948020469,-4,-2,0,0
"1271","E1",10,"26.12.2019","Yes","Cardiff","Millwall",1,1,13,7,5,3,12,8,0,0,0,0,2.29,3.19,3.27,2.06,1.76,1,1,0.413535146106792,0.29686378827102,0.289601065622188,1.5374692265914,1.16566698513758,0,6,2,0,0.371802241453813,4,0,0,0
"1272","E1",10,"26.12.2019","Yes","Charlton","Bristol City",3,2,14,12,6,4,11,14,3,1,0,0,3.1,3.43,2.26,1.81,1.99,3,0,0.305299557319974,0.275926713612805,0.418773729067221,1.19182538557273,1.53224790081447,1,2,2,3,-0.340422515241741,-3,2,0,0
"1273","E1",10,"26.12.2019","Yes","Hull","Nott'm Forest",0,2,10,10,1,4,14,16,4,2,0,0,2.08,3.45,3.52,1.84,1.96,0,3,0.455828478770044,0.274818329229476,0.26935319200048,1.64230376553961,1.08287790523092,-2,0,-3,-3,0.55942586030869,-2,2,0,0
"1274","E1",10,"26.12.2019","Yes","Luton","Fulham",3,3,10,19,3,12,9,11,0,0,0,0,4.07,3.96,1.79,1.57,2.39,1,1,0.232475919044699,0.238933583462607,0.528590497492694,0.936361340596703,1.82470507594069,0,-9,-9,0,-0.888343735343988,-2,0,0,0
"1275","E1",10,"26.12.2019","Yes","Middlesbrough","Huddersfield",1,0,14,8,3,3,12,7,3,4,0,0,2.43,3.14,3.07,2.21,1.66,3,0,0.389800283864602,0.301660729232797,0.308538986902601,1.4710615808266,1.2272776899406,1,6,0,3,0.243783890886005,5,-1,0,0
"1276","E1",10,"26.12.2019","Yes","Stoke","Sheffield Weds",3,2,17,4,8,3,6,25,0,2,0,0,2.67,3.13,2.76,2.21,1.65,3,0,0.354556312102146,0.302448994668604,0.34299469322925,1.36611793097504,1.33143307435635,1,13,5,3,0.0346848566186884,-19,-2,0,0
"1277","E1",10,"26.12.2019","Yes","Wigan","Derby",1,1,11,7,4,3,12,22,1,3,0,0,2.42,3.24,3,2.07,1.75,1,1,0.391607039257397,0.292496615741636,0.315896345000967,1.46731773351383,1.24018565074454,0,4,1,0,0.22713208276929,-10,-2,0,0
"1278","E1",10,"26.12.2019","Yes","Leeds","Preston",1,1,17,12,4,2,11,22,3,4,0,0,1.4,4.65,7.8,1.66,2.2,1,1,0.675418994413408,0.203351955307263,0.12122905027933,2.22960893854749,0.567039106145251,0,5,2,0,1.66256983240223,-11,-1,0,0
"1279","E1",10,"26.12.2019","Yes","Reading","QPR",1,0,13,16,4,4,11,15,1,0,0,0,2.34,3.43,2.97,1.76,2.06,3,0,0.404842805536679,0.276190135555635,0.318967058907686,1.49071855216567,1.23309131227869,1,-3,0,3,0.257627239886978,-4,1,0,0
"1280","E1",10,"29.12.2019","Yes","Birmingham","Leeds",4,5,15,11,4,5,10,11,5,3,0,0,5.3,3.8,1.66,1.94,1.86,0,3,0.178970663337684,0.249616977813085,0.571412358849231,0.786528967826136,1.96385405436078,-1,4,-1,-3,-1.17732508653464,-1,2,0,0
"1281","E1",10,"29.12.2019","Yes","Bristol City","Luton",3,0,14,9,8,1,13,17,1,4,0,0,1.71,4.03,4.58,1.6,2.32,3,0,0.556272509455855,0.236036226096653,0.207691264447492,1.90485375446422,0.859110019439129,3,5,7,3,1.04574373502509,-4,-3,0,0
"1282","E1",10,"29.12.2019","Yes","Fulham","Stoke",1,0,10,11,5,6,11,14,2,3,0,0,1.85,3.51,4.38,1.86,1.94,3,0,0.512967838159778,0.270367663987347,0.216664497852874,1.80927117846668,0.92036115754597,1,-1,-1,3,0.888910020920711,-3,-1,0,0
"1283","E1",10,"29.12.2019","Yes","Huddersfield","Blackburn",2,1,17,10,4,3,15,13,2,1,0,0,2.36,3.22,3.13,2.16,1.69,3,0,0.402104960781341,0.2947104681503,0.303184571068359,1.50102535049432,1.20426418135538,1,7,1,3,0.296761169138945,2,1,0,0
"1284","E1",10,"29.12.2019","Yes","Millwall","Brentford",1,0,8,6,2,2,9,8,3,1,0,0,3.67,3.27,2.1,2.21,1.66,3,0,0.258401724935936,0.290010498628405,0.451587776435659,1.06521567343621,1.64477382793538,1,2,0,3,-0.57955815449917,1,2,0,0
"1285","E1",10,"29.12.2019","Yes","Nott'm Forest","Wigan",1,0,9,14,2,4,15,14,0,2,0,0,1.78,3.51,4.85,2.05,1.76,3,0,0.533580113025517,0.270590484668211,0.195829402306272,1.87133082374476,0.858078691587028,1,-5,-2,3,1.01325213215773,1,-2,0,0
"1286","E1",10,"29.12.2019","Yes","Preston","Reading",0,2,21,12,5,3,12,5,0,0,0,0,1.91,3.54,4.05,1.92,1.88,0,3,0.497227222123958,0.268277964479311,0.234494813396731,1.75995963085119,0.971762404669504,-2,9,2,-3,0.788197226181682,7,0,0,0
"1287","E1",10,"29.12.2019","Yes","QPR","Hull",1,2,13,5,4,3,10,15,0,2,0,0,2.34,3.57,2.88,1.56,2.39,0,3,0.405192594168972,0.265588423068738,0.32921898276229,1.48116620557565,1.25324537135561,-1,8,1,-3,0.227920834220047,-5,-2,0,0
"1288","E1",10,"29.12.2019","Yes","Sheffield Weds","Cardiff",1,2,18,9,3,3,10,13,1,2,0,0,1.7,3.81,4.94,1.99,1.81,0,3,0.558558184257072,0.24922543654515,0.192216379197778,1.92489998931637,0.825874574138484,-1,9,0,-3,1.09902541517788,-3,-1,0,0
"1289","E1",10,"29.12.2019","Yes","Swansea","Barnsley",0,0,11,12,5,1,17,12,1,4,0,0,1.89,3.62,3.99,1.61,2.3,1,1,0.501056312377067,0.261601223865375,0.237342463757558,1.76477016099658,0.973628615138049,0,-1,4,0,0.791141545858528,5,-3,0,0
"1290","E1",10,"29.12.2019","Yes","West Brom","Middlesbrough",0,2,11,15,5,10,16,12,4,3,0,0,1.44,4.56,7.08,1.61,2.3,0,3,0.658250146799765,0.207868467410452,0.133881385789783,2.18261890780975,0.6095126247798,-2,-4,-5,-3,1.57310628302995,4,1,0,0
"1291","E1",10,"30.12.2019","Yes","Derby","Charlton",2,1,12,11,7,5,5,21,1,5,1,0,1.77,3.69,4.6,1.87,1.93,3,0,0.536349072432719,0.257273132305126,0.206377795262155,1.86632034960328,0.876406518091591,1,1,2,3,0.989913831511693,-16,-4,1,0
"1292","E1",10,"01.01.2020","Yes","Millwall","Luton",3,1,20,6,7,4,10,13,0,0,0,0,1.65,4.07,4.93,1.78,2.03,3,0,0.57468258719007,0.232979427239217,0.192337985570713,1.95702718880943,0.809993383951356,2,14,3,3,1.14703380485807,-3,0,0,0
"1293","E1",10,"01.01.2020","Yes","Birmingham","Wigan",2,3,13,10,5,7,17,13,0,2,0,0,2.01,3.34,3.86,2.07,1.74,0,3,0.471137682536434,0.283528964640189,0.245333352823376,1.69694201224949,1.01952902311032,-1,3,-2,-3,0.677412989139174,4,-2,0,0
"1294","E1",10,"01.01.2020","Yes","Bristol City","Brentford",0,4,6,16,2,8,6,13,2,2,1,0,3.87,3.55,1.93,1.9,1.89,0,3,0.244181032178509,0.266191716769248,0.489627251052243,0.998734813304775,1.73507346992598,-4,-10,-6,-3,-0.736338656621203,-7,0,1,0
"1295","E1",10,"01.01.2020","Yes","Fulham","Reading",1,2,20,11,6,3,15,11,4,3,0,0,1.68,3.91,4.9,1.73,2.09,0,3,0.564167044564456,0.242404254442017,0.193428700993528,1.93490538813538,0.8226903574226,-1,9,3,-3,1.11221503071278,4,1,0,0
"1296","E1",10,"01.01.2020","Yes","Huddersfield","Stoke",2,5,6,15,3,6,10,19,5,2,0,0,2.77,3.07,2.71,2.35,1.59,0,3,0.341948105859772,0.308532981508654,0.349518912631575,1.33437729908797,1.35708971940338,-3,-9,-3,-3,-0.022712420315409,-9,3,0,0
"1297","E1",10,"01.01.2020","Yes","Nott'm Forest","Blackburn",3,2,10,11,5,3,17,9,1,1,0,0,2.06,3.35,3.66,2.08,1.74,3,0,0.459185966384037,0.282365101716751,0.258448931899212,1.65992300086886,1.05771189741439,1,-1,2,3,0.602211103454475,8,0,0,0
"1298","E1",10,"01.01.2020","Yes","Preston","Middlesbrough",0,2,11,18,2,5,4,18,0,2,0,0,1.82,3.58,4.44,1.87,1.93,0,3,0.52129766886618,0.265017250652639,0.213685080481182,1.82891025725118,0.906072492096184,-2,-7,-3,-3,0.922837765154994,-14,-2,0,0
"1299","E1",10,"01.01.2020","Yes","QPR","Cardiff",6,1,14,12,7,2,9,10,2,1,0,0,2.11,3.58,3.3,1.71,2.12,3,0,0.448676075166725,0.264443161620612,0.286880763212663,1.61047138712079,1.1250854512586,5,2,5,3,0.485385935862184,-1,1,0,0
"1300","E1",10,"01.01.2020","Yes","Sheffield Weds","Hull",0,1,12,9,5,3,14,15,2,1,0,0,1.9,3.6,3.95,1.82,1.99,0,3,0.497812007701733,0.262734115175915,0.239453877122352,1.75617013828111,0.981095746542972,-1,3,2,-3,0.775074391738141,-1,1,0,0
"1301","E1",10,"01.01.2020","Yes","West Brom","Leeds",1,1,13,10,6,2,18,13,2,3,0,0,2.87,3.45,2.39,1.75,2.07,1,1,0.329736906299612,0.27430287567533,0.395960218025058,1.26351359457417,1.4621835297505,0,3,4,0,-0.198669935176336,5,-1,0,0
"1302","E1",10,"02.01.2020","Yes","Derby","Barnsley",2,1,15,14,4,4,8,11,1,0,0,0,2.27,3.35,3.15,1.81,1.99,3,0,0.416971253580954,0.282544700187691,0.300484046231354,1.53345846093055,1.18399683888175,1,1,0,3,0.3494616220488,-3,1,0,0
"1303","E1",10,"02.01.2020","Yes","Swansea","Charlton",1,0,14,7,3,5,8,9,1,3,0,0,1.58,4.19,5.42,1.71,2.12,3,0,0.599304368019929,0.225990668608947,0.174704963371123,2.02390377266874,0.750105558722317,1,7,-2,3,1.27379821394642,-1,-2,0,0
"1304","E1",10,"11.01.2020","Yes","Brentford","QPR",3,1,14,4,6,2,8,17,0,5,0,0,1.64,3.93,5.29,1.66,2.2,3,0,0.578930953342337,0.241589507247184,0.179479539410479,1.9783823672742,0.78002812547862,2,10,4,3,1.19835424179558,-9,-5,0,0
"1305","E1",10,"11.01.2020","Yes","Barnsley","Huddersfield",2,1,7,10,2,2,13,22,2,5,0,0,2.18,3.5,3.21,1.89,1.91,3,0,0.43440772074176,0.270573951776296,0.295018327481943,1.57379711400158,1.15562893422213,1,-3,0,3,0.418168179779452,-9,-3,0,0
"1306","E1",10,"11.01.2020","Yes","Blackburn","Preston",1,1,14,9,4,2,10,12,2,0,0,0,2.66,3.2,2.73,2.05,1.77,1,1,0.356428857028617,0.296281487405038,0.347289655566345,1.36556805849089,1.33815045410407,0,5,2,0,0.0274176043868168,-2,2,0,0
"1307","E1",10,"11.01.2020","Yes","Charlton","West Brom",2,2,7,19,2,5,10,14,2,6,0,0,5.5,4.08,1.59,1.72,2.13,1,1,0.172201251851498,0.232134040486088,0.595664707662414,0.748737796040582,2.01912816347333,0,-12,-3,0,-1.27039036743275,-4,-4,0,0
"1308","E1",10,"11.01.2020","Yes","Hull","Fulham",0,1,9,4,2,1,12,10,1,4,0,0,2.53,3.51,2.66,1.65,2.22,0,3,0.374261926427143,0.269767143550049,0.355970930022809,1.39255292283148,1.33767993361847,-1,5,1,-3,0.0548729892130022,2,-3,0,0
"1309","E1",10,"11.01.2020","Yes","Leeds","Sheffield Weds",0,2,14,10,5,2,8,16,1,2,0,0,1.59,3.98,5.81,1.88,1.92,0,3,0.597670192996105,0.238767740418042,0.163562066585853,2.03177831940636,0.729453940175602,-2,4,3,-3,1.30232437923076,-8,-1,0,0
"1310","E1",10,"11.01.2020","Yes","Luton","Birmingham",1,2,9,10,2,7,7,20,1,3,0,1,2.94,3.48,2.34,1.72,2.12,0,3,0.322451888809693,0.272416250890948,0.405131860299359,1.23977191732003,1.48781183178902,-1,-1,-5,-3,-0.248039914468995,-13,-2,-1,0
"1311","E1",10,"11.01.2020","Yes","Middlesbrough","Derby",2,2,15,7,5,3,11,13,1,2,0,0,2.11,3.32,3.57,2.01,1.79,1,1,0.449119562869691,0.285434420980436,0.265446016149873,1.63279310958951,1.08177246943006,0,8,2,0,0.551020640159453,-2,-1,0,0
"1312","E1",10,"11.01.2020","Yes","Reading","Nott'm Forest",1,1,17,13,3,3,10,19,4,2,0,0,2.36,3.23,3.09,2.03,1.78,1,1,0.400897336509224,0.292915700978876,0.3061869625119,1.49560771050655,1.21147658851457,0,4,0,0,0.284131121991975,-9,2,0,0
"1313","E1",10,"11.01.2020","Yes","Stoke","Millwall",0,0,9,5,2,3,9,10,1,1,0,1,2.02,3.21,3.99,2.47,1.54,1,1,0.468263630680136,0.294670571331425,0.23706579798844,1.69946146337183,1.00586796529674,0,4,-1,0,0.693593498075088,-1,0,-1,0
"1314","E1",10,"11.01.2020","Yes","Wigan","Bristol City",0,2,17,6,7,3,9,10,1,1,0,0,2.34,3.29,3.08,1.98,1.82,0,3,0.404696673189824,0.28783897120492,0.307464355605256,1.50192899077439,1.21023203802069,-2,11,4,-3,0.291696952753705,-1,0,0,0
"1315","E1",10,"12.01.2020","Yes","Cardiff","Swansea",0,0,14,12,3,1,16,11,4,2,0,0,2.39,3.32,2.97,1.89,1.91,1,1,0.396103400486071,0.285146725048708,0.318749874465222,1.47345692650692,1.24139634844437,0,2,2,0,0.232060578062547,5,2,0,0
"1316","E1",10,"17.01.2020","Yes","Fulham","Middlesbrough",1,0,17,8,6,0,10,6,1,1,0,0,1.91,3.47,4.16,1.89,1.92,3,0,0.497619663202165,0.273905924125687,0.228474412672148,1.76676491373218,0.959329162142131,1,9,6,3,0.807435751590051,4,0,0,0
"1317","E1",10,"18.01.2020","Yes","QPR","Leeds",1,0,9,17,2,3,17,11,4,3,0,1,4.29,3.97,1.76,1.6,2.31,3,0,0.221331753719642,0.239172096588731,0.539496149691627,0.903167357747657,1.85766054566361,1,-8,-1,3,-0.954493187915955,6,1,-1,0
"1318","E1",10,"18.01.2020","Yes","Birmingham","Cardiff",1,1,14,6,3,2,11,10,1,3,0,0,2.37,3.33,3.01,1.97,1.83,1,1,0.400146113034001,0.284788675042217,0.315065211923782,1.48522701414422,1.22998431081356,0,8,1,0,0.255242703330658,1,-2,0,0
"1319","E1",10,"18.01.2020","Yes","Bristol City","Barnsley",1,0,10,16,2,3,8,14,1,2,0,0,2.23,3.47,3.14,1.68,2.17,3,0,0.425017845928203,0.27313826986164,0.301843884210157,1.54819180764625,1.17866992249211,1,-6,-1,3,0.369521885154138,-6,-1,0,0
"1320","E1",10,"18.01.2020","Yes","Derby","Hull",1,0,12,9,2,1,12,12,3,0,0,0,2.55,3.33,2.76,1.87,1.93,3,0,0.37179160447082,0.28470528270288,0.343503112826301,1.40008009611534,1.31521462118178,1,3,1,3,0.0848654749335565,0,3,0,0
"1321","E1",10,"18.01.2020","Yes","Huddersfield","Brentford",0,0,6,11,1,3,12,8,1,0,0,0,4.83,3.61,1.76,2.03,1.78,1,1,0.196762535342993,0.263258461414587,0.53997900324242,0.853546067443567,1.88319547114185,0,-5,-2,0,-1.02964940369828,4,1,0,0
"1322","E1",10,"18.01.2020","Yes","Millwall","Reading",2,0,22,8,8,0,12,9,1,3,0,0,2.17,3.21,3.55,2.3,1.61,3,0,0.437200504897428,0.295552989292031,0.267246505810541,1.60715450398432,1.09729250672365,2,14,8,3,0.509861997260663,3,-2,0,0
"1323","E1",10,"18.01.2020","Yes","Preston","Charlton",2,1,14,6,8,2,7,6,1,0,0,0,1.55,4.21,5.9,1.77,2.05,3,0,0.613164813191967,0.225749515545736,0.161085671262297,2.06524395512164,0.709006529332626,1,8,6,3,1.35623742578901,1,1,0,0
"1324","E1",10,"18.01.2020","Yes","Sheffield Weds","Blackburn",0,5,4,15,1,9,14,11,1,1,1,0,1.8,3.54,4.65,2.04,1.77,0,3,0.5275454283242,0.268243438130949,0.204211133544851,1.85087972310355,0.880876838765503,-5,-11,-8,-3,0.970002884338045,3,0,1,0
"1325","E1",10,"18.01.2020","Yes","Swansea","Wigan",2,1,13,12,3,2,8,14,0,1,0,0,1.96,3.39,4.05,1.89,1.91,3,0,0.484937429137571,0.280376802687209,0.23468576817522,1.73518909009992,0.984434107212868,1,1,1,3,0.750754982887054,-6,-1,0,0
"1326","E1",10,"19.01.2020","Yes","Nott'm Forest","Luton",3,1,22,8,5,2,11,19,0,3,0,0,1.6,4.15,5.3,1.69,2.16,3,0,0.592617540078135,0.22847905159639,0.178903408325475,2.0063316718308,0.765189276572814,2,14,3,3,1.24114239525798,-8,-3,0,0
"1327","E1",10,"20.01.2020","Yes","West Brom","Stoke",0,1,16,4,2,2,10,18,1,3,0,0,1.85,3.57,4.3,1.88,1.91,0,3,0.513231139566373,0.265960114341118,0.220808746092509,1.80565353304024,0.928386352618646,-1,12,0,-3,0.877267180421591,-8,-2,0,0
"1328","E1",10,"21.01.2020","Yes","Barnsley","Preston",0,3,10,14,3,3,17,10,1,1,0,0,2.59,3.43,2.66,1.8,2.01,0,3,0.366463294627042,0.276717181657154,0.356819523715804,1.37610706553828,1.34717575280457,-3,-4,0,-3,0.0289313127337141,7,0,0,0
"1329","E1",10,"21.01.2020","Yes","Middlesbrough","Birmingham",1,1,16,11,2,4,10,11,0,1,0,0,2.22,3.27,3.36,2.06,1.76,1,1,0.427421048946152,0.29017575800014,0.282403193053708,1.5724389048386,1.13738533716126,0,5,-2,0,0.435053567677333,-1,-1,0,0
"1330","E1",10,"22.01.2020","Yes","Charlton","Fulham",0,0,4,11,1,4,7,13,1,1,0,0,4.33,3.72,1.8,1.81,1.99,1,1,0.218840693387717,0.254725860851832,0.526433445760452,0.911247941014982,1.83402619813319,0,-7,-3,0,-0.922778257118205,-6,0,0,0
"1331","E1",10,"22.01.2020","Yes","Nott'm Forest","Reading",1,1,15,12,4,4,11,12,1,2,0,0,2.07,3.37,3.63,2.04,1.77,1,1,0.457772488970217,0.281183695005445,0.261043816024338,1.65450116191609,1.06431514307846,0,3,0,0,0.590186018837635,-1,-1,0,0
"1332","E1",10,"25.01.2020","Yes","Stoke","Swansea",2,0,16,11,5,3,11,7,0,2,0,0,2.05,3.37,3.69,2.06,1.76,3,0,0.4621362181929,0.281121438366601,0.2567423434405,1.6675300929453,1.0513484686881,2,5,2,3,0.616181624257199,4,-2,0,0
"1333","E1",10,"28.01.2020","Yes","Blackburn","QPR",2,1,12,9,6,4,7,10,1,3,0,0,2.04,3.5,3.59,1.81,1.99,3,0,0.464877944103653,0.270957430277558,0.264164625618789,1.66559126258852,1.06345130713392,1,3,2,3,0.602139955454593,-3,-2,0,0
"1334","E1",10,"28.01.2020","Yes","Brentford","Nott'm Forest",0,1,13,8,3,2,12,11,1,1,0,0,1.65,3.75,5.58,2.02,1.79,0,3,0.576136786024037,0.253500185850576,0.170363028125387,1.98191054392269,0.764589270226738,-1,5,1,-3,1.21732127369595,1,0,0,0
"1335","E1",10,"28.01.2020","Yes","Cardiff","West Brom",2,1,10,16,5,3,16,11,1,0,0,0,2.98,3.24,2.44,2.07,1.75,3,0,0.318363402061856,0.292815721649484,0.38882087628866,1.24790592783505,1.45927835051546,1,-6,2,3,-0.211372422680412,5,1,0,0
"1336","E1",10,"28.01.2020","Yes","Hull","Huddersfield",1,2,20,14,5,4,8,10,0,1,0,0,2.03,3.38,3.77,1.99,1.82,0,3,0.467496542185339,0.280774550484094,0.251728907330567,1.68326417704011,1.0359612724758,-1,6,1,-3,0.647302904564315,-2,-1,0,0
"1337","E1",10,"28.01.2020","Yes","Leeds","Millwall",3,2,28,11,11,5,12,10,2,1,0,0,1.53,3.92,6.91,2.09,1.74,3,0,0.620453488665074,0.242166795320807,0.137379716014119,2.10352726131603,0.654305943363164,1,17,6,3,1.44922131795286,2,1,0,0
"1338","E1",10,"28.01.2020","Yes","Luton","Derby",3,2,8,15,5,4,7,18,1,4,0,1,3.11,3.46,2.25,1.72,2.12,3,0,0.304778981407895,0.273948737623859,0.421272280968246,1.18828568184754,1.5377655805286,1,-7,1,3,-0.349479898681053,-11,-3,-1,0
"1339","E1",10,"28.01.2020","Yes","Wigan","Sheffield Weds",2,1,17,9,5,4,8,15,0,0,0,0,2.85,3.1,2.61,2.32,1.61,3,0,0.332081512035954,0.30530074493628,0.362617743027766,1.30154528104414,1.39315397401958,1,8,1,3,-0.0916086929754356,-7,0,0,0
"1340","E1",10,"28.01.2020","Yes","Reading","Bristol City",0,1,16,11,5,3,9,10,1,3,0,0,2.19,3.37,3.33,1.91,1.89,0,3,0.433367702770022,0.281624708921765,0.285007588308213,1.58172781723183,1.1366474738464,-1,5,2,-3,0.445080343385428,-1,-2,0,0
"1341","E1",10,"31.01.2020","Yes","Cardiff","Reading",1,1,18,8,4,2,17,13,3,2,0,0,2.14,3.33,3.49,2.01,1.8,1,1,0.443297160185379,0.284881658497511,0.271821181317109,1.61477313905365,1.10034520244884,0,10,2,0,0.51442793660481,4,1,0,0
"1342","E1",10,"31.01.2020","Yes","Derby","Stoke",4,0,10,7,5,1,15,16,2,2,0,0,2.81,3.08,2.68,2.33,1.6,3,0,0.337741407528642,0.308134206219313,0.354124386252046,1.32135842880524,1.37050736497545,4,3,4,3,-0.0491489361702127,-1,0,0,0
"1343","E1",10,"01.02.2020","Yes","Hull","Brentford",1,5,9,15,1,11,7,9,0,1,0,0,3.71,3.52,1.99,1.91,1.89,0,3,0.255212792701544,0.268988483216684,0.475798724081772,1.03462686132131,1.696384655462,-4,-6,-10,-3,-0.661757794140686,-2,-1,0,0
"1344","E1",10,"01.02.2020","Yes","Birmingham","Nott'm Forest",2,1,13,12,4,3,14,9,1,1,0,0,2.57,3.2,2.81,2.11,1.72,3,0,0.367956067878728,0.295514717015104,0.336529215106168,1.39938292065129,1.30510236233361,1,1,1,3,0.0942805583176813,5,0,0,0
"1345","E1",10,"01.02.2020","Yes","Charlton","Barnsley",2,1,8,16,4,6,9,15,1,4,0,0,2.89,3.45,2.38,1.77,2.05,3,0,0.327657553761617,0.274472559527847,0.397869886710535,1.2574452208127,1.46808221965945,1,-8,-2,3,-0.210636998846754,-6,-3,0,0
"1346","E1",10,"01.02.2020","Yes","Fulham","Huddersfield",3,2,10,12,3,8,12,10,4,1,0,0,1.69,3.75,5.03,1.98,1.82,3,0,0.55970647493969,0.25224105137282,0.18805247368749,1.93136047619189,0.81639847243529,1,-2,-5,3,1.1149620037566,2,3,0,0
"1347","E1",10,"01.02.2020","Yes","Leeds","Wigan",0,1,18,5,5,2,10,15,0,2,0,0,1.36,4.83,8.58,1.72,2.12,0,3,0.694405067109033,0.19552606444478,0.110068868446187,2.27874126577188,0.525732669783341,-1,13,3,-3,1.75300859598854,-5,-2,0,0
"1348","E1",10,"01.02.2020","Yes","Middlesbrough","Blackburn",1,1,18,7,6,2,12,12,0,2,0,0,2.26,3.24,3.29,2.19,1.67,1,1,0.419381998158742,0.292531887604554,0.288086114236704,1.55067788208078,1.15679023031467,0,11,4,0,0.393887651766113,0,-2,0,0
"1349","E1",10,"01.02.2020","Yes","Preston","Swansea",1,1,10,11,2,3,15,15,1,3,0,0,2.12,3.36,3.47,1.93,1.87,1,1,0.446049550859259,0.28143602613739,0.272514423003351,1.61958467871517,1.09897929514744,0,-1,-1,0,0.520605383567723,0,-2,0,0
"1350","E1",10,"01.02.2020","Yes","QPR","Bristol City",0,1,18,11,1,5,11,12,0,0,0,0,2.16,3.51,3.24,1.64,2.24,0,3,0.438202247191011,0.269662921348315,0.292134831460674,1.58426966292135,1.14606741573034,-1,7,-4,-3,0.438202247191011,-1,0,0,0
"1351","E1",10,"01.02.2020","Yes","Sheffield Weds","Millwall",0,0,15,7,2,2,20,13,4,3,0,0,2.21,3.05,3.61,2.44,1.55,1,1,0.427939570369737,0.310080803448236,0.261979626182027,1.59389951455745,1.09601968199432,0,8,0,0,0.497879832563129,7,1,0,0
"1352","E1",10,"01.02.2020","Yes","West Brom","Luton",2,0,16,6,6,0,13,9,0,1,0,0,1.35,5.12,8.3,1.51,2.53,3,0,0.701103723623645,0.184861333377328,0.114034942999027,2.28817250424826,0.526966162374408,2,10,6,3,1.76120634187386,4,-1,0,0
"1353","E1",10,"07.02.2020","Yes","Bristol City","Birmingham",1,3,13,9,2,3,8,13,0,0,0,0,2.26,3.33,3.21,1.92,1.88,0,3,0.419686922107445,0.284832565754603,0.295480512137952,1.54389333207694,1.17127410216846,-2,4,-1,-3,0.37261922990848,-5,0,0,0
"1354","E1",10,"08.02.2020","Yes","Wigan","Preston",1,2,12,15,4,4,13,10,1,3,0,0,2.84,3.13,2.6,2.25,1.64,0,3,0.333371567149505,0.30248410565642,0.364144327194075,1.30259880710494,1.39491708723864,-1,-3,0,-3,-0.092318280133709,3,-2,0,0
"1355","E1",10,"08.02.2020","Yes","Barnsley","Sheffield Weds",1,1,12,6,4,2,7,19,1,2,0,0,2.75,3.39,2.52,1.85,1.94,1,1,0.344533036502886,0.279488451440394,0.37597851205672,1.31308756094905,1.40742398761055,0,6,2,0,-0.0943364266615041,-12,-1,0,0
"1356","E1",10,"08.02.2020","Yes","Blackburn","Fulham",0,1,4,11,1,4,8,14,0,1,0,0,2.83,3.26,2.52,2.03,1.79,0,3,0.334323596200646,0.290225698542279,0.375450705257075,1.29319648714422,1.4165778143135,-1,-7,-3,-3,-0.123381327169286,-6,-1,0,0
"1357","E1",10,"08.02.2020","Yes","Brentford","Middlesbrough",3,2,14,10,5,5,11,12,0,1,0,0,1.53,4.08,6.33,1.92,1.87,3,0,0.618541590326127,0.231953096372298,0.149505313301576,2.08757786735068,0.680469036277025,1,4,0,3,1.40710883107365,-1,-1,0,0
"1358","E1",10,"08.02.2020","Yes","Huddersfield","QPR",2,0,16,8,7,2,15,15,0,3,0,0,2.33,3.29,3.1,1.97,1.83,3,0,0.406533879151935,0.28791001167903,0.305556109169035,1.50751164913484,1.20457833918613,2,8,5,3,0.3029333099487,0,-3,0,0
"1359","E1",10,"08.02.2020","Yes","Luton","Cardiff",0,1,10,15,2,2,9,14,0,1,0,0,3.12,3.49,2.23,1.73,2.09,0,3,0.303666535305571,0.271472661935066,0.424860802759363,1.18247226785178,1.54605507021316,-1,-5,0,-3,-0.363582802361378,-5,-1,0,0
"1360","E1",10,"08.02.2020","Yes","Reading","Hull",1,1,19,14,5,7,8,12,1,3,0,0,1.99,3.52,3.71,1.86,1.94,1,1,0.475798724081772,0.268988483216684,0.255212792701544,1.696384655462,1.03462686132131,0,5,-2,0,0.661757794140686,-4,-2,0,0
"1361","E1",10,"08.02.2020","Yes","Stoke","Charlton",3,1,13,5,6,2,22,15,0,5,0,0,1.54,3.96,6.5,2.11,1.72,3,0,0.615077278940174,0.239196719587846,0.14572600147198,2.08442855640837,0.676374724003785,2,8,4,3,1.40805383240458,7,-5,0,0
"1362","E1",10,"08.02.2020","Yes","Swansea","Derby",2,3,16,8,7,4,7,16,1,4,0,0,1.99,3.47,3.75,1.93,1.87,0,3,0.475250453793421,0.272549972060204,0.252199574146375,1.69830133344047,1.02914869449933,-1,8,3,-3,0.669152638941137,-9,-3,0,0
"1363","E1",10,"08.02.2020","Yes","Nott'm Forest","Leeds",2,0,14,13,6,1,11,14,3,3,0,0,3.92,3.48,1.95,1.95,1.85,3,0,0.241738981746676,0.27230368058821,0.485957337665114,0.997520625828239,1.73017569358355,2,1,5,3,-0.732655067755312,-3,0,0,0
"1364","E1",10,"09.02.2020","Yes","Millwall","West Brom",0,2,7,29,3,6,11,14,2,2,0,0,2.81,3.13,2.62,2.25,1.64,0,3,0.336668295146173,0.302248533342092,0.361083171511735,1.31225341878061,1.3854980478773,-2,-22,-3,-3,-0.0732446290966866,-3,0,0,0
"1365","E1",10,"11.02.2020","Yes","Barnsley","Birmingham",0,1,9,11,4,2,8,8,1,1,0,0,2.57,3.41,2.69,1.74,2.09,0,3,0.369132270149981,0.278202326769927,0.352665403080093,1.38559913721987,1.33619853601021,-1,-2,2,-3,0.0494006012096624,0,0,0,0
"1366","E1",10,"11.02.2020","Yes","Blackburn","Hull",3,0,26,10,11,0,9,11,1,2,0,0,1.77,3.63,4.68,1.92,1.88,3,0,0.535960703029615,0.261336210568159,0.202703086402226,1.869218319657,0.869445469774837,3,16,11,3,0.999772849882166,-2,-1,0,0
"1367","E1",10,"11.02.2020","Yes","Brentford","Leeds",1,1,7,13,2,6,8,8,0,0,0,0,2.42,3.3,2.98,2,1.8,1,1,0.392863420636316,0.288099841799965,0.319036737563719,1.46669010370891,1.24521005449112,0,-6,-4,0,0.221480049217789,0,0,0,0
"1368","E1",10,"11.02.2020","Yes","Nott'm Forest","Charlton",0,1,17,11,2,3,8,13,2,4,0,0,1.59,3.93,5.94,1.89,1.9,0,3,0.597994236311239,0.241936599423631,0.16006916426513,2.03591930835735,0.72214409221902,-1,6,-1,-3,1.31377521613833,-5,-2,0,0
"1369","E1",10,"11.02.2020","Yes","Swansea","QPR",0,0,8,16,0,4,17,12,1,2,0,0,2,3.55,3.69,1.7,2.15,1,1,0.474972352653239,0.267590057832811,0.257437589513951,1.69250711579253,1.03990282637466,0,-8,-4,0,0.652604289417865,5,-1,0,0
"1370","E1",10,"11.02.2020","Yes","Wigan","Middlesbrough",2,2,6,9,4,2,16,13,5,3,1,0,2.58,3.13,2.87,2.17,1.68,1,1,0.367210206392485,0.302684451275595,0.33010534233192,1.40431507045305,1.29300047827136,0,-3,2,0,0.111314592181694,3,2,1,0
"1371","E1",10,"12.02.2020","Yes","Bristol City","Derby",3,2,16,11,5,4,11,11,0,1,0,0,2.23,3.28,3.32,1.88,1.92,3,0,0.425248754276074,0.289117293303551,0.285633952420375,1.56486355613177,1.14601915056468,1,5,1,3,0.418844405567097,0,-1,0,0
"1372","E1",10,"12.02.2020","Yes","Huddersfield","Cardiff",0,3,19,11,4,6,9,10,1,2,0,0,2.43,3.19,3,2.15,1.7,0,3,0.388839454405831,0.296200587525445,0.314959958068723,1.46271895074294,1.24108046173162,-3,8,-2,-3,0.221638489011324,-1,-1,0,0
"1373","E1",10,"12.02.2020","Yes","Luton","Sheffield Weds",1,0,10,14,4,2,14,16,3,1,0,0,3.48,3.45,2.1,1.83,1.97,3,0,0.272788885123687,0.275160962385632,0.452050152490681,1.09352761775669,1.63131141985768,1,-4,2,3,-0.537783802100983,-2,2,0,0
"1374","E1",10,"12.02.2020","Yes","Millwall","Fulham",1,1,9,9,2,2,9,12,1,2,0,0,2.95,3.11,2.53,2.29,1.62,1,1,0.321072540530394,0.304554339088316,0.37437312038129,1.2677719606795,1.42767370023219,0,0,0,0,-0.159901739552687,-3,-1,0,0
"1375","E1",10,"12.02.2020","Yes","Reading","West Brom",1,2,11,26,1,7,13,15,2,2,0,0,3.63,3.32,2.09,2.05,1.76,0,3,0.261081908861388,0.285460038905674,0.453458052232937,1.06870576548984,1.64583419560449,-1,-15,-6,-3,-0.577128430114648,-2,0,0,0
"1376","E1",10,"12.02.2020","Yes","Stoke","Preston",0,2,14,4,5,3,11,14,3,2,0,0,2.11,3.22,3.7,2.28,1.63,0,3,0.44932717837316,0.294434890176201,0.25623793145064,1.64241642529568,1.06314868452812,-2,10,2,-3,0.57926774076756,-3,1,0,0
"1377","E1",10,"14.02.2020","Yes","Hull","Swansea",4,4,11,20,4,6,10,10,0,3,0,0,3.04,3.44,2.3,1.82,1.99,1,1,0.311967699198789,0.275692385338464,0.412339915462747,1.21159548293483,1.5127121317267,0,-9,-2,0,-0.301116648791874,0,-3,0,0
"1378","E1",10,"15.02.2020","Yes","West Brom","Nott'm Forest",2,2,18,8,9,1,8,11,1,3,0,0,1.71,3.81,4.82,1.86,1.94,1,1,0.554449526742448,0.248847425388343,0.196703047869209,1.91219600561569,0.838956568995969,0,10,8,0,1.07323943661972,-3,-2,0,0
"1379","E1",10,"15.02.2020","Yes","Birmingham","Brentford",1,1,11,12,4,4,8,9,2,3,0,0,3.79,3.46,1.99,1.97,1.84,1,1,0.250006354185956,0.273850890856871,0.476142754957173,1.02386995341474,1.70227915572839,0,-1,0,0,-0.67840920231365,-1,-1,0,0
"1380","E1",10,"15.02.2020","Yes","Cardiff","Wigan",2,2,15,11,5,4,18,12,3,3,0,0,2.05,3.27,3.81,2.04,1.78,1,1,0.461900365925547,0.289570565794303,0.24852906828015,1.67527166357094,1.03515777063475,0,4,1,0,0.640113892936191,6,0,0,0
"1381","E1",10,"15.02.2020","Yes","Charlton","Blackburn",0,2,9,14,7,5,15,12,0,3,0,0,3.13,3.25,2.34,2.06,1.76,0,3,0.302967528095707,0.291781034750634,0.405251437153659,1.20068361903775,1.50753534621161,-2,-5,2,-3,-0.306851727173857,3,-3,0,0
"1382","E1",10,"15.02.2020","Yes","Derby","Huddersfield",1,1,10,10,7,3,10,8,3,0,0,0,2.08,3.31,3.64,2.07,1.76,1,1,0.454581126152639,0.285658230331568,0.259760643515794,1.64940160878948,1.06494016087895,0,0,4,0,0.584461447910536,2,3,0,0
"1383","E1",10,"15.02.2020","Yes","Fulham","Barnsley",0,3,21,14,8,6,9,17,1,1,0,0,1.55,4.23,5.74,1.67,2.19,0,3,0.611073219961896,0.223915718898567,0.165011061139536,2.05713537878426,0.718948902317177,-3,7,2,-3,1.33818647646708,-8,0,0,0
"1384","E1",10,"15.02.2020","Yes","Leeds","Bristol City",1,0,21,3,6,1,13,14,2,2,0,0,1.35,5.14,8.36,1.62,2.29,3,0,0.702183497452423,0.184425626762796,0.113390875784781,2.29097611912006,0.52459825411714,1,18,5,3,1.76637786500292,-1,0,0,0
"1385","E1",10,"15.02.2020","Yes","Middlesbrough","Luton",0,1,7,10,0,1,9,14,1,4,0,0,1.61,4,5.37,1.76,2.05,0,3,0.587435766305581,0.236442895937997,0.176121337756422,1.99875019485474,0.764806909207263,-1,-3,-1,-3,1.23394328564748,-5,-3,0,0
"1386","E1",10,"15.02.2020","Yes","Preston","Millwall",0,1,10,16,3,6,5,11,3,0,0,0,2.14,3.16,3.68,2.36,1.59,0,3,0.442725306855907,0.29982030274419,0.257454390399903,1.62799622331191,1.0721834739439,-1,-6,-3,-3,0.555812749368014,-6,3,0,0
"1387","E1",10,"15.02.2020","Yes","QPR","Stoke",4,2,13,15,9,4,11,11,4,2,0,0,2.7,3.24,2.65,1.93,1.87,3,0,0.350606394707828,0.292171995589857,0.357221609702315,1.34399117971334,1.3638368246968,2,-2,5,3,-0.0198456449834623,0,2,0,0
"1388","E1",10,"15.02.2020","Yes","Sheffield Weds","Reading",0,3,10,9,3,5,21,12,0,2,1,0,2.03,3.29,3.89,2.15,1.7,0,3,0.467536120700678,0.288479734049354,0.243984145249968,1.69108809615139,1.02043216979926,-3,1,-2,-3,0.670655926352129,9,-2,1,0
"1389","E1",10,"21.02.2020","Yes","Derby","Fulham",1,1,14,17,7,5,12,11,0,1,0,0,2.9,3.3,2.47,1.9,1.9,1,1,0.327559877833146,0.287855650217007,0.384584471949847,1.27053528371644,1.44160906606655,0,-3,2,0,-0.171073782350105,1,-1,0,0
"1390","E1",10,"22.02.2020","Yes","Brentford","Blackburn",2,2,20,11,9,6,12,10,1,0,0,0,1.6,3.93,5.74,1.94,1.86,1,1,0.593165431683241,0.24149228770819,0.165342280608569,2.02098858275791,0.737519129533897,0,9,3,0,1.28346945322402,2,1,0,0
"1391","E1",10,"22.02.2020","Yes","Barnsley","Middlesbrough",1,0,18,5,4,0,8,7,2,0,0,0,2.46,3.36,2.84,1.82,1.99,3,0,0.384861097667215,0.281773303649211,0.333365598683574,1.43635659665086,1.28187009969993,1,13,4,3,0.154486496950924,1,2,0,0
"1392","E1",10,"22.02.2020","Yes","Birmingham","Sheffield Weds",3,3,11,10,4,5,13,15,1,5,0,0,2.22,3.19,3.44,2.13,1.71,1,1,0.427117957979465,0.297241964487276,0.275640077533259,1.57859583842567,1.12416219708705,0,1,-1,0,0.454433641338616,-2,-4,0,0
"1393","E1",10,"22.02.2020","Yes","Bristol City","West Brom",0,3,7,17,1,8,14,13,2,1,0,1,4.11,3.81,1.82,1.77,2.05,0,3,0.230575091026984,0.248730610005487,0.52069429896753,0.940455883086438,1.81081350690808,-3,-10,-7,-3,-0.870357623821637,1,1,-1,0
"1394","E1",10,"22.02.2020","Yes","Charlton","Luton",3,1,12,9,3,2,10,8,2,1,0,0,2.23,3.3,3.28,1.87,1.93,3,0,0.424513872002636,0.286868465019963,0.288617662977402,1.56041008102787,1.15272145395217,2,3,1,3,0.407688627075702,2,1,0,0
"1395","E1",10,"22.02.2020","Yes","Leeds","Reading",1,0,18,8,5,2,12,10,1,2,0,0,1.28,5.44,11.05,1.67,2.19,3,0,0.740120562625586,0.174146014735432,0.0857334226389819,2.39450770261219,0.431346282652378,1,10,3,3,1.96316141995981,2,-1,0,0
"1396","E1",10,"22.02.2020","Yes","Nott'm Forest","QPR",0,0,12,6,2,3,11,17,1,3,0,0,2.13,3.46,3.36,1.79,2.02,1,1,0.444536214926469,0.27365957739693,0.281804207676601,1.60726822217634,1.11907220042673,0,6,-1,0,0.488196021749604,-6,-2,0,0
"1397","E1",10,"22.02.2020","Yes","Preston","Hull",2,1,12,7,4,3,8,14,1,3,0,0,1.6,4.07,5.45,1.76,2.05,3,0,0.59287422989028,0.233070950325417,0.174054819784302,2.01169363999626,0.755235409678325,1,5,1,3,1.25645823031793,-6,-2,0,0
"1398","E1",10,"22.02.2020","Yes","Stoke","Cardiff",2,0,10,10,5,2,10,7,1,1,0,0,2,3.37,3.89,2.17,1.68,3,0,0.474470942079604,0.281585128830625,0.243943929089771,1.70499795506944,1.01341691609994,2,0,3,3,0.6915810389695,3,0,0,0
"1399","E1",10,"22.02.2020","Yes","Swansea","Huddersfield",3,1,15,7,6,4,11,12,1,1,0,0,2,3.45,3.77,1.92,1.88,3,0,0.473885559178766,0.274716266190589,0.251398174630645,1.69637294372689,1.02891079008252,2,8,2,3,0.667462153644363,-1,0,0,0
"1400","E1",10,"22.02.2020","Yes","Wigan","Millwall",1,0,16,11,2,1,10,14,1,3,0,0,2.76,3.03,2.75,2.35,1.59,3,0,0.343108794208842,0.312534743239738,0.34435646255142,1.34186112586626,1.345604130894,1,5,1,3,-0.00374300502773273,-4,-2,0,0
"1401","E1",10,"25.02.2020","Yes","Cardiff","Nott'm Forest",0,1,18,17,4,4,14,14,1,2,0,0,2.4,3.17,3.11,2.13,1.71,0,3,0.395444171242685,0.299389908827269,0.305165919930046,1.48572242255532,1.21488766861741,-1,1,0,-3,0.270834753937916,0,-1,0,0
"1402","E1",10,"25.02.2020","Yes","Huddersfield","Bristol City",2,1,20,8,6,3,7,12,2,4,0,0,2.14,3.32,3.49,2.02,1.79,3,0,0.442917103080252,0.285494759214379,0.271588137705369,1.61424606845513,1.10025917233049,1,12,3,3,0.513986896124648,-5,-2,0,0
"1403","E1",10,"25.02.2020","Yes","Luton","Brentford",2,1,10,19,3,7,14,9,2,1,0,0,5.54,4.28,1.56,1.63,2.26,3,0,0.171066655735017,0.221427400180372,0.607505944084611,0.734627367385423,2.04394523243421,1,-9,-4,3,-1.30931786504878,5,1,0,0
"1404","E1",10,"25.02.2020","Yes","QPR","Derby",2,1,15,15,6,4,12,9,3,1,0,0,2.17,3.53,3.22,1.68,2.17,3,0,0.436939967171649,0.268600489734413,0.294459543093937,1.57942039124936,1.15197911901623,1,0,2,3,0.427441272233135,3,2,0,0
"1405","E1",10,"25.02.2020","Yes","West Brom","Preston",2,0,21,5,9,0,8,11,0,0,0,1,1.66,3.85,5.25,1.88,1.91,3,0,0.572292141512239,0.246754533742939,0.180953324744822,1.96363095827966,0.789614507977406,2,16,9,3,1.17401645030225,-3,0,-1,0
"1406","E1",10,"26.02.2020","Yes","Blackburn","Stoke",0,0,16,11,6,2,10,17,2,2,0,0,2.35,3.15,3.2,2.23,1.65,1,1,0.403159684031597,0.300769923007699,0.296070392960704,1.51024897510249,1.18898110188981,0,5,4,0,0.321267873212679,-7,0,0,0
"1407","E1",10,"26.02.2020","Yes","Fulham","Swansea",1,0,15,6,6,2,6,13,0,4,0,0,1.83,3.67,4.23,1.78,2.04,3,0,0.517796211613316,0.258192661376667,0.224011127010016,1.81158129621662,0.930226042406716,1,9,4,3,0.8813552538099,-7,-4,0,0
"1408","E1",10,"26.02.2020","Yes","Hull","Barnsley",0,1,12,22,3,6,11,12,1,1,0,0,2.51,3.52,2.67,1.67,2.19,0,3,0.376911446824381,0.268763560093522,0.354324993082096,1.39949790056667,1.33173853933981,-1,-10,-3,-3,0.067759361226855,-1,0,0,0
"1409","E1",10,"26.02.2020","Yes","Middlesbrough","Leeds",0,1,14,12,2,8,14,11,3,0,0,0,5.53,3.9,1.62,1.87,1.92,0,3,0.171481614174511,0.243152134970524,0.585366250854965,0.757596977494056,1.99925088753542,-1,2,-6,-3,-1.24165391004136,3,3,0,0
"1410","E1",10,"26.02.2020","Yes","Millwall","Birmingham",0,0,12,8,3,0,7,13,1,0,0,0,2.18,3.14,3.59,2.33,1.59,1,1,0.434497378970089,0.301657415972865,0.263845205057046,1.60514955288313,1.093193031144,0,4,3,0,0.51195652173913,-6,1,0,0
"1411","E1",10,"26.02.2020","Yes","Sheffield Weds","Charlton",1,0,24,6,8,1,17,18,2,3,0,0,1.74,3.6,4.92,2.01,1.79,3,0,0.544368223058199,0.263111307811463,0.192520469130339,1.89621597698606,0.840672715202478,1,18,7,3,1.05554326178358,-1,-1,0,0
"1412","E1",10,"26.02.2020","Yes","Reading","Wigan",0,3,10,17,4,10,12,12,3,1,0,0,2.15,3.25,3.55,2.06,1.76,0,3,0.441078084679346,0.291790117557106,0.267131797763548,1.61502437159514,1.09318551084775,-3,-7,-6,-3,0.521838860747395,0,2,0,0
"1413","E1",10,"29.02.2020","Yes","Hull","Leeds",0,4,8,17,2,8,13,13,2,1,0,0,7.25,4.76,1.41,1.67,2.19,0,3,0.130463940471308,0.198710833701046,0.670825225827646,0.590102655114969,2.21118651118398,-4,-9,-6,-3,-1.62108385606901,0,1,0,0
"1414","E1",10,"29.02.2020","Yes","Blackburn","Swansea",2,2,16,9,5,3,17,13,3,5,0,0,2.19,3.29,3.39,2.05,1.76,1,1,0.432587472801108,0.287953363353929,0.279459163844963,1.58571578175725,1.12633085488882,0,7,2,0,0.459384926868433,4,-2,0,0
"1415","E1",10,"29.02.2020","Yes","Cardiff","Brentford",2,2,11,10,6,5,14,6,4,1,0,0,3.54,3.33,2.11,2.03,1.78,1,1,0.267323342426352,0.284181571228014,0.448495086345634,1.08615159850707,1.62966683026492,0,1,1,0,-0.543515231757844,8,3,0,0
"1416","E1",10,"29.02.2020","Yes","Fulham","Preston",2,0,15,8,4,2,11,6,0,0,0,0,1.85,3.57,4.27,1.93,1.86,3,0,0.51243617196508,0.265548156340448,0.222015671694473,1.80285667223569,0.931595171423865,2,7,2,3,0.871261500811822,5,0,0,0
"1417","E1",10,"29.02.2020","Yes","Huddersfield","Charlton",4,0,20,10,8,2,15,13,1,2,0,0,1.8,3.52,4.63,2.14,1.7,3,0,0.526279078779111,0.269119983466591,0.204600937754298,1.84795721980392,0.882922796729485,4,10,6,3,0.965034423074439,2,-1,0,0
"1418","E1",10,"29.02.2020","Yes","Luton","Stoke",1,1,9,9,3,4,11,9,1,1,0,0,3.27,3.3,2.23,2.01,1.8,1,1,0.289244991569092,0.286615491645737,0.424139516785171,1.15435046635301,1.55903404200125,0,0,-1,0,-0.404683575648237,2,0,0,0
"1419","E1",10,"29.02.2020","Yes","Millwall","Bristol City",1,1,12,3,4,1,14,16,1,0,0,0,1.96,3.31,4.12,2.14,1.7,1,1,0.48358865248227,0.286354609929078,0.230056737588652,1.73712056737589,0.976524822695035,0,9,3,0,0.760595744680851,-2,1,0,0
"1420","E1",10,"29.02.2020","Yes","QPR","Birmingham",2,2,14,13,6,4,6,15,0,0,0,0,2.2,3.45,3.21,1.8,2.01,1,1,0.430470526499913,0.274502944434727,0.295026529065361,1.56591452393446,1.15958253163081,0,1,2,0,0.406331992303656,-9,0,0,0
"1421","E1",10,"29.02.2020","Yes","Reading","Barnsley",2,0,7,23,4,6,11,15,1,3,0,0,2.32,3.34,3.06,1.84,1.97,3,0,0.407700531346237,0.283193183450081,0.309106285203683,1.50629477748879,1.21051203906113,2,-16,-2,3,0.295782738427662,-4,-2,0,0
"1422","E1",10,"29.02.2020","Yes","Sheffield Weds","Derby",1,3,15,13,4,5,14,8,2,1,0,0,2.13,3.37,3.43,2,1.8,0,3,0.443845010770607,0.280531119567179,0.275623869662214,1.612066151879,1.10740272855382,-2,2,-1,-3,0.50466342332518,6,1,0,0
"1423","E1",10,"29.02.2020","Yes","West Brom","Wigan",0,1,9,13,3,5,10,6,2,1,0,0,1.46,4.44,6.85,1.71,2.11,0,3,0.648522092909202,0.213252760280954,0.138225146809844,2.15881903900856,0.627928200710487,-1,-4,-2,-3,1.53089083829807,4,1,0,0
"1424","E1",10,"02.03.2020","Yes","Middlesbrough","Nott'm Forest",2,2,14,16,4,2,13,11,1,1,0,0,2.59,3.17,2.8,2.2,1.66,1,1,0.364692686013403,0.2979665794242,0.337340734562398,1.39204463746441,1.30998878311139,0,-2,2,0,0.0820558543530157,2,0,0,0
"1425","E1",10,"06.03.2020","Yes","Nott'm Forest","Millwall",0,3,18,13,4,4,7,7,1,1,0,0,2.28,3.1,3.43,2.43,1.55,0,3,0.416630749096837,0.306425196109931,0.276944054793232,1.55631744340044,1.13725736048963,-3,5,0,-3,0.419060082910812,0,0,0,0
"1426","E1",10,"07.03.2020","Yes","Bristol City","Fulham",1,1,14,19,8,5,8,13,2,2,0,0,3.52,3.4,2.1,1.9,1.9,1,1,0.269433962264151,0.278943396226415,0.451622641509434,1.08724528301887,1.63381132075472,0,-5,3,0,-0.546566037735849,-5,0,0,0
"1427","E1",10,"07.03.2020","Yes","Barnsley","Cardiff",0,2,6,13,0,7,10,16,0,0,0,0,2.33,3.4,3.02,1.86,1.93,0,3,0.407030673971126,0.27893572657433,0.314033599454544,1.50002774848771,1.22103652493796,-2,-7,-7,-3,0.278991223549745,-6,0,0,0
"1428","E1",10,"07.03.2020","Yes","Birmingham","Reading",1,3,18,9,4,4,14,7,2,1,0,0,2.11,3.38,3.51,2.02,1.79,0,3,0.449357427741395,0.280516027377025,0.27012654488158,1.62858831060121,1.09089566202176,-2,9,0,-3,0.537692648579448,7,1,0,0
"1429","E1",10,"07.03.2020","Yes","Brentford","Sheffield Weds",5,0,12,8,6,3,8,11,0,2,0,0,1.58,3.91,6.05,1.92,1.88,3,0,0.600510759717,0.24266163691889,0.156827603364109,2.04419391606989,0.713144447011218,5,4,3,3,1.33104946905867,-3,-2,0,0
"1430","E1",10,"07.03.2020","Yes","Charlton","Middlesbrough",0,1,13,23,3,4,9,10,2,1,0,0,2.98,3.21,2.45,2.09,1.74,0,3,0.317997840792841,0.295212948773417,0.386789210433742,1.24920647115194,1.45558058007464,-1,-10,-1,-3,-0.206374108922701,-1,1,0,0
"1431","E1",10,"07.03.2020","Yes","Leeds","Huddersfield",2,0,16,6,5,2,13,18,3,3,0,0,1.36,4.83,9.22,1.76,2.06,3,0,0.699751416548555,0.197031454763154,0.10321712868829,2.29628570440882,0.506682840828025,2,10,3,3,1.7896028635808,-5,0,0,0
"1432","E1",10,"07.03.2020","Yes","Preston","QPR",1,3,10,10,2,3,16,12,2,1,0,1,2.06,3.46,3.58,1.82,1.99,0,3,0.460660785742975,0.274266248159112,0.265072966097913,1.65624860538804,1.06948514645285,-2,0,-1,-3,0.586763458935186,4,1,-1,0
"1433","E1",10,"07.03.2020","Yes","Stoke","Hull",5,1,16,5,7,1,8,17,0,2,0,0,1.58,3.9,6.07,1.94,1.85,3,0,0.600447425023335,0.243258187573556,0.156294387403109,2.04460046264356,0.712141349782882,4,11,6,3,1.33245911286068,-9,-2,0,0
"1434","E1",10,"07.03.2020","Yes","Swansea","West Brom",0,0,9,10,2,1,9,18,1,2,0,0,3.47,3.49,2.09,1.86,1.93,1,1,0.273631019593573,0.272062933521404,0.454306046885023,1.09295599230212,1.63498107417647,0,-1,1,0,-0.542025081874351,-9,-1,0,0
"1435","E1",10,"07.03.2020","Yes","Wigan","Luton",0,0,12,3,2,1,11,13,1,2,0,0,1.73,3.74,4.84,1.89,1.9,1,1,0.549449081803005,0.254156928213689,0.196393989983306,1.9025041736227,0.843338898163606,0,9,1,0,1.0591652754591,-2,-1,0,0
"1436","E1",10,"08.03.2020","Yes","Derby","Blackburn",3,0,16,11,11,3,12,14,2,3,0,1,2.38,3.19,3.1,2.03,1.78,3,0,0.397800411919933,0.296791529896376,0.30540805818369,1.49019276565618,1.21301570444745,3,5,8,3,0.277177061208728,-2,-1,-1,0
"1437","E1",10,"20.06.2020","No","Fulham","Brentford",0,2,9,13,4,5,11,12,1,1,0,0,2.88,3.27,2.48,1.99,1.82,0,3,0.328728475532639,0.289522327074618,0.381749197392742,1.27570775367254,1.43476991925285,-2,-4,-1,-3,-0.15906216558031,-1,0,0,0
"1438","E1",10,"20.06.2020","No","Middlesbrough","Swansea",0,3,17,13,1,3,15,13,2,1,0,0,2.51,3.23,2.87,2.01,1.81,0,3,0.377123074231829,0.293058488025353,0.329818437742819,1.42442771072084,1.28251380125381,-3,4,-2,-3,0.14191390946703,2,1,0,0
"1439","E1",10,"20.06.2020","No","Millwall","Derby",2,3,12,12,4,5,10,8,0,2,0,0,2.37,3.11,3.2,2.35,1.59,0,3,0.399571199717345,0.304496380491996,0.295932419790659,1.50320997964403,1.19229363986397,-1,0,-1,-3,0.310916339780059,2,-2,0,0
"1440","E1",10,"20.06.2020","No","Blackburn","Bristol City",3,1,9,7,4,1,14,21,2,2,0,0,2.17,3.37,3.35,1.97,1.84,3,0,0.436361457797842,0.280980523270421,0.282658018931737,1.59006489666395,1.12895458006563,2,2,3,3,0.461110316598317,-7,0,0,0
"1441","E1",10,"20.06.2020","No","Huddersfield","Wigan",0,2,9,9,1,5,16,17,2,1,0,0,2.38,3.21,3.06,2.2,1.67,0,3,0.396949711459192,0.294311624072547,0.30873866446826,1.48516075845012,1.22052761747733,-2,0,-4,-3,0.264633140972795,-1,1,0,0
"1442","E1",10,"20.06.2020","No","Hull","Charlton",0,1,12,10,3,2,13,20,1,0,0,0,2.24,3.39,3.19,1.88,1.93,0,3,0.423197786587251,0.279635115621074,0.297167097791675,1.54922847538283,1.1711364089961,-1,2,1,-3,0.378092066386729,-7,1,0,0
"1443","E1",10,"20.06.2020","No","Luton","Preston",1,1,5,12,1,4,9,7,1,0,0,0,3.32,3.32,2.2,1.93,1.88,1,1,0.284974093264249,0.284974093264249,0.430051813471503,1.13989637305699,1.57512953367876,0,-7,-3,0,-0.435233160621761,2,1,0,0
"1444","E1",10,"20.06.2020","No","QPR","Barnsley",0,1,8,10,2,2,11,18,0,1,0,0,2.19,3.52,3.17,1.67,2.21,0,3,0.43233693020012,0.268982351459734,0.298680718340146,1.56599314206009,1.16502450648017,-1,-2,0,-3,0.400968635579922,-7,-1,0,0
"1445","E1",10,"20.06.2020","No","Reading","Stoke",1,1,7,10,3,3,11,13,0,1,0,0,3.03,3.18,2.42,2.17,1.69,1,1,0.312022575779692,0.297304529752348,0.390672894467961,1.23337225709142,1.46932321315623,0,-3,0,0,-0.235950956064808,-2,-1,0,0
"1446","E1",10,"20.06.2020","No","Sheffield Weds","0",1,1,13,10,3,3,17,15,3,3,0,0,2.6,3.21,2.78,2.07,1.76,1,1,0.364269444603189,0.295046902170807,0.340683653226004,1.38785523598037,1.31709786184882,0,3,0,0,0.0707573741315544,2,0,0,0
"1447","E1",10,"20.06.2020","No","West Brom","Birmingham",0,0,20,7,2,2,11,11,1,3,0,0,1.65,3.86,5.22,1.8,2.01,1,1,0.573541467413581,0.245166689438448,0.181291843147971,1.96579109167919,0.789042218882361,0,13,0,0,1.17674887279683,0,-2,0,0
"1448","E1",10,"21.06.2020","No","Cardiff","Leeds",2,0,7,13,2,3,17,12,2,4,0,0,5.26,3.85,1.65,1.83,1.98,3,0,0.180046765393609,0.245985970381917,0.573967264224474,0.786126266562744,1.96788776305534,2,-6,-1,3,-1.1817614964926,5,-2,0,0
"1449","E1",10,"26.06.2020","No","Brentford","West Brom",1,0,9,12,2,2,18,14,2,1,0,0,2.5,3.24,2.9,2.06,1.76,3,0,0.379697728925887,0.292976642689728,0.327325628384385,1.43206982946739,1.27495352784288,1,-3,0,3,0.157116301624505,4,1,0,0
"1450","E1",10,"27.06.2020","No","Charlton","QPR",1,0,12,6,5,1,11,11,1,0,0,0,3.32,3.41,2.16,1.88,1.92,3,0,0.284848016087865,0.277330033258566,0.43782195065357,1.13187408152216,1.59079588521927,1,6,4,3,-0.458921803697115,0,1,0,0
"1451","E1",10,"27.06.2020","No","Preston","Cardiff",1,3,14,13,3,6,11,10,1,2,0,0,2.42,3.21,3.01,2.14,1.7,0,3,0.390948633393352,0.294733860689069,0.314317505917579,1.46757976086913,1.23768637844181,-2,1,-3,-3,0.22989338242732,1,-1,0,0
"1452","E1",10,"27.06.2020","No","Swansea","Luton",0,1,10,7,3,2,12,19,2,3,1,0,1.7,3.81,4.84,1.83,1.98,0,3,0.556348693936414,0.248239574722284,0.195411731341302,1.91728565653152,0.834474768746191,-1,3,1,-3,1.08281088778533,-7,-1,1,0
"1453","E1",10,"27.06.2020","No","Barnsley","Millwall",0,0,9,9,5,1,12,16,2,2,0,0,2.7,3.14,2.72,2.19,1.68,1,1,0.350567258279016,0.301443183870491,0.347989557850493,1.35314495870754,1.34541185742197,0,0,4,0,0.00773310128556659,-4,0,0,0
"1454","E1",10,"27.06.2020","No","Derby","Reading",2,1,13,12,6,4,13,12,2,0,1,1,2.11,3.36,3.52,1.97,1.84,3,0,0.448952323109626,0.281931369571819,0.269116307318555,1.6287883389007,1.08928029152748,1,1,2,3,0.539508047373216,1,2,0,0
"1455","E1",10,"27.06.2020","No","Birmingham","Hull",3,3,14,12,4,3,12,10,3,0,0,0,1.77,3.69,4.54,1.82,1.99,1,1,0.534890180940431,0.256573338825085,0.208536480234485,1.86124388164638,0.88218277952854,0,2,1,0,0.979061102117837,2,3,0,0
"1456","E1",10,"27.06.2020","No","Leeds","Fulham",3,0,10,12,5,5,16,15,2,2,0,1,1.74,3.72,4.75,1.93,1.87,3,0,0.545239109103364,0.255031196193509,0.199729694703127,1.8907485235036,0.85422028030289,3,-2,0,3,1.03652824320071,1,0,-1,0
"1457","E1",10,"27.06.2020","No","Stoke","Middlesbrough",0,2,22,8,6,3,16,16,0,1,0,0,2.2,3.12,3.55,2.39,1.58,0,3,0.430135922330097,0.303300970873786,0.266563106796117,1.59370873786408,1.10299029126214,-2,14,3,-3,0.490718446601942,0,-1,0,0
"1458","E1",10,"27.06.2020","No","Wigan","Blackburn",2,0,13,12,3,3,13,14,1,0,0,0,2.64,3.08,2.82,2.35,1.59,3,0,0.357997823721436,0.306855277475517,0.335146898803047,1.38084874863983,1.31229597388466,2,1,0,3,0.0685527747551686,-1,1,0,0
"1459","E1",10,"28.06.2020","No","Bristol City","Sheffield Weds",1,2,7,12,3,4,13,17,1,2,0,0,2.66,3.26,2.66,2,1.81,0,3,0.355119825708061,0.289760348583878,0.355119825708061,1.35511982570806,1.35511982570806,-1,-5,-1,-3,0,-4,-1,0,0
"1460","E1",10,"28.06.2020","No","Nott'm Forest","Huddersfield",3,1,14,14,6,4,14,10,3,0,0,1,2.23,3.18,3.39,2.3,1.61,3,0,0.423894964079697,0.297259676068467,0.278845359851836,1.56894456830756,1.13379575562398,2,0,2,3,0.435148812683583,4,3,-1,0
"1461","E1",10,"30.06.2020","No","Millwall","Swansea",1,1,16,9,2,4,15,8,2,1,0,0,2.56,3.05,2.98,2.3,1.62,1,1,0.370589338574073,0.311052034999878,0.318358626426049,1.4228200507221,1.26612791427803,0,7,-2,0,0.156692136444071,7,1,0,0
"1462","E1",10,"30.06.2020","No","Barnsley","Blackburn",2,0,12,10,5,5,12,12,1,2,0,1,2.51,3.25,2.87,2.06,1.77,3,0,0.377804420645882,0.291781260252666,0.330414319101451,1.42519452219031,1.28302421755702,2,2,0,3,0.142170304633294,0,-1,-1,0
"1463","E1",10,"30.06.2020","No","Cardiff","Charlton",0,0,8,4,1,0,10,8,1,1,0,0,1.81,3.54,4.57,2.06,1.76,1,1,0.524284681870181,0.268066461634189,0.20764885649563,1.84092050724473,0.891013031121078,0,4,1,0,0.949907476123655,2,0,0,0
"1464","E1",10,"30.06.2020","No","Reading","Brentford",0,3,5,19,1,9,10,11,0,1,0,0,5.2,3.7,1.69,2,1.8,0,3,0.182404247250664,0.256351915054987,0.56124383769435,0.803564656806978,1.94008342813804,-3,-14,-8,-3,-1.13651877133106,-1,-1,0,0
"1465","E1",10,"30.06.2020","No","QPR","Fulham",1,2,11,14,2,5,8,10,2,3,0,0,3.26,3.38,2.22,1.93,1.87,0,3,0.291293343064333,0.280951567570925,0.427755089364742,1.15483159676392,1.56421683566515,-1,-3,-3,-3,-0.409385238901225,-2,-1,0,0
"1466","E1",10,"30.06.2020","No","Leeds","Luton",1,1,23,3,9,2,9,10,0,5,0,0,1.27,5.65,11.24,1.67,2.21,1,1,0.747513721760481,0.168025208254126,0.0844610699853925,2.41056637353557,0.421408418210303,0,20,7,0,1.98915795532527,-1,-5,0,0
"1467","E1",10,"30.06.2020","No","Wigan","Stoke",3,0,16,7,7,1,11,13,1,3,0,0,2.74,2.95,2.87,2.55,1.51,3,0,0.346798671216099,0.322111308180377,0.331090020603523,1.36250732182868,1.31538136999095,3,9,6,3,0.0471259518377281,-2,-2,0,0
"1468","E1",10,"01.07.2020","No","Preston","Derby",0,1,9,8,1,3,10,11,0,0,0,0,2.46,3.28,2.91,2.01,1.81,0,3,0.385302879841112,0.288977159880834,0.325719960278054,1.44488579940417,1.26613704071499,-1,1,-2,-3,0.178748758689176,-1,0,0,0
"1469","E1",10,"01.07.2020","No","Birmingham","Huddersfield",0,3,10,12,2,6,17,20,0,1,0,0,2.45,3.16,3.02,2.13,1.72,0,3,0.386611678725663,0.29974639648034,0.313641924793998,1.45958143265733,1.24067217086233,-3,-2,-4,-3,0.218909261794994,-3,-1,0,0
"1470","E1",10,"01.07.2020","No","Nott'm Forest","Bristol City",1,0,11,8,3,2,12,11,0,2,0,1,2.05,3.4,3.68,2.03,1.79,3,0,0.462961592540517,0.279138607267076,0.257899800192407,1.66802338488863,1.0528380078443,1,3,1,3,0.615185377044328,1,-2,-1,0
"1471","E1",10,"01.07.2020","No","Sheffield Weds","West Brom",0,3,14,9,2,4,8,13,0,4,0,0,3.93,3.42,1.97,2.03,1.79,0,3,0.241310023961232,0.277294852095802,0.481395123942966,1.0012249239795,1.7214802239247,-3,5,-2,-3,-0.720255299945201,-5,-4,0,0
"1472","E1",10,"02.07.2020","No","Hull","Middlesbrough",2,1,8,14,3,3,18,21,1,1,0,0,3.37,3.29,2.19,2.12,1.72,3,0,0.280652210324586,0.287476580180503,0.431871209494911,1.12943321115426,1.58309020866524,1,-6,0,3,-0.453656997510975,-3,0,0,0
"1473","E1",10,"03.07.2020","No","Charlton","Millwall",0,1,14,12,3,4,13,14,3,3,0,0,3.42,2.95,2.35,2.67,1.47,0,3,0.276652632839156,0.320729492986412,0.402617874174432,1.15068739150388,1.52858311550971,-1,2,-1,-3,-0.377895724005826,-1,0,0,0
"1474","E1",10,"04.07.2020","No","Derby","Nott'm Forest",1,1,10,10,3,4,12,7,1,3,1,0,2.42,3.18,3.05,2.14,1.71,1,1,0.391473869452203,0.297914076752934,0.310612053794863,1.47233568510954,1.22975023813752,0,0,-1,0,0.242585446972021,5,-2,1,0
"1475","E1",10,"04.07.2020","No","Blackburn","Leeds",1,3,11,17,3,5,18,12,1,2,0,0,5.39,3.8,1.65,2.05,1.78,0,3,0.175898781052307,0.249498534176825,0.574602684770869,0.777194877333745,1.97330658848943,-2,-6,-2,-3,-1.19611171115569,6,-1,0,0
"1476","E1",10,"04.07.2020","No","Brentford","Wigan",3,0,18,3,6,0,9,14,0,1,0,1,1.5,4.17,6.64,1.9,1.91,3,0,0.630669782570074,0.226859634018012,0.142470583411914,2.11886898172823,0.654271384253755,3,15,6,3,1.46459759747448,-5,-1,-1,0
"1477","E1",10,"04.07.2020","No","Bristol City","Cardiff",0,1,11,13,2,3,9,12,1,0,0,0,3.22,3.34,2.24,2.02,1.79,0,3,0.293981736164595,0.283419518098801,0.422598745736605,1.16536472659258,1.55121575530861,-1,-2,-1,-3,-0.38585102871603,-3,1,0,0
"1478","E1",10,"04.07.2020","No","Fulham","Birmingham",1,0,15,6,5,2,9,18,2,4,0,0,1.76,3.64,4.65,1.86,1.95,3,0,0.537053724410148,0.259674328286226,0.203271947303626,1.87083550151667,0.869490170197104,1,9,3,3,1.00134533131957,-9,-2,0,0
"1479","E1",10,"04.07.2020","No","Huddersfield","Preston",0,0,2,9,1,0,9,14,0,0,0,0,2.61,3.11,2.84,2.29,1.63,1,1,0.362549719028483,0.30426198285027,0.333188298121247,1.39191113993572,1.30382687721401,0,-7,1,0,0.0880842627217089,-5,0,0,0
"1480","E1",10,"04.07.2020","No","Luton","Reading",0,5,5,16,1,10,11,13,0,1,0,0,2.57,3.22,2.8,2.08,1.75,0,3,0.368189354525184,0.293865416499914,0.337945228974901,1.39843348007547,1.30770110342462,-5,-11,-9,-3,0.090732376650849,-2,-1,0,0
"1481","E1",10,"04.07.2020","No","Stoke","Barnsley",4,0,14,5,7,3,12,15,2,0,0,0,2.31,3.17,3.24,2.23,1.66,3,0,0.409555824052253,0.298446042132714,0.291998133815032,1.52711351428947,1.17444044357781,4,9,4,3,0.352673070711663,-3,2,0,0
"1482","E1",10,"05.07.2020","No","Swansea","Sheffield Weds",2,1,7,10,4,3,12,20,2,1,0,0,2.25,3.27,3.25,2.03,1.79,3,0,0.420100800474355,0.28906018381263,0.290839015713015,1.54936258523569,1.16157723095167,1,-3,1,3,0.38778535428402,-8,1,0,0
"1483","E1",10,"05.07.2020","No","Middlesbrough","QPR",0,1,15,10,4,5,14,14,3,0,0,0,2.12,3.32,3.49,2.06,1.76,0,3,0.445235167537658,0.284306793728866,0.270458038733477,1.62001229634184,1.0956809099293,-1,5,-1,-3,0.524331386412542,0,3,0,0
"1484","E1",10,"05.07.2020","No","West Brom","Hull",4,2,22,15,10,4,16,16,1,1,1,0,1.32,5.21,9.17,1.59,2.35,3,0,0.715662556754093,0.181319496144991,0.103017947100916,2.32830716640727,0.49037333744774,2,7,6,3,1.83793382895953,0,0,1,0
"1485","E1",10,"07.07.2020","No","Nott'm Forest","Fulham",0,1,10,9,4,2,16,12,2,2,0,0,2.83,3.05,2.68,2.27,1.63,0,3,0.335138725456029,0.310964784603463,0.353896489940508,1.31638096097155,1.37265425442499,-1,1,2,-3,-0.0562732934534376,4,0,0,0
"1486","E1",10,"07.07.2020","No","Brentford","Charlton",2,1,21,6,8,2,10,9,1,1,0,0,1.28,5.49,10.81,1.7,2.16,3,0,0.739885726254162,0.172505233079295,0.0876090406665428,2.39216241184178,0.435332355078923,1,15,6,3,1.95683005676286,1,0,0,0
"1487","E1",10,"07.07.2020","No","Luton","Barnsley",1,1,10,21,5,7,12,14,4,2,0,0,2.93,3.27,2.45,1.96,1.85,1,1,0.323421244918474,0.289793347893311,0.386785407188215,1.26005708264873,1.45014956945796,0,-11,-2,0,-0.190092486809225,-2,2,0,0
"1488","E1",10,"07.07.2020","No","Reading","Huddersfield",0,0,7,11,2,3,14,10,1,2,0,0,2.7,3.19,2.71,2.12,1.73,1,1,0.351777626765521,0.297742818892447,0.350479554342032,1.35307569918901,1.34918148191854,0,-4,-1,0,0.00389421727046702,4,-1,0,0
"1489","E1",10,"07.07.2020","No","Cardiff","Blackburn",2,3,12,14,4,4,14,12,0,1,0,0,2.05,3.37,3.71,2.09,1.74,0,3,0.462776726987382,0.281511065378081,0.255712207634537,1.66984124634023,1.04864768828169,-1,-2,0,-3,0.621193558058534,2,-1,0,0
"1490","E1",10,"08.07.2020","No","Millwall","Middlesbrough",0,2,10,7,4,3,11,12,1,3,0,0,2.26,3.18,3.32,2.27,1.63,0,3,0.418162518417592,0.297184682900553,0.284652798681855,1.55167223815333,1.15114307894612,-2,3,1,-3,0.400529159207212,-1,-2,0,0
"1491","E1",10,"08.07.2020","No","West Brom","Derby",2,0,18,4,7,0,11,14,0,4,0,1,1.76,3.78,4.48,1.79,2.02,3,0,0.538078291814947,0.250533807829181,0.211387900355872,1.86476868327402,0.884697508896797,2,14,7,3,0.980071174377224,-3,-4,-1,0
"1492","E1",10,"08.07.2020","No","Birmingham","Swansea",1,3,20,10,5,4,16,6,2,3,0,0,2.91,3.26,2.46,2,1.81,0,3,0.325143524374818,0.290235477279362,0.384620998345821,1.26566605040381,1.44409847231682,-2,10,1,-3,-0.17843242191301,10,-1,0,0
"1493","E1",10,"08.07.2020","No","Bristol City","Hull",2,1,9,18,5,4,10,20,0,3,0,0,2.1,3.5,3.39,1.8,2.01,3,0,0.450558213716108,0.270334928229665,0.279106858054227,1.62200956937799,1.10765550239234,1,-9,1,3,0.514354066985646,-10,-3,0,0
"1494","E1",10,"08.07.2020","No","Wigan","QPR",1,0,16,6,6,2,12,9,1,0,0,0,2.12,3.37,3.45,2.03,1.79,3,0,0.445717637407082,0.280392104244218,0.2738902583487,1.61754501646546,1.10206287929032,1,10,4,3,0.515482137175147,3,1,0,0
"1495","E1",10,"08.07.2020","No","Sheffield Weds","Preston",1,3,13,14,2,5,15,13,2,0,0,0,2.42,3.17,3.05,2.2,1.68,0,3,0.391106310854378,0.298573272008705,0.310320417136917,1.47189220457184,1.22953452341945,-2,-1,-3,-3,0.242357681152385,2,2,0,0
"1496","E1",10,"09.07.2020","No","Leeds","Stoke",5,0,19,5,11,0,8,8,2,2,0,0,1.48,4.22,6.97,1.97,1.83,3,0,0.639775006199075,0.224376068524794,0.135848925276131,2.14370108712202,0.631922844353186,5,14,11,3,1.51177824276883,0,0,0,0
"1497","E1",10,"10.07.2020","No","Huddersfield","Luton",0,2,11,6,2,2,19,11,2,1,0,0,1.79,3.52,4.69,2.18,1.69,0,3,0.529048508718238,0.269033190512968,0.201918300768794,1.85617871666768,0.874788092819351,-2,5,0,-3,0.981390623848331,8,1,0,0
"1498","E1",10,"10.07.2020","No","Fulham","Cardiff",2,0,14,13,7,1,18,13,3,1,0,0,2.01,3.31,3.91,2.13,1.72,3,0,0.471405207927356,0.286261168560116,0.242333623512528,1.70047679234218,1.0132620390977,2,1,6,3,0.687214753244483,5,2,0,0
"1499","E1",10,"11.07.2020","No","Charlton","Reading",0,1,15,4,2,2,18,22,4,3,0,0,2.65,3.16,2.75,2.22,1.67,0,3,0.356856867133442,0.299262879083424,0.343880253783135,1.36983348048375,1.33090364043283,-1,11,0,-3,0.0389298400509208,-4,1,0,0
"1500","E1",10,"11.07.2020","No","Derby","Brentford",1,3,9,17,3,6,9,9,0,1,0,0,4.22,3.64,1.83,1.88,1.92,0,3,0.223946531471259,0.259630319452943,0.516423149075799,0.931469913866719,1.80889976668034,-2,-8,-3,-3,-0.87742985281362,0,-1,0,0
"1501","E1",10,"11.07.2020","No","Barnsley","Wigan",0,0,13,6,5,0,13,15,2,3,0,1,2.48,3.38,2.79,1.81,1.99,1,1,0.381298571070444,0.279769365755829,0.338932063173728,1.42366507896716,1.29656555527701,0,7,5,0,0.127099523690148,-2,-1,-1,0
"1502","E1",10,"11.07.2020","No","Blackburn","West Brom",1,1,7,18,4,8,14,12,2,2,0,0,4.8,3.5,1.78,2.06,1.77,1,1,0.197314245898524,0.270602394375119,0.532083359726357,0.862545132070691,1.86685247355419,0,-11,-4,0,-1.0043073414835,2,0,0,0
"1503","E1",10,"11.07.2020","No","Hull","Millwall",0,1,12,10,5,2,20,9,2,0,0,0,3.08,3.27,2.34,2.09,1.75,0,3,0.306924021082525,0.289090515270391,0.403985463647084,1.20986257851797,1.50104690621164,-1,2,3,-3,-0.291184327693678,11,2,0,0
"1504","E1",10,"11.07.2020","No","Middlesbrough","Bristol City",1,3,14,12,4,6,11,9,1,0,0,0,2.03,3.37,3.76,2.13,1.72,0,3,0.466795112193361,0.281185186276713,0.252019701529926,1.6815705228568,1.03724429086649,-2,2,-2,-3,0.644326231990304,2,1,0,0
"1505","E1",10,"11.07.2020","No","Preston","Nott'm Forest",1,1,15,8,2,1,18,6,2,0,0,0,2.54,3.16,2.87,2.22,1.67,1,1,0.371911061536821,0.298941169716306,0.329147768746873,1.41467435432677,1.28638447595692,0,7,1,0,0.128289878369844,12,2,0,0
"1506","E1",10,"11.07.2020","No","QPR","Sheffield Weds",0,3,7,14,1,6,12,12,1,2,0,0,2.84,3.28,2.5,1.94,1.86,0,3,0.333127498456238,0.288439663297475,0.378432838246287,1.28782215866619,1.42373817803634,-3,-7,-5,-3,-0.135916019370145,0,-1,0,0
"1507","E1",10,"12.07.2020","No","Stoke","Birmingham",2,0,15,7,5,1,12,11,1,4,0,0,1.98,3.26,4.08,2.19,1.67,3,0,0.477861608105195,0.29023496443199,0.231903427462815,1.72381978874758,0.985945246820435,2,8,4,3,0.73787454192714,1,-3,0,0
"1508","E1",10,"12.07.2020","No","Swansea","Leeds",0,1,6,12,3,4,12,19,2,3,0,0,4.71,3.81,1.72,1.88,1.93,0,3,0.201021488059633,0.248506878939861,0.550471633000506,0.851571343118759,1.89992177794138,-1,-6,-1,-3,-1.04835043482262,-7,-1,0,0
"1509","E1",10,"14.07.2020","No","West Brom","Fulham",0,0,12,6,3,2,12,12,3,0,0,0,2.04,3.33,3.77,2.06,1.77,1,1,0.46431147159009,0.284443063676812,0.251245464733099,1.67737747844708,1.03817945787611,0,6,1,0,0.639198020570972,0,3,0,0
"1510","E1",10,"14.07.2020","No","Reading","Middlesbrough",1,2,10,13,1,6,11,17,2,0,0,0,3.1,3.21,2.38,2.09,1.75,0,3,0.305973855371504,0.295488769984941,0.398537374643555,1.21341033609945,1.49110089391561,-1,-3,-5,-3,-0.277690557816155,-6,2,0,0
"1511","E1",10,"14.07.2020","No","Wigan","Hull",8,0,14,10,9,4,11,16,0,2,0,0,1.8,3.63,4.45,1.95,1.86,3,0,0.526215489860738,0.260933300757391,0.212851209381871,1.8395797703396,0.899486928903005,8,4,5,3,0.940092841436599,-5,-2,0,0
"1512","E1",10,"14.07.2020","No","Cardiff","Derby",2,1,14,8,8,2,8,9,1,0,0,0,2.31,3.3,3.13,2.05,1.77,3,0,0.410169047307037,0.287118333114926,0.302712619578037,1.51762547503604,1.19525619184904,1,6,6,3,0.322369283187,-1,1,0,0
"1513","E1",10,"14.07.2020","No","Luton","QPR",1,1,11,11,3,5,9,15,1,0,0,0,2.34,3.44,2.98,1.85,1.96,1,1,0.405602595552742,0.275904091160877,0.318493313286381,1.4927118778191,1.23138403102002,0,0,-2,0,0.261327846799082,-6,1,0,0
"1514","E1",10,"14.07.2020","No","Millwall","Blackburn",1,0,11,10,4,2,13,9,2,2,0,0,2.26,3.21,3.32,2.22,1.67,3,0,0.419327168994688,0.295227228014952,0.28544560299036,1.55320873499902,1.15156403698603,1,1,2,3,0.401644698012984,4,0,0,0
"1515","E1",10,"14.07.2020","No","Sheffield Weds","Huddersfield",0,0,13,12,4,1,13,16,1,1,0,0,2.56,3.19,2.85,2.22,1.66,1,1,0.370267045153723,0.297142205515213,0.332590749331063,1.40794334097638,1.2949144535084,0,1,3,0,0.113028887467979,-3,0,0,0
"1516","E1",10,"15.07.2020","No","Brentford","Preston",1,0,14,8,3,4,15,11,2,1,0,0,1.45,4.42,7.1,1.79,2.02,3,0,0.652622384893732,0.214095578754731,0.133282036351537,2.17196273343593,0.613941687809342,1,6,-1,3,1.55802104562659,4,1,0,0
"1517","E1",10,"15.07.2020","No","Bristol City","Stoke",1,1,8,10,1,3,10,9,1,0,0,0,2.89,3.12,2.55,2.27,1.63,1,1,0.32683846637335,0.302744605070186,0.370416928556463,1.28326000419024,1.41399539073958,0,-2,-2,0,-0.130735386549341,1,1,0,0
"1518","E1",10,"15.07.2020","No","Birmingham","Charlton",1,1,23,7,7,3,16,10,3,1,0,0,2.32,3.24,3.14,2.1,1.74,1,1,0.40734808930459,0.291681347897114,0.300970562798296,1.51372561581088,1.194593036292,0,16,4,0,0.319132579518883,6,2,0,0
"1519","E1",10,"15.07.2020","No","Nott'm Forest","Swansea",2,2,8,6,2,2,15,10,4,2,0,1,2.43,3.21,2.98,2.14,1.71,1,1,0.388735141725084,0.294276135324596,0.31698872295032,1.46048156049985,1.24524230417556,0,2,0,0,0.215239256324292,5,2,-1,0
"1520","E1",10,"16.07.2020","No","Leeds","Barnsley",1,0,7,12,3,3,9,15,1,1,0,0,1.29,5.38,10.11,1.65,2.23,3,0,0.731329135624191,0.175355870809518,0.0933149935662914,2.36934327768209,0.455300851508392,1,-5,0,3,1.9140424261737,-6,0,0,0
"1521","E1",10,"17.07.2020","No","Huddersfield","West Brom",2,1,7,13,4,4,19,17,4,6,0,0,5.3,3.74,1.67,2.09,1.74,3,0,0.178866398616218,0.253473773440095,0.567659827943687,0.79007296928875,1.95645325727115,1,-6,0,3,-1.1663802879824,2,-2,0,0
"1522","E1",10,"18.07.2020","No","Charlton","Wigan",2,2,15,16,4,6,13,19,1,3,0,0,3.79,3.37,2.01,2.06,1.76,1,1,0.249364045663546,0.28044205728927,0.470193897047184,1.02853419427991,1.69102374843082,0,-1,-2,0,-0.662489554150914,-6,-2,0,0
"1523","E1",10,"18.07.2020","No","Stoke","Brentford",1,0,6,14,2,3,14,6,2,0,0,0,4.89,3.95,1.67,1.89,1.91,3,0,0.193568928027513,0.239633432418871,0.566797639553616,0.82034021650141,1.94002635107972,1,-8,-1,3,-1.11968613457831,8,2,0,0
"1524","E1",10,"18.07.2020","No","Blackburn","Reading",4,3,17,13,5,3,15,13,1,0,0,0,2.12,3.33,3.53,2.04,1.79,3,0,0.446986664435834,0.284568086667858,0.268445248896308,1.62552807997536,1.08990383335678,1,4,2,3,0.535624246618577,2,1,0,0
"1525","E1",10,"18.07.2020","No","Fulham","Sheffield Weds",5,3,12,14,8,6,12,14,1,0,1,0,1.91,3.39,4.21,2.04,1.78,3,0,0.495760371544989,0.279322215236262,0.224917413218748,1.76660332987123,0.954074454892507,2,-2,2,3,0.812528874978724,-2,1,1,0
"1526","E1",10,"18.07.2020","No","Hull","Luton",0,1,8,16,2,4,25,11,1,2,0,0,2.58,3.48,2.62,1.82,1.99,0,3,0.366822768309757,0.271954810988268,0.361222420701975,1.37242311591754,1.35562207309419,-1,-8,-2,-3,0.0168010428233476,14,-1,0,0
"1527","E1",10,"18.07.2020","No","Middlesbrough","Cardiff",1,3,12,13,5,4,13,11,2,2,1,0,2.76,3.13,2.65,2.22,1.66,0,3,0.342079324295901,0.301641832286481,0.356278843417618,1.32787980517418,1.37047836253933,-2,-1,1,-3,-0.0425985573651499,2,0,1,0
"1528","E1",10,"18.07.2020","No","Preston","Birmingham",2,0,14,12,7,2,11,10,2,2,0,0,2,3.36,3.86,2,1.81,3,0,0.473177280952659,0.281653143424202,0.245169575623139,1.70118498628218,1.01716187029362,2,2,5,3,0.684023115988559,1,0,0,0
"1529","E1",10,"18.07.2020","No","QPR","Millwall",4,3,22,14,11,7,11,9,0,1,0,0,3.56,3.44,2.06,1.91,1.9,3,0,0.265742657426574,0.275012750127501,0.459244592445924,1.07224072240722,1.65274652746527,1,8,4,3,-0.58050580505805,2,-1,0,0
"1530","E1",10,"18.07.2020","No","Swansea","Bristol City",1,0,17,14,7,1,8,11,0,0,0,0,1.92,3.56,3.94,1.93,1.88,3,0,0.493428643795908,0.266118819125883,0.240452537078209,1.74640475051361,0.98747643036051,1,3,6,3,0.758928320153097,-3,0,0,0
"1531","E1",10,"19.07.2020","No","Derby","Leeds",1,3,10,23,2,8,8,10,1,0,0,0,4.33,3.78,1.78,1.83,1.97,0,3,0.218431851236235,0.250214263453148,0.531353885310617,0.905509817161853,1.844275919385,-2,-13,-6,-3,-0.938766102223146,-2,1,0,0
"1532","E1",10,"19.07.2020","No","Barnsley","Nott'm Forest",1,0,20,10,6,2,9,11,0,1,0,0,2.64,3.31,2.65,1.93,1.87,3,0,0.357934211761249,0.285482271616223,0.356583516622528,1.35928490689997,1.35523282148381,1,10,4,3,0.00405208541616497,-2,-1,0,0
"1533","E1",10,"22.07.2020","No","Birmingham","Derby",1,3,13,7,4,5,14,5,0,0,0,0,2.7,3.23,2.64,1.88,1.91,0,3,0.349816624412337,0.292416373347774,0.35776700223989,1.34186624658478,1.36571738006744,-2,6,-1,-3,-0.0238511334826592,9,0,0,0
"1534","E1",10,"22.07.2020","No","Brentford","Barnsley",1,2,12,11,3,3,11,17,3,3,0,0,1.36,4.86,8.29,1.64,2.24,0,3,0.692574269339595,0.193806791420134,0.113618939240271,2.27152959943892,0.534663609140948,-1,1,0,-3,1.73686599029797,-6,0,0,0
"1535","E1",10,"22.07.2020","No","Bristol City","Preston",1,1,13,22,6,6,10,11,0,0,0,0,2.68,3.29,2.61,1.88,1.91,1,1,0.351937997204792,0.286685055473812,0.361376947321396,1.34249904708819,1.370815897438,0,-9,0,0,-0.028316850349811,-1,0,0,0
"1536","E1",10,"22.07.2020","No","Cardiff","Hull",3,0,14,8,7,2,16,16,0,0,0,0,1.38,4.85,7.86,1.62,2.28,3,0,0.684880562262849,0.194873232149017,0.120246205588134,2.24951491893756,0.555611848913418,3,6,5,3,1.69390307002415,0,0,0,0
"1537","E1",10,"22.07.2020","No","Leeds","Charlton",4,0,21,10,8,4,14,10,1,0,0,0,1.68,3.99,4.64,1.64,2.25,3,0,0.560814249363868,0.236132315521628,0.203053435114504,1.91857506361323,0.84529262086514,4,11,4,3,1.07328244274809,4,1,0,0
"1538","E1",10,"22.07.2020","No","Luton","Blackburn",3,2,8,14,1,4,10,12,4,1,0,0,1.78,3.69,4.38,1.74,2.09,3,0,0.529442981249263,0.255395259247612,0.215161759503125,1.8437242029954,0.900880537756987,1,-6,-3,3,0.942843665238413,-2,3,0,0
"1539","E1",10,"22.07.2020","No","Millwall","Huddersfield",4,1,15,7,9,2,14,14,1,0,0,0,2.4,3.25,2.98,1.86,1.94,3,0,0.393107927101514,0.29029508462881,0.316596988269676,1.46961886593335,1.24008604943784,3,8,7,3,0.229532816495515,0,1,0,0
"1540","E1",10,"22.07.2020","No","Nott'm Forest","Stoke",1,4,16,10,5,4,9,13,0,1,0,0,2.16,3.26,3.44,2.06,1.76,0,3,0.436589012084216,0.289273701258253,0.274137286657531,1.5990407375109,1.11168556123085,-3,6,1,-3,0.487355176280055,-4,-1,0,0
"1541","E1",10,"22.07.2020","No","Reading","Swansea",1,4,19,20,6,8,17,10,1,0,1,0,3.78,3.57,1.94,1.82,1.98,0,3,0.249546004842615,0.264225181598063,0.486228813559322,1.01286319612591,1.72291162227603,-3,-1,-2,-3,-0.710048426150121,7,1,1,0
"1542","E1",10,"22.07.2020","No","Sheffield Weds","Middlesbrough",1,2,18,10,4,4,11,11,0,0,0,0,2.3,3.25,3.15,2.02,1.79,0,3,0.4101973354703,0.290293498948212,0.299509165581488,1.52088550535911,1.18882099569268,-1,8,0,-3,0.332064509666433,0,0,0,0
"1543","E1",10,"22.07.2020","No","West Brom","QPR",2,2,16,7,6,3,13,9,0,0,0,0,1.25,6.03,11.11,1.53,2.47,1,1,0.757685908912522,0.157065901515863,0.0852481895716158,2.43012362825343,0.41281047023071,0,9,3,0,2.01731315802272,4,0,0,0
"1544","E1",10,"22.07.2020","No","Wigan","Fulham",1,1,13,19,7,4,14,11,3,4,0,0,2.54,3.61,2.55,1.68,2.17,1,1,0.370414334517683,0.260623936198037,0.36896172928428,1.37186693975109,1.36750912405088,0,-6,3,0,0.00435781570020799,3,-1,0,0
"1545","S1",10,"16.08.2019","Yes","Ath Bilbao","Barcelona",1,0,11,11,5,2,14,9,1,1,0,0,5.07,3.81,1.71,1.79,2.05,3,0,0.188835268031825,0.251284726751011,0.559880005217165,0.817790530846485,1.9309247424025,1,0,3,3,-1.11313421155602,5,0,0,0
"1546","S1",10,"17.08.2019","Yes","Celta","Real Madrid",1,3,7,17,4,11,17,12,5,2,0,1,4.67,4.12,1.69,1.49,2.58,0,3,0.204214632429499,0.231476294525671,0.56430907304483,0.844120191814169,1.92440351366016,-2,-10,-7,-3,-1.08028332184599,5,3,-1,0
"1547","S1",10,"17.08.2019","Yes","Valencia","Sociedad",1,1,14,12,6,3,13,14,4,4,1,0,1.68,3.8,5.29,2.07,1.77,1,1,0.568283333144867,0.251241052548257,0.180475614306876,1.95609105198286,0.792667895468886,0,2,3,0,1.16342315651397,-1,0,1,0
"1548","S1",10,"17.08.2019","Yes","Mallorca","Eibar",2,1,16,11,4,5,13,14,2,3,0,0,2.91,3.09,2.62,2.34,1.6,3,0,0.327607347067607,0.308523423937455,0.363869228994938,1.29134546514028,1.40013111092227,1,5,-1,3,-0.108785645781992,-1,-1,0,0
"1549","S1",10,"17.08.2019","Yes","Leganes","Osasuna",0,1,13,4,2,2,17,11,1,4,1,0,2.06,3.18,4.02,2.59,1.49,0,3,0.462912266979533,0.299873984269761,0.237213748750706,1.68861078520836,1.01151523052188,-1,9,0,-3,0.677095554686482,6,-3,1,0
"1550","S1",10,"17.08.2019","Yes","Villarreal","Granada",4,4,12,14,7,7,10,16,3,1,0,0,1.61,3.95,5.8,1.84,1.98,1,1,0.59340801657709,0.24187010295927,0.164721880463641,2.02209415269054,0.736035744350191,0,-2,0,0,1.28605840834035,-6,2,0,0
"1551","S1",10,"18.08.2019","Yes","Alaves","Levante",1,0,9,16,2,4,18,15,2,1,0,0,2.23,3.25,3.43,2.13,1.72,3,0,0.428027292379406,0.293692572924946,0.278280134695648,1.57777445006316,1.12853297701189,1,-7,-2,3,0.449241473051271,3,1,0,0
"1552","S1",10,"18.08.2019","Yes","Espanol","Sevilla",0,2,7,12,2,4,11,17,2,2,0,0,3.08,3.41,2.33,1.92,1.89,0,3,0.310066537883666,0.280060098733634,0.4098733633827,1.21025971238463,1.50968018888173,-2,-5,-2,-3,-0.299420476497103,-6,0,0,0
"1553","S1",10,"18.08.2019","Yes","Betis","Valladolid",1,2,13,14,4,3,11,19,2,6,1,0,1.64,3.76,5.78,2.13,1.72,0,3,0.581426706333069,0.253601010209105,0.164972283457826,1.99788112920831,0.748517860582583,-1,-1,1,-3,1.24936326862573,-8,-4,1,0
"1554","S1",10,"18.08.2019","Yes","Ath Madrid","Getafe",1,0,5,6,5,0,19,22,3,4,1,1,1.47,4.23,7.63,2.23,1.66,3,0,0.649275484770394,0.225634742934392,0.125089772295214,2.17346119724557,0.600904059820033,1,-1,5,3,1.57255713742554,-3,-1,0,0
"1555","S1",10,"23.08.2019","Yes","Granada","Sevilla",0,1,12,11,0,6,13,14,1,1,0,0,3.95,3.58,1.94,1.89,1.93,0,3,0.241578896108413,0.266546547382188,0.491874556509399,0.991283235707428,1.74217021691038,-1,1,-6,-3,-0.750886981202955,-1,0,0,0
"1556","S1",10,"23.08.2019","Yes","Levante","Villarreal",2,1,16,23,4,6,5,9,1,2,0,0,2.59,3.54,2.63,1.7,2.17,3,0,0.368130325616338,0.26933828908088,0.362531385302782,1.37372926592989,1.35693244498923,1,-7,-2,3,0.0167968209406693,-4,-1,0,0
"1557","S1",10,"24.08.2019","Yes","Osasuna","Eibar",0,0,6,12,2,0,15,12,4,4,0,0,2.53,3.12,2.99,2.29,1.63,1,1,0.376357056694813,0.30518697225573,0.318455971049457,1.43425814234017,1.2605548854041,0,-6,2,0,0.173703256936068,3,0,0,0
"1558","S1",10,"24.08.2019","Yes","Real Madrid","Valladolid",1,1,22,9,4,2,12,11,2,2,0,0,1.21,6.97,13.16,1.36,3.1,1,1,0.790172506622445,0.137174854090841,0.0726526392867142,2.50769237395818,0.355132771950983,0,13,2,0,2.15255960200719,1,0,0,0
"1559","S1",10,"24.08.2019","Yes","Celta","Valencia",1,0,11,9,6,1,8,12,1,2,0,0,3.17,3.45,2.26,1.89,1.92,3,0,0.301069206917989,0.276634604617398,0.422296188464613,1.17984222537136,1.54352317001124,1,2,5,3,-0.363680944639872,-4,-1,0,0
"1560","S1",10,"24.08.2019","Yes","Getafe","Ath Bilbao",1,1,6,4,2,2,15,11,2,1,0,0,2.61,2.94,3.06,2.84,1.42,1,1,0.364870784056067,0.323915900131406,0.311213315812527,1.41852825229961,1.25755584756899,0,2,0,0,0.160972404730618,4,1,0,0
"1561","S1",10,"25.08.2019","Yes","Alaves","Espanol",0,0,10,5,2,1,13,10,3,1,0,0,2.52,3.18,2.97,2.47,1.55,1,1,0.37865338817926,0.300064949123187,0.321281662697554,1.43602511366097,1.26390993721585,0,5,1,0,0.172115176445118,3,2,0,0
"1562","S1",10,"25.08.2019","Yes","Mallorca","Sociedad",0,1,12,12,4,4,16,12,1,2,0,0,3.02,3.23,2.44,2.08,1.75,0,3,0.315190005039073,0.294697775609288,0.390112219351639,1.24026779072651,1.46503443366421,-1,0,0,-3,-0.224766642937699,4,-1,0,0
"1563","S1",10,"25.08.2019","Yes","Leganes","Ath Madrid",0,1,10,6,4,4,12,13,4,5,0,0,5.18,3.29,1.81,2.54,1.52,0,3,0.183947066836768,0.289618786083422,0.526434147079811,0.841459986593725,1.86892122732285,-1,4,0,-3,-1.02746124072913,-1,-1,0,0
"1564","S1",10,"25.08.2019","Yes","Barcelona","Betis",5,2,20,4,7,3,14,12,1,1,0,0,1.27,6.07,10.56,1.39,2.95,3,0,0.752167642775756,0.157372801701023,0.0904595555232207,2.41387573002829,0.428751468270685,3,16,4,3,1.98512426175761,2,0,0,0
"1565","S1",10,"30.08.2019","Yes","Sevilla","Celta",1,1,19,2,5,1,16,9,4,2,0,0,1.55,4.31,5.97,1.65,2.25,1,1,0.617565949112798,0.222094482859591,0.160339568027611,2.07479233019798,0.703113186942424,0,17,4,0,1.37167914325556,7,2,0,0
"1566","S1",10,"30.08.2019","Yes","Ath Bilbao","Sociedad",2,0,15,2,5,2,17,17,2,3,0,0,2.33,3.07,3.45,2.45,1.56,3,0,0.410792340719308,0.31177399149055,0.277433667790142,1.54415101364848,1.14407499486097,2,13,3,3,0.4000760187875,0,-1,0,0
"1567","S1",10,"31.08.2019","Yes","Osasuna","Barcelona",2,2,15,8,5,4,16,9,3,4,0,0,9.52,4.86,1.36,1.73,2.11,1,1,0.100413223140496,0.196694214876033,0.702892561983471,0.497933884297521,2.30537190082645,0,7,1,0,-1.80743801652893,7,-1,0,0
"1568","S1",10,"31.08.2019","Yes","Getafe","Alaves",1,1,15,5,1,1,11,17,3,1,0,0,1.77,3.34,5.55,2.74,1.45,1,1,0.540874116998276,0.28663089433741,0.172494988664315,1.90925324533224,0.804115860330354,0,10,0,0,1.10513738500188,-6,2,0,0
"1569","S1",10,"31.08.2019","Yes","Levante","Valladolid",2,0,16,15,3,4,9,10,2,2,0,0,2.01,3.56,3.74,1.85,1.96,3,0,0.475728363477851,0.268599441177101,0.255672195345048,1.69578453161065,1.03561602721225,2,1,-1,3,0.660168504398408,-1,0,0,0
"1570","S1",10,"31.08.2019","Yes","Betis","Leganes",2,1,17,19,5,7,14,15,4,2,0,0,1.95,3.24,4.49,2.42,1.56,3,0,0.491122881999656,0.295583216018311,0.213293901982033,1.76895186201728,0.93546492196441,1,-2,-2,3,0.833486940052868,-1,2,0,0
"1571","S1",10,"01.09.2019","Yes","Valencia","Mallorca",2,0,9,12,4,1,6,19,0,1,0,0,1.41,4.63,8.14,1.75,2.09,3,0,0.676702475495521,0.206080019535353,0.117217504969126,2.23618744602192,0.557732534442731,2,-3,3,3,1.67845491157919,-13,-1,0,0
"1572","S1",10,"01.09.2019","Yes","Ath Madrid","Eibar",3,2,7,6,3,2,9,15,0,3,0,0,1.42,4.16,9.92,2.27,1.64,3,0,0.673631424989553,0.229941496030088,0.0964270789803594,2.25083577099875,0.519222732971166,1,1,1,3,1.73161303802758,-6,-3,0,0
"1573","S1",10,"01.09.2019","Yes","Espanol","Granada",0,3,15,14,3,6,6,13,2,3,0,0,2.1,3.2,3.92,2.29,1.63,0,3,0.456211812627291,0.29938900203666,0.244399185336049,1.66802443991853,1.03258655804481,-3,1,-3,-3,0.635437881873727,-7,-1,0,0
"1574","S1",10,"01.09.2019","Yes","Villarreal","Real Madrid",2,2,10,17,5,5,8,14,1,4,0,1,3.71,4.14,1.88,1.41,2.88,1,1,0.258428682422785,0.231587055987569,0.509984261589646,1.00687310325593,1.76153984075651,0,-7,0,0,-0.754666737500581,-6,-3,-1,0
"1575","S1",10,"13.09.2019","Yes","Mallorca","Ath Bilbao",0,0,10,11,1,5,15,18,4,3,0,0,3.65,3.02,2.28,2.69,1.46,1,1,0.262502573330385,0.317263043925797,0.420234382743818,1.10477076391695,1.57796619215725,0,-1,-4,0,-0.4731954282403,-3,1,0,0
"1576","S1",10,"14.09.2019","Yes","Real Madrid","Levante",3,2,25,8,11,3,13,10,2,2,0,0,1.25,6.59,10.54,1.31,3.44,3,0,0.764364027727187,0.144985589477843,0.09065038279497,2.4380776726594,0.416936737862753,1,17,8,3,2.02114093479665,3,0,0,0
"1577","S1",10,"14.09.2019","Yes","Leganes","Villarreal",0,3,10,8,4,4,14,11,2,0,0,0,2.51,3.15,3.04,2.33,1.61,0,3,0.381317968056258,0.303843841213082,0.31483819073066,1.44779774538186,1.24835841340506,-3,2,0,-3,0.199439331976793,3,2,0,0
"1578","S1",10,"14.09.2019","Yes","Sociedad","Ath Madrid",2,0,14,12,5,2,13,10,1,3,0,0,3.73,3.15,2.17,2.46,1.55,3,0,0.256211791252329,0.303387295673392,0.440400913074279,1.07202266943038,1.62459003489623,2,2,3,3,-0.552567365465851,3,-2,0,0
"1579","S1",10,"14.09.2019","Yes","Barcelona","Valencia",5,2,17,9,10,3,11,11,1,4,0,0,1.47,4.59,6.69,1.53,2.47,3,0,0.649353862550673,0.207963001731915,0.142683135717412,2.15602458938393,0.636012408884152,3,8,7,3,1.52001218049978,0,-3,0,0
"1580","S1",10,"15.09.2019","Yes","Eibar","Espanol",1,2,11,7,1,2,14,16,2,4,0,1,1.97,3.34,4.21,2.2,1.68,0,3,0.485966773688521,0.286633097055805,0.227400129255674,1.74453341812137,0.968833484822826,-1,4,-1,-3,0.775699933298543,-2,-2,-1,0
"1581","S1",10,"15.09.2019","Yes","Alaves","Sevilla",0,1,7,19,0,7,13,7,5,5,0,0,4.23,3.37,1.95,2.27,1.64,0,3,0.226018139232539,0.283696358739953,0.490285502027508,0.96175077643757,1.75455286482248,-1,-12,-7,-3,-0.792802088384907,6,0,0,0
"1582","S1",10,"15.09.2019","Yes","Celta","Granada",0,2,4,13,0,3,11,13,4,2,2,0,1.84,3.64,4.4,1.99,1.83,0,3,0.519837972579975,0.262775238886581,0.217386788533444,1.82228915662651,0.914935604486913,-2,-9,-3,-3,0.907353552139593,-2,2,2,0
"1583","S1",10,"15.09.2019","Yes","Valladolid","Osasuna",1,1,11,17,1,5,9,10,0,1,0,0,2.23,3.05,3.73,2.53,1.52,1,1,0.429368317362309,0.313931589415721,0.25670009322197,1.60203654150265,1.08403186908163,0,-6,-4,0,0.518004672421016,-1,-1,0,0
"1584","S1",10,"15.09.2019","Yes","Betis","Getafe",1,1,7,12,2,4,11,28,3,6,2,0,2.22,3.22,3.51,2.38,1.58,1,1,0.430678128858201,0.296927157163108,0.272394713978691,1.58896154373771,1.11411129909918,0,-5,-2,0,0.474850244638529,-17,-3,2,0
"1585","S1",10,"20.09.2019","Yes","Osasuna","Betis",0,0,12,7,6,2,15,9,1,2,0,0,2.34,3.37,3.12,1.88,1.94,1,1,0.409104704097117,0.284066767830045,0.306828528072838,1.5113808801214,1.20455235204856,0,5,4,0,0.306828528072838,6,-1,0,0
"1586","S1",10,"21.09.2019","Yes","Villarreal","Valladolid",2,0,18,7,6,3,12,8,2,1,0,0,1.59,4.19,5.61,1.8,2.03,3,0,0.601360011666014,0.228201054546292,0.170438933787694,2.03228108954433,0.739517855909373,2,11,3,3,1.29276323363496,4,1,0,0
"1587","S1",10,"21.09.2019","Yes","Levante","Eibar",0,0,13,18,4,4,9,11,0,2,0,0,2.26,3.51,3.12,1.76,2.08,1,1,0.422255639097744,0.27187969924812,0.305864661654135,1.53864661654135,1.18947368421053,0,-5,0,0,0.349172932330827,-2,-2,0,0
"1588","S1",10,"21.09.2019","Yes","Ath Madrid","Celta",0,0,20,6,5,3,14,12,3,5,0,0,1.42,4.35,8.61,2,1.82,1,1,0.670528334112112,0.218885111365333,0.110586554522555,2.23047011370167,0.550644774932998,0,14,2,0,1.67982533876867,2,-2,0,0
"1589","S1",10,"21.09.2019","Yes","Granada","Barcelona",2,0,9,8,4,1,22,12,3,2,0,0,9.24,5.44,1.32,1.55,2.46,3,0,0.103108415466262,0.175132676269901,0.721758908263836,0.484457922668688,2.34040940106141,2,1,3,3,-1.85595147839272,10,1,0,0
"1590","S1",10,"22.09.2019","Yes","Getafe","Mallorca",4,2,14,7,5,3,15,17,4,5,0,0,1.85,3.23,5.06,2.67,1.47,3,0,0.51589789238107,0.295483312973678,0.188618794645253,1.84317699011689,0.861339696909436,2,7,2,3,0.98183729320745,-2,-1,0,0
"1591","S1",10,"22.09.2019","Yes","Espanol","Sociedad",1,3,17,10,3,5,7,12,1,0,0,0,2.94,3.25,2.5,2.32,1.61,0,3,0.324610467439073,0.293647622852577,0.38174190970835,1.2674790251698,1.43887335197763,-2,7,-2,-3,-0.171394326807831,-5,1,0,0
"1592","S1",10,"22.09.2019","Yes","Valencia","Leganes",1,1,13,13,4,4,14,23,3,4,0,0,1.59,3.9,6.16,2.16,1.7,1,1,0.600308850207649,0.244741300469272,0.154949849323078,2.04566785109222,0.709590848438507,0,0,0,0,1.33607700265371,-9,-1,0,0
"1593","S1",10,"22.09.2019","Yes","Ath Bilbao","Alaves",2,0,13,5,4,1,11,19,1,4,0,0,1.65,3.61,6.16,2.53,1.52,3,0,0.579736743999312,0.26497662814373,0.155286627856958,2.00418686014166,0.730836511714605,2,8,3,3,1.27335034842706,-8,-3,0,0
"1594","S1",10,"22.09.2019","Yes","Sevilla","Real Madrid",0,1,9,7,0,4,16,15,3,2,0,0,2.61,3.77,2.5,1.52,2.51,0,3,0.365455976610818,0.253007983807489,0.381536039581694,1.34937591363994,1.39761610255257,-1,2,-4,-3,-0.0482401889126278,1,1,0,0
"1595","S1",10,"24.09.2019","Yes","Valladolid","Granada",1,1,9,6,5,4,21,18,3,2,0,0,2.36,3.17,3.27,2.4,1.58,1,1,0.405483428061789,0.301874097863036,0.292642474075175,1.5183243820484,1.17980152008856,0,3,1,0,0.338522861959843,3,1,0,0
"1596","S1",10,"24.09.2019","Yes","Betis","Levante",3,1,17,17,5,3,11,11,2,2,0,0,1.97,3.67,3.77,1.63,2.29,3,0,0.485594555798503,0.260659747935436,0.253745696266061,1.71744341533094,1.02189683673362,2,0,2,3,0.695546578597324,0,0,0,0
"1597","S1",10,"24.09.2019","Yes","Barcelona","Villarreal",2,1,8,11,4,3,4,13,4,2,0,0,1.31,6.06,8.84,1.31,3.44,3,0,0.732943491121832,0.15844157976396,0.108614929114208,2.35727205312945,0.484286367106585,1,-3,1,3,1.87298568602287,-9,2,0,0
"1598","S1",10,"25.09.2019","Yes","Leganes","Ath Bilbao",1,1,7,9,3,2,11,12,0,1,0,0,2.86,2.94,2.79,2.98,1.39,1,1,0.333569197735702,0.324492484872145,0.341938317392153,1.32520007807925,1.3503074370486,0,-2,1,0,-0.025107358969354,-1,-1,0,0
"1599","S1",10,"25.09.2019","Yes","Mallorca","Ath Madrid",0,2,9,13,3,3,8,15,3,5,0,1,6.33,3.65,1.63,2.47,1.54,0,3,0.151110309637076,0.262062536987039,0.586827153375885,0.715393465898268,2.02254399711469,-2,-4,0,-3,-1.30715053121643,-7,-2,-1,0
"1600","S1",10,"25.09.2019","Yes","Valencia","Getafe",3,3,8,18,4,5,14,26,1,4,0,0,1.93,3.31,4.46,2.35,1.6,1,1,0.496076777547406,0.28925322678746,0.214669995665133,1.77748355942968,0.93326321378286,0,-10,-1,0,0.844220345646819,-12,-3,0,0
"1601","S1",10,"25.09.2019","Yes","Real Madrid","Osasuna",2,0,15,4,4,0,13,13,2,2,0,0,1.24,6.45,11.19,1.43,2.79,3,0,0.767423611709203,0.147535702096033,0.0850406861947642,2.44980653722364,0.402657760680325,2,11,4,3,2.04714877654332,0,0,0,0
"1602","S1",10,"26.09.2019","Yes","Eibar","Sevilla",3,2,11,7,4,4,11,19,3,4,0,0,3.25,3.34,2.27,2.02,1.81,3,0,0.293705426837063,0.285791208748639,0.420503364414297,1.16690748925983,1.54730130199153,1,4,0,3,-0.380393812731703,-8,-1,0,0
"1603","S1",10,"26.09.2019","Yes","Celta","Espanol",1,1,14,10,3,4,5,17,2,5,0,0,1.85,3.64,4.33,2.05,1.78,1,1,0.516664098840544,0.262590270015112,0.220745631144344,1.81258256653675,0.924827163448142,0,4,-1,0,0.887755403088603,-12,-3,0,0
"1604","S1",10,"26.09.2019","Yes","Sociedad","Alaves",3,0,21,5,7,0,7,20,1,4,0,1,1.65,3.83,5.55,2.26,1.65,3,0,0.578667973375801,0.249295602107068,0.17203642451713,1.98529952223447,0.765404875658459,3,16,7,3,1.21989464657601,-13,-3,-1,0
"1605","S1",10,"27.09.2019","Yes","Villarreal","Betis",5,1,17,11,10,6,13,8,2,2,0,0,1.87,3.82,4.04,1.64,2.27,3,0,0.512190103215957,0.250731804453885,0.237078092330158,1.78730211410176,0.96196608144436,4,6,4,3,0.825336032657396,5,0,0,0
"1606","S1",10,"28.09.2019","Yes","Ath Bilbao","Valencia",0,1,14,10,3,6,14,12,2,5,0,0,2.16,3.21,3.69,2.45,1.56,0,3,0.442818209346926,0.297971131523165,0.259210659129908,1.62642575956394,1.07560310891289,-1,4,-3,-3,0.550822650651055,2,-3,0,0
"1607","S1",10,"28.09.2019","Yes","Getafe","Barcelona",0,2,8,10,1,6,23,17,4,4,0,1,4.38,3.44,1.89,1.96,1.86,0,3,0.217830937782692,0.277354507990753,0.504814554226555,0.930847321338828,1.79179817067042,-2,-2,-5,-3,-0.860950849331591,6,0,-1,0
"1608","S1",10,"28.09.2019","Yes","Granada","Leganes",1,0,11,15,4,6,19,12,3,4,0,0,2.36,3.07,3.35,2.76,1.44,3,0,0.404333279603078,0.310822977154157,0.284843743242765,1.52382281596339,1.16535420688245,1,-4,-2,3,0.358468609080938,7,-1,0,0
"1609","S1",10,"28.09.2019","Yes","Ath Madrid","Real Madrid",0,0,7,14,1,3,14,14,1,2,0,0,2.41,3.33,3,1.98,1.84,1,1,0.395717222611734,0.286389941890174,0.317892835498093,1.47354160972537,1.24006844838445,0,-7,-2,0,0.233473161340923,0,-1,0,0
"1610","S1",10,"29.09.2019","Yes","Espanol","Valladolid",0,2,16,9,2,6,16,13,2,0,1,0,2.03,3.26,4.08,2.33,1.61,0,3,0.471642849544342,0.293691713059821,0.234665437395837,1.70862026169285,0.997688025247332,-2,7,-4,-3,0.710932236445516,3,2,1,0
"1611","S1",10,"29.09.2019","Yes","Eibar","Celta",2,0,7,3,3,2,17,15,3,1,0,0,2.36,3.3,3.13,2.03,1.8,3,0,0.404998470816114,0.28963527003819,0.305366259145696,1.50463068248653,1.20573404747528,2,4,1,3,0.298896635011253,2,2,0,0
"1612","S1",10,"29.09.2019","Yes","Alaves","Mallorca",2,0,11,5,6,1,16,14,2,3,0,0,2.25,3.13,3.52,2.59,1.5,3,0,0.424078429259318,0.304848711128902,0.27107285961178,1.57708399890686,1.11806728996424,2,6,5,3,0.459016708942614,2,-1,0,0
"1613","S1",10,"29.09.2019","Yes","Levante","Osasuna",1,1,10,18,5,3,12,12,6,0,1,0,2.15,3.45,3.41,1.9,1.91,1,1,0.443717351537896,0.276519508929413,0.279763139532691,1.6076715635431,1.11580892752749,0,-8,2,0,0.491862636015615,0,6,1,0
"1614","S1",10,"29.09.2019","Yes","Sevilla","Sociedad",3,2,21,5,8,2,9,8,1,1,0,0,1.87,3.56,4.33,1.87,1.94,3,0,0.510946630824254,0.268390505517235,0.220662863658512,1.80123039799,0.930379096492769,1,16,6,3,0.870851301497227,1,0,0,0
"1615","S1",10,"04.10.2019","Yes","Betis","Eibar",1,1,12,8,3,2,7,20,3,6,0,1,2.02,3.62,3.68,1.84,1.99,1,1,0.474625546893927,0.264846299647993,0.26052815345808,1.68872294032978,1.04643076002223,0,4,1,0,0.642292180307543,-13,-3,-1,0
"1616","S1",10,"05.10.2019","Yes","Leganes","Levante",1,2,25,9,10,2,10,7,3,5,0,0,1.98,3.44,4,2.1,1.74,0,3,0.482956140843489,0.277980569438985,0.239063289717527,1.72684899196945,0.995170438591565,-1,16,8,-3,0.731678553377885,3,-2,0,0
"1617","S1",10,"05.10.2019","Yes","Real Madrid","Granada",4,2,17,8,10,5,12,18,4,5,0,0,1.3,5.78,9.42,1.45,2.73,3,0,0.733719996334607,0.165023528587368,0.101256475078024,2.36618351759119,0.468792953821441,2,9,5,3,1.89739056376975,-6,-1,0,0
"1618","S1",10,"05.10.2019","Yes","Valencia","Alaves",2,1,11,10,3,4,7,16,1,3,0,0,1.52,4.1,6.81,2.11,1.74,3,0,0.627378988949358,0.232589283708055,0.140031727342588,2.11472625055613,0.652684465735818,1,1,-1,3,1.46204178482031,-9,-2,0,0
"1619","S1",10,"05.10.2019","Yes","Osasuna","Villarreal",2,1,16,16,4,5,9,15,2,2,0,0,2.99,3.28,2.45,2.05,1.78,3,0,0.319285461704419,0.291055954419577,0.389658583876005,1.24891233953283,1.46003170604759,1,0,-1,3,-0.211119366514758,-6,0,0,0
"1620","S1",10,"06.10.2019","Yes","Mallorca","Espanol",2,0,9,11,3,3,11,11,1,3,0,0,2.49,3.13,3.06,2.41,1.57,3,0,0.383251503547291,0.304886978860305,0.311861517592404,1.45464148950218,1.24047153163752,2,-2,0,3,0.214169957864662,0,-2,0,0
"1621","S1",10,"06.10.2019","Yes","Celta","Ath Bilbao",1,0,13,6,2,2,8,20,0,5,0,0,2.7,3.04,2.87,2.5,1.53,3,0,0.353491236457633,0.313956032380134,0.332552731162233,1.37442974175303,1.31161422586683,1,7,0,3,0.0628155158861996,-12,-5,0,0
"1622","S1",10,"06.10.2019","Yes","Valladolid","Ath Madrid",0,0,5,9,1,1,15,14,6,4,0,0,5.36,3.52,1.74,2.32,1.61,1,1,0.178469858734673,0.27176092125507,0.549769220010257,0.807170497459089,1.92106858128584,0,-4,0,0,-1.11389808382675,1,2,0,0
"1623","S1",10,"06.10.2019","Yes","Sociedad","Getafe",1,2,6,13,3,4,20,15,2,4,1,0,1.9,3.36,4.46,2.44,1.56,0,3,0.502137811792143,0.283946976906271,0.213915211301586,1.7903604122827,0.925692610811028,-1,-7,-1,-3,0.864667801471672,5,-2,1,0
"1624","S1",10,"06.10.2019","Yes","Barcelona","Sevilla",4,0,15,16,8,4,10,12,5,3,2,0,1.51,4.46,6.19,1.55,2.44,3,0,0.631908791477927,0.213942214155083,0.15414899436699,2.10966858858886,0.676389197256054,4,-1,4,3,1.43327939133281,-2,2,2,0
"1625","S1",10,"18.10.2019","Yes","Granada","Osasuna",1,0,6,9,2,4,12,17,2,8,0,1,2.4,3.01,3.38,2.62,1.48,3,0,0.398819277297352,0.317995437047723,0.283185285654925,1.51445326893978,1.1675512940125,1,-3,-2,3,0.346901974927283,-5,-6,-1,0
"1626","S1",10,"19.10.2019","Yes","Eibar","Barcelona",0,3,5,9,0,4,16,14,5,0,0,0,5.8,4.5,1.53,1.54,2.45,0,3,0.164480756826489,0.211997419909697,0.623521823263814,0.705439690389164,2.08256288970114,-3,-4,-4,-3,-1.37712319931198,2,5,0,0
"1627","S1",10,"19.10.2019","Yes","Ath Madrid","Valencia",1,1,15,11,4,3,18,12,2,1,0,1,1.61,3.87,5.95,2.09,1.74,1,1,0.592905679421784,0.246661019087616,0.1604333014906,2.02537805735297,0.727960923559417,0,4,1,0,1.29741713379355,6,1,-1,0
"1628","S1",10,"19.10.2019","Yes","Getafe","Leganes",2,0,5,7,2,3,17,19,1,4,0,0,1.84,3.21,5.17,2.85,1.42,3,0,0.518374256986591,0.297136645749323,0.184489097264086,1.85225941670909,0.850603937541582,2,-2,-1,3,1.00165547916751,-2,-3,0,0
"1629","S1",10,"19.10.2019","Yes","Mallorca","Real Madrid",1,0,5,13,1,4,20,14,2,2,0,1,6.26,4.34,1.52,1.6,2.33,3,0,0.15242003308657,0.219850093806896,0.627729873106533,0.677110193066607,2.1030397131265,1,-8,-3,3,-1.42592952005989,6,0,-1,0
"1630","S1",10,"20.10.2019","Yes","Alaves","Celta",2,0,12,14,5,2,20,5,5,1,0,0,2.96,3,2.65,2.66,1.47,3,0,0.322201507659885,0.317905487557753,0.359893004782362,1.28451001053741,1.39758450190484,2,-2,3,3,-0.113074491367431,15,4,0,0
"1631","S1",10,"20.10.2019","Yes","Sociedad","Betis",3,1,18,12,6,5,23,12,4,2,0,0,1.76,3.88,4.5,1.65,2.25,3,0,0.542087876605151,0.245895531655945,0.212016591738904,1.8721591614714,0.881945306872656,2,6,1,3,0.990213854598743,11,2,0,0
"1632","S1",10,"20.10.2019","Yes","Espanol","Villarreal",0,1,18,11,3,5,11,14,2,1,0,0,3.04,3.4,2.36,1.97,1.85,0,3,0.314242747039288,0.280969985588069,0.404787267372642,1.22369822670593,1.495331787706,-1,7,-2,-3,-0.271633561000063,-3,1,0,0
"1633","S1",10,"20.10.2019","Yes","Ath Bilbao","Valladolid",1,1,19,9,7,3,12,9,2,3,0,0,1.69,3.46,6.03,2.57,1.5,1,1,0.565385522154686,0.276156512266306,0.158457965579008,1.97231307873036,0.75153040900333,0,10,4,0,1.22078266972703,3,-1,0,0
"1634","S1",10,"20.10.2019","Yes","Sevilla","Levante",1,0,19,12,5,5,10,11,2,2,0,0,1.33,5.53,8.64,1.44,2.76,3,0,0.71713298101472,0.172475020750376,0.110391998234905,2.32387396379453,0.50365101545509,1,7,0,3,1.82022294833944,-1,0,0,0
"1635","S1",10,"25.10.2019","Yes","Villarreal","Alaves",4,1,19,12,8,3,12,13,2,2,0,0,1.52,4.25,6.58,1.88,1.93,3,0,0.629465230289961,0.22512638824488,0.145408381465158,2.11352207911476,0.661351532640355,3,7,5,3,1.45217054647441,-1,0,0,0
"1636","S1",10,"26.10.2019","Yes","Leganes","Mallorca",1,0,9,9,3,1,19,13,4,1,0,0,1.85,3.39,4.79,2.57,1.51,3,0,0.517613344766361,0.28247335923828,0.199913295995359,1.83531339353736,0.882213247224356,1,0,2,3,0.953100146313008,6,3,0,0
"1637","S1",10,"26.10.2019","Yes","Valladolid","Eibar",2,0,8,13,4,3,13,13,1,2,0,0,2.42,3.12,3.17,2.43,1.56,3,0,0.393848408343355,0.305484983394525,0.30066660826212,1.48703020842459,1.20748480818088,2,-5,1,3,0.279545400243706,0,-1,0,0
"1638","S1",10,"26.10.2019","Yes","Ath Madrid","Ath Bilbao",2,0,9,9,2,2,14,9,2,2,0,0,1.74,3.37,5.73,2.7,1.46,3,0,0.549454958300255,0.283694844938411,0.166850196761334,1.93205971983918,0.784245435222413,2,0,0,3,1.14781428461676,5,0,0,0
"1639","S1",10,"27.10.2019","Yes","Celta","Sociedad",0,1,9,9,1,4,20,12,5,2,1,0,2.84,3.29,2.54,1.95,1.86,0,3,0.335420529987397,0.289542341995199,0.375037128017404,1.29580393195739,1.41465372604741,-1,0,-3,-3,-0.118849794090022,8,3,1,0
"1640","S1",10,"27.10.2019","Yes","Granada","Betis",1,0,13,12,3,0,13,8,3,4,0,0,2.5,3.33,2.87,2.04,1.79,3,0,0.381412853043648,0.286345985768505,0.332241161187847,1.43058454489945,1.28306946933205,1,1,3,3,0.147515075567404,5,-1,0,0
"1641","S1",10,"27.10.2019","Yes","Levante","Espanol",0,1,7,14,3,3,10,26,2,3,0,0,2.19,3.4,3.38,1.9,1.91,0,3,0.436291296193651,0.281022923136499,0.282685780669851,1.58989681171745,1.12908026514605,-1,-7,0,-3,0.4608165465714,-16,-1,0,0
"1642","S1",10,"27.10.2019","Yes","Sevilla","Getafe",2,0,15,9,8,4,13,18,2,3,0,0,1.73,3.62,5.22,2.2,1.68,3,0,0.552694386597094,0.264132952710766,0.18317266069214,1.92221611250205,0.813650934787187,2,6,4,3,1.10856517771486,-5,-1,0,0
"1643","S1",10,"27.10.2019","Yes","Osasuna","Valencia",3,1,21,2,13,1,8,6,1,1,0,1,2.78,3.17,2.68,2.22,1.66,3,0,0.343137334098051,0.300921699934568,0.355940965967381,1.33033370222872,1.36874459783671,2,19,12,3,-0.0384108956079907,2,0,-1,0
"1644","S1",10,"29.10.2019","Yes","Alaves","Ath Madrid",1,1,11,9,3,3,23,16,3,3,0,0,6.12,3.45,1.69,2.71,1.46,1,1,0.156366913131281,0.277381306772011,0.566251780096709,0.746482046165853,1.97613664706214,0,2,0,0,-1.22965460089628,7,0,0,0
"1645","S1",10,"29.10.2019","Yes","Barcelona","Valladolid",5,1,18,9,9,1,9,14,0,3,0,0,1.13,9.03,19.44,1.34,3.22,3,0,0.845118511339855,0.105756801529794,0.0491246871303516,2.64111233554936,0.253130862920848,4,9,8,3,2.38798147262851,-5,-3,0,0
"1646","S1",10,"30.10.2019","Yes","Sociedad","Levante",1,2,17,13,5,4,15,12,3,4,0,0,1.5,4.55,6.21,1.51,2.53,0,3,0.636449640166233,0.209818562692165,0.153731797141602,2.11916748319086,0.671013954116971,-1,4,1,-3,1.44815352907389,3,-1,0,0
"1647","S1",10,"30.10.2019","Yes","Valencia","Sevilla",1,1,10,10,3,1,12,17,6,3,0,0,2.84,3.38,2.5,1.95,1.86,1,1,0.335994783134255,0.282315143225232,0.381690073640513,1.290299492628,1.42738536414677,0,0,2,0,-0.137085871518776,-5,3,0,0
"1648","S1",10,"30.10.2019","Yes","Ath Bilbao","Espanol",3,0,7,12,5,5,13,20,0,1,0,0,1.91,3.19,4.76,2.66,1.47,3,0,0.499998353578826,0.299372054964125,0.20062959145705,1.7993671157006,0.901260829335274,3,-5,0,3,0.898106286365328,-7,-1,0,0
"1649","S1",10,"30.10.2019","Yes","Betis","Celta",2,1,11,18,7,5,16,17,6,1,0,0,2.07,3.47,3.63,1.88,1.93,3,0,0.461512250348989,0.275311342427207,0.263176407223804,1.65984809347417,1.06484056409862,1,-7,2,3,0.595007529375557,-1,5,0,0
"1650","S1",10,"30.10.2019","Yes","Real Madrid","Leganes",5,0,22,5,11,3,12,12,1,5,0,0,1.27,5.87,11.5,1.58,2.38,3,0,0.753699272817811,0.163066111836222,0.083234615345967,2.42416393028966,0.412769957874123,5,17,8,3,2.01139397241553,0,-4,0,0
"1651","S1",10,"31.10.2019","Yes","Eibar","Villarreal",2,1,25,9,8,2,11,12,0,3,0,0,2.73,3.42,2.56,1.85,1.96,3,0,0.349082557833545,0.278653620726777,0.372263821439679,1.32590129422741,1.39544508504581,1,16,6,3,-0.0695437908184016,-1,-3,0,0
"1652","S1",10,"31.10.2019","Yes","Mallorca","Osasuna",2,2,11,12,3,4,9,10,1,5,0,0,2.53,3.01,3.1,2.59,1.49,1,1,0.37641240373871,0.316386505468085,0.307201090793205,1.44562371668421,1.2379897778477,0,-1,-1,0,0.207633938836514,-1,-4,0,0
"1653","S1",10,"31.10.2019","Yes","Getafe","Granada",3,1,8,10,3,2,22,11,5,5,0,0,1.92,3.25,4.57,2.62,1.49,3,0,0.497289641710388,0.293783419102753,0.208926939186859,1.78565234423392,0.92056423666333,2,-2,1,3,0.865088107570588,11,0,0,0
"1654","S1",10,"02.11.2019","Yes","Espanol","Valencia",1,2,13,11,4,4,20,14,0,1,0,0,2.77,3.21,2.68,2.14,1.72,0,3,0.345243016120812,0.297919985873722,0.356836998005466,1.33364903423616,1.36843097989012,-1,2,0,-3,-0.0347819456539622,6,-1,0,0
"1655","S1",10,"02.11.2019","Yes","Levante","Barcelona",3,1,9,9,3,6,9,13,1,6,0,0,8.36,5.92,1.32,1.37,3.06,3,0,0.114344578933814,0.161473087818697,0.724182333247489,0.504506824620139,2.33402008756116,2,0,-3,3,-1.82951326294102,-4,-5,0,0
"1656","S1",10,"02.11.2019","Yes","Sevilla","Ath Madrid",1,1,11,14,4,5,13,16,4,3,0,0,2.39,3.14,3.24,2.49,1.54,1,1,0.400191961230125,0.304604709343949,0.295203329425926,1.50518059303432,1.19021469762173,0,-3,-1,0,0.314965895412599,-3,1,0,0
"1657","S1",10,"02.11.2019","Yes","Real Madrid","Betis",0,0,22,13,7,3,11,17,2,4,0,0,1.28,6.27,9.58,1.34,3.24,1,1,0.747519121493978,0.152603584611211,0.0998772938948113,2.39516094909315,0.452235466295645,0,9,4,0,1.9429254827975,-6,-2,0,0
"1658","S1",10,"03.11.2019","Yes","Valladolid","Mallorca",3,0,12,14,6,1,15,20,5,4,0,0,2.07,3.29,3.86,2.47,1.54,3,0,0.461798042901974,0.290553783831941,0.247648173266085,1.67594791253786,1.0334983036302,3,-2,5,3,0.642449608907669,-5,1,0,0
"1659","S1",10,"03.11.2019","Yes","Villarreal","Ath Bilbao",0,0,11,12,7,2,10,8,2,0,0,0,1.88,3.5,4.36,2.07,1.76,1,1,0.508043466680871,0.272891919245725,0.219064614073403,1.79702231928834,0.930085761465935,0,-1,5,0,0.866936557822404,2,2,0,0
"1660","S1",10,"03.11.2019","Yes","Osasuna","Alaves",4,2,19,11,6,3,13,17,4,2,0,0,2.08,3.04,4.25,2.65,1.47,3,0,0.460061531449407,0.314778942570647,0.225159525979945,1.69496353691887,0.990257520510483,2,8,3,3,0.704706016408386,-4,2,0,0
"1661","S1",10,"03.11.2019","Yes","Celta","Getafe",0,1,6,9,2,5,6,19,3,3,0,0,2.57,3.05,3.02,2.41,1.56,0,3,0.371248120785622,0.312822187022639,0.315929692191738,1.42656654937951,1.26061126359785,-1,-3,-3,-3,0.165955285781652,-13,0,0,0
"1662","S1",10,"03.11.2019","Yes","Leganes","Eibar",1,2,12,7,5,4,16,20,5,2,0,0,2.32,3.17,3.32,2.51,1.52,0,3,0.411411505324222,0.301096117461261,0.287492377214517,1.53533063343393,1.16357324910481,-1,5,1,-3,0.371757384329117,-4,3,0,0
"1663","S1",10,"03.11.2019","Yes","Granada","Sociedad",1,2,5,9,3,5,15,19,0,2,0,0,3.05,3.17,2.47,2.36,1.59,0,3,0.312796871192359,0.300955980169304,0.386247148638337,1.23934659374638,1.45969742608432,-1,-4,-2,-3,-0.220350832337937,-4,-2,0,0
"1664","S1",10,"08.11.2019","Yes","Sociedad","Leganes",1,1,11,6,5,2,14,23,2,6,0,1,1.84,3.34,4.95,2.29,1.63,1,1,0.520124832476578,0.28653583585536,0.193339331668061,1.84691033328509,0.866553830859545,0,5,3,0,0.98035650242555,-9,-4,-1,0
"1665","S1",10,"09.11.2019","Yes","Alaves","Valladolid",3,0,14,7,5,1,21,16,3,3,0,0,2.4,3.02,3.34,2.65,1.47,3,0,0.397888824021333,0.31620303895735,0.285908137021317,1.50986951102135,1.1739274500213,3,7,4,3,0.335942061000047,5,0,0,0
"1666","S1",10,"09.11.2019","Yes","Valencia","Granada",2,0,12,13,4,1,11,15,0,5,0,0,1.67,3.63,5.87,2.27,1.64,3,0,0.573212887814038,0.263709510371747,0.163077601814215,1.98334817381386,0.752942315814393,2,-1,3,3,1.23040585799947,-4,-5,0,0
"1667","S1",10,"09.11.2019","Yes","Eibar","Real Madrid",0,4,14,10,1,5,9,8,0,0,0,0,5.48,4.13,1.6,1.62,2.29,0,3,0.173856305448269,0.230685848391408,0.595457846160322,0.752254764736216,2.01705938687238,-4,4,-4,-3,-1.26480462213616,1,0,0,0
"1668","S1",10,"09.11.2019","Yes","Barcelona","Celta",4,1,10,6,7,5,18,14,4,1,0,0,1.21,6.93,13.22,1.41,2.86,3,0,0.789807588358574,0.137902912253084,0.0722894993883415,2.50732567732881,0.354771410418109,3,4,2,3,2.1525542669107,4,3,0,0
"1669","S1",10,"10.11.2019","Yes","Mallorca","Villarreal",3,1,5,22,3,6,18,17,2,3,0,0,3.35,3.45,2.17,1.93,1.89,3,0,0.284511752522469,0.27626503505805,0.439223212419481,1.12980029262546,1.59393467231649,2,-17,-3,3,-0.464134379691033,1,-1,0,0
"1670","S1",10,"10.11.2019","Yes","Ath Bilbao","Levante",2,1,23,8,10,2,13,13,3,2,0,0,1.69,3.77,5.18,1.94,1.88,3,0,0.563529279363769,0.252616573507897,0.183854147128334,1.9432044115992,0.804179014892899,1,15,8,3,1.13902539670631,0,1,0,0
"1671","S1",10,"10.11.2019","Yes","Ath Madrid","Espanol",3,1,18,10,5,1,12,15,2,2,0,0,1.46,4.02,8.64,2.38,1.58,3,0,0.652670981126119,0.237039709563217,0.110289309310664,2.19505265294157,0.567907637495208,2,8,4,3,1.62714501544637,-3,0,0,0
"1672","S1",10,"10.11.2019","Yes","Getafe","Osasuna",0,0,14,4,5,1,15,16,2,4,0,0,1.95,3.26,4.35,2.52,1.52,1,1,0.488654571768233,0.292293378818421,0.219052049413346,1.75825709412312,0.949449527058459,0,10,4,0,0.808807567064661,-1,-2,0,0
"1673","S1",10,"10.11.2019","Yes","Betis","Sevilla",1,2,18,10,5,6,12,21,2,3,0,0,3.4,3.44,2.15,1.8,2.02,0,3,0.280130293159609,0.276872964169381,0.44299674267101,1.11726384364821,1.60586319218241,-1,8,-1,-3,-0.488599348534202,-9,-1,0,0
"1674","S1",10,"22.11.2019","Yes","Levante","Mallorca",2,1,13,14,6,7,13,9,2,1,1,0,1.77,3.77,4.64,1.84,1.98,3,0,0.54025974025974,0.253649798477385,0.206090461262875,1.87442901925661,0.87192118226601,1,-1,-1,3,1.0025078369906,4,1,1,0
"1675","S1",10,"23.11.2019","Yes","Leganes","Barcelona",1,2,9,11,4,6,11,10,1,2,0,0,6.98,4.46,1.47,1.72,2.11,0,3,0.136736770974981,0.213996112422728,0.649267116602291,0.624206425347671,2.1617974622296,-1,-2,-2,-3,-1.53759103688193,1,-1,0,0
"1676","S1",10,"23.11.2019","Yes","Betis","Valencia",2,1,25,9,8,3,9,13,2,2,0,0,2.41,3.4,2.93,1.78,2.04,3,0,0.395046257926106,0.280018082824093,0.324935659249801,1.46515685660241,1.2548250605735,1,16,5,3,0.210331796028917,-4,0,0,0
"1677","S1",10,"23.11.2019","Yes","Granada","Ath Madrid",1,1,9,17,3,6,15,17,4,3,0,0,4.89,3.1,1.92,2.76,1.44,1,1,0.195148820648004,0.30783152676411,0.497019652587886,0.893277988708123,1.79889048452777,0,-8,-3,0,-0.905612495819645,-2,1,0,0
"1678","S1",10,"23.11.2019","Yes","Real Madrid","Sociedad",3,1,18,11,10,6,13,16,1,1,0,0,1.37,5.4,7.42,1.4,2.91,3,0,0.695245994371124,0.176386483757119,0.128367521871757,2.26212446687049,0.561489049372391,2,7,4,3,1.7006354174981,-3,0,0,0
"1679","S1",10,"24.11.2019","Yes","Espanol","Getafe",1,1,6,11,2,2,23,12,3,4,0,0,2.77,2.94,2.85,2.74,1.45,1,1,0.343158334459584,0.323315845732329,0.333525819808087,1.35279084911108,1.32389330515659,0,-5,0,0,0.0288975439544914,11,-1,0,0
"1680","S1",10,"24.11.2019","Yes","Osasuna","Ath Bilbao",1,2,12,6,7,4,15,18,4,3,0,0,2.61,2.98,3.01,2.58,1.5,0,3,0.364571182383138,0.319305632892614,0.316123184724249,1.41301918004203,1.26767518706536,-1,6,3,-3,0.145343992976666,-3,1,0,0
"1681","S1",10,"24.11.2019","Yes","Eibar","Alaves",0,2,18,7,7,5,10,11,1,2,0,0,1.85,3.4,4.65,2.14,1.71,0,3,0.514941779985343,0.280188909697907,0.204869310316749,1.82501424965394,0.894796840648156,-2,11,2,-3,0.930217409005781,-1,-1,0,0
"1682","S1",10,"24.11.2019","Yes","Villarreal","Celta",1,3,15,11,1,7,12,9,3,2,0,0,1.77,3.87,4.41,1.73,2.11,0,3,0.538003234317814,0.246063494765512,0.215933270916674,1.86007319771895,0.893863307515533,-2,4,-6,-3,0.966209890203422,3,1,0,0
"1683","S1",10,"24.11.2019","Yes","Valladolid","Sevilla",0,1,7,4,1,2,13,25,3,4,0,1,4.14,3.59,1.89,2.02,1.8,0,3,0.230219562097291,0.265489968546737,0.504290469355972,0.956148654838611,1.77836137661465,-1,3,-1,-3,-0.822212721776041,-12,-1,-1,0
"1684","S1",10,"29.11.2019","Yes","Celta","Valladolid",0,0,13,9,5,2,11,17,1,3,0,0,1.74,3.62,5.13,2.18,1.69,1,1,0.549497567730711,0.264123140290452,0.186379291978838,1.91261584348258,0.823261016226965,0,4,3,0,1.08935482725562,-6,-2,0,0
"1685","S1",10,"30.11.2019","Yes","Alaves","Real Madrid",1,2,8,12,2,6,18,11,4,3,0,0,6.03,4.44,1.52,1.64,2.24,0,3,0.158097433446715,0.214713406235066,0.627189160318219,0.689005706575211,2.09628088718972,-1,-4,-4,-3,-1.40727518061451,7,1,0,0
"1686","S1",10,"30.11.2019","Yes","Sociedad","Eibar",4,1,15,10,4,4,8,12,1,4,0,0,1.71,3.84,4.93,1.9,1.91,3,0,0.557983252721212,0.248476917227415,0.193539830051374,1.92242667539105,0.829096407381536,3,5,0,3,1.09333026800951,-4,-3,0,0
"1687","S1",10,"30.11.2019","Yes","Mallorca","Betis",1,2,16,15,7,3,16,15,3,4,1,0,2.66,3.33,2.68,1.98,1.83,0,3,0.358251374894625,0.286170767933844,0.355577857171531,1.36092489261772,1.35290433944844,-1,1,4,-3,0.00802055316928296,1,-1,1,0
"1688","S1",10,"30.11.2019","Yes","Valencia","Villarreal",2,1,13,24,7,7,8,17,1,2,0,0,2.38,3.43,2.96,1.77,2.06,3,0,0.400331217223296,0.277780844603919,0.321887938172785,1.47877449627381,1.24344465912227,1,-11,0,3,0.235329837151532,-9,-1,0,0
"1689","S1",10,"01.12.2019","Yes","Sevilla","Leganes",1,0,16,8,8,4,16,7,3,3,0,0,1.53,4.01,6.86,2.13,1.72,3,0,0.623216741391536,0.237785938735424,0.138997319873039,2.10743616291003,0.654777898354542,1,8,4,3,1.45265826455549,9,0,0,0
"1690","S1",10,"01.12.2019","Yes","Ath Bilbao","Granada",2,0,14,8,6,1,18,16,5,4,0,0,1.71,3.42,5.85,2.59,1.5,3,0,0.55793991416309,0.278969957081545,0.163090128755365,1.95278969957082,0.76824034334764,2,6,5,3,1.18454935622318,2,1,0,0
"1691","S1",10,"01.12.2019","Yes","Espanol","Osasuna",2,4,12,14,5,8,12,16,1,4,0,1,2.21,3.23,3.49,2.33,1.6,0,3,0.431509077894189,0.295243053296024,0.273247868809787,1.58977028697859,1.11498665972539,-2,-2,-3,-3,0.474783627253205,-4,-3,-1,0
"1692","S1",10,"01.12.2019","Yes","Getafe","Levante",4,0,13,7,9,2,22,14,2,3,0,0,1.68,3.77,5.32,2.02,1.8,3,0,0.567726083855116,0.252991994927479,0.179281921217405,1.95617024649283,0.790837758579694,4,6,7,3,1.16533248791313,8,-1,0,0
"1693","S1",10,"01.12.2019","Yes","Ath Madrid","Barcelona",0,1,17,13,2,5,12,11,4,4,0,0,2.79,3.24,2.61,2.12,1.73,0,3,0.341288002615234,0.293886891140896,0.364825106243871,1.3177508989866,1.38836220987251,-1,4,-3,-3,-0.0706113108859103,1,0,0,0
"1694","S1",10,"06.12.2019","Yes","Villarreal","Ath Madrid",0,0,23,18,3,3,11,11,2,1,0,0,3.52,3.29,2.19,2.21,1.67,1,1,0.271944955028742,0.290956304468441,0.437098740502818,1.10679116955467,1.60225252597689,0,5,0,0,-0.495461356422228,0,1,0,0
"1695","S1",10,"07.12.2019","Yes","Real Madrid","Espanol",2,0,18,6,8,2,15,13,4,3,1,0,1.2,7.06,14.13,1.42,2.81,3,0,0.796877920658733,0.13544667206664,0.067675407274627,2.52608043404284,0.338472893890521,2,12,6,3,2.18760754015232,2,1,1,0
"1696","S1",10,"07.12.2019","Yes","Granada","Alaves",3,0,13,5,3,1,16,17,1,4,0,2,2.24,3.06,3.65,2.59,1.5,3,0,0.426307472690214,0.312068215302641,0.261624312007145,1.59099063337328,1.09694115132408,3,8,2,3,0.494049482049207,-1,-3,-2,0
"1697","S1",10,"07.12.2019","Yes","Levante","Valencia",2,4,17,10,6,6,14,14,5,2,1,0,3.05,3.76,2.2,1.62,2.3,0,3,0.312741020793951,0.253686200378072,0.433572778827977,1.19190926275992,1.554404536862,-2,7,0,-3,-0.362495274102079,0,3,1,0
"1698","S1",10,"07.12.2019","Yes","Barcelona","Mallorca",5,2,25,9,17,3,15,10,3,0,0,0,1.12,9.16,21.61,1.34,3.21,3,0,0.851717223871606,0.104140097241943,0.0441426788864507,2.65929176885676,0.236568133901295,3,16,14,3,2.42272363495547,5,3,0,0
"1699","S1",10,"08.12.2019","Yes","Eibar","Getafe",0,1,6,6,3,3,16,15,5,1,1,0,2.77,2.98,2.83,2.58,1.49,0,3,0.343840078933098,0.319609737800229,0.336550183266672,1.35112997459952,1.32926028760025,-1,0,0,-3,0.0218696869992785,1,4,1,0
"1700","S1",10,"08.12.2019","Yes","Betis","Ath Bilbao",3,2,10,8,6,2,12,15,2,4,0,0,2.33,3.24,3.21,2.18,1.68,3,0,0.408999209560775,0.29412597477673,0.296874815662494,1.52112360345906,1.18475042176421,1,2,4,3,0.336373181694843,-3,-2,0,0
"1701","S1",10,"08.12.2019","Yes","Valladolid","Sociedad",0,0,4,16,2,2,10,19,0,4,0,0,3.27,3.22,2.31,2.3,1.62,1,1,0.291450670616309,0.295976302147618,0.412573027236073,1.17032831399654,1.53369538385584,0,-12,0,0,-0.363367069859294,-9,-4,0,0
"1702","S1",10,"08.12.2019","Yes","Leganes","Celta",3,2,15,9,8,4,14,11,3,3,0,1,2.35,3.09,3.34,2.59,1.5,3,0,0.405825937533178,0.308637848932999,0.285536213533823,1.52611566153253,1.16524648953447,1,6,4,3,0.360869171998065,3,0,-1,0
"1703","S1",10,"08.12.2019","Yes","Osasuna","Sevilla",1,1,10,13,1,4,22,10,4,4,1,0,3.44,3.38,2.16,1.97,1.84,1,1,0.276981910889887,0.281898749544737,0.441119339565376,1.1128444822144,1.60525676824086,0,-3,-3,0,-0.492412286026465,12,0,1,0
"1704","S1",10,"13.12.2019","Yes","Alaves","Leganes",1,1,10,3,3,1,14,17,2,3,0,0,2.53,2.95,3.2,2.74,1.44,1,1,0.377607552151043,0.323846476929539,0.298545970919418,1.45666913338267,1.21948438968779,0,7,2,0,0.237184743694874,-3,-1,0,0
"1705","S1",10,"14.12.2019","Yes","Granada","Levante",1,2,18,13,4,6,14,12,4,3,0,0,2.01,3.55,3.73,1.92,1.89,0,3,0.475043319473494,0.268968189335696,0.25598849119081,1.69409814775618,1.03693366290813,-1,5,-2,-3,0.65716448484805,2,1,0,0
"1706","S1",10,"14.12.2019","Yes","Sociedad","Barcelona",2,2,19,9,5,5,7,8,0,1,0,0,4.76,4.24,1.67,1.53,2.49,1,1,0.201088253001783,0.225750019879361,0.573161727118856,0.829014778884711,1.94523520123593,0,10,0,0,-1.11622042235122,-1,-1,0,0
"1707","S1",10,"14.12.2019","Yes","Ath Bilbao","Eibar",0,0,8,8,3,2,7,12,3,3,0,0,1.7,3.58,5.52,2.31,1.61,1,1,0.560905550698805,0.266351797817868,0.172742651483328,1.94906844991428,0.784579752267851,0,0,1,0,1.16448869764643,-5,0,0,0
"1708","S1",10,"14.12.2019","Yes","Ath Madrid","Osasuna",2,0,19,15,9,3,16,10,2,1,0,0,1.4,4.27,10.06,2.18,1.68,3,0,0.681647524048608,0.223490991491347,0.0948614844600449,2.26843356363717,0.508075444871481,2,4,6,3,1.76035811876569,6,1,0,0
"1709","S1",10,"15.12.2019","Yes","Getafe","Valladolid",2,0,7,10,3,3,28,10,3,3,0,0,1.65,3.58,6.07,2.59,1.5,3,0,0.577126451739697,0.265994035019693,0.15687951324061,1.99737339023879,0.736632574741522,2,-3,0,3,1.26074081549726,18,0,0,0
"1710","S1",10,"15.12.2019","Yes","Celta","Mallorca",2,2,18,8,7,2,14,16,3,5,0,1,1.69,3.76,5.22,2.08,1.75,1,1,0.563944901934868,0.253475235178172,0.182579862886959,1.94530994098278,0.80121482383905,0,10,5,0,1.14409511714373,-2,-2,-1,0
"1711","S1",10,"15.12.2019","Yes","Espanol","Betis",2,2,16,10,4,5,26,13,4,1,0,0,2.57,3.36,2.76,1.95,1.85,1,1,0.370914326853852,0.283705303575714,0.345380369570434,1.39644828413727,1.31984641228702,0,6,-1,0,0.0766018718502517,13,3,0,0
"1712","S1",10,"15.12.2019","Yes","Sevilla","Villarreal",1,2,24,9,5,3,12,11,2,0,0,0,1.69,4.07,4.78,1.65,2.23,0,3,0.565358271023013,0.234755645707344,0.199886083269643,1.93083045877638,0.834413895516272,-1,15,2,-3,1.09641656326011,1,2,0,0
"1713","S1",10,"15.12.2019","Yes","Valencia","Real Madrid",1,1,9,19,6,6,11,15,1,2,0,0,3.75,3.91,1.9,1.57,2.39,1,1,0.254274125921996,0.24386904660038,0.501856827477624,1.00669142436637,1.74943952903325,0,-10,0,0,-0.742748104666884,-4,-1,0,0
"1714","S1",10,"18.12.2019","Yes","Barcelona","Real Madrid",0,0,9,17,2,4,5,17,3,5,0,0,1.74,4.16,4.3,1.46,2.68,1,1,0.54857030703745,0.229450080347395,0.221979612615154,1.87516100145975,0.895388918192858,0,-8,-2,0,0.979772083266888,-12,-2,0,0
"1715","S1",10,"20.12.2019","Yes","Eibar","Granada",3,0,21,12,7,1,17,13,3,3,0,0,2.09,3.21,3.94,2.46,1.55,3,0,0.458390266355936,0.298453475602463,0.243156258041601,1.67362427467027,1.02792224972727,3,9,6,3,0.645702024943007,4,0,0,0
"1716","S1",10,"21.12.2019","Yes","Mallorca","Sevilla",0,2,8,13,1,6,15,12,6,3,0,0,4.95,3.89,1.7,1.89,1.92,0,3,0.192891624250733,0.245453352195663,0.561655023553605,0.824128224947861,1.93041842285648,-2,-5,-5,-3,-1.10629019790861,3,3,0,0
"1717","S1",10,"21.12.2019","Yes","Barcelona","Alaves",4,1,8,5,4,3,10,11,2,4,0,0,1.15,8.35,18.61,1.36,3.08,3,0,0.833667297039928,0.114816454083343,0.0515162488767285,2.61581834520313,0.269365200713529,3,3,1,3,2.3464531444896,-1,-2,0,0
"1718","S1",10,"21.12.2019","Yes","Villarreal","Getafe",1,0,11,7,4,0,8,18,2,5,0,1,2.22,3.18,3.53,2.26,1.64,3,0,0.429736310180081,0.300004593899302,0.270259095920617,1.58921352443954,1.11078188166115,1,4,4,3,0.47843164277839,-10,-3,-1,0
"1719","S1",10,"21.12.2019","Yes","Valladolid","Valencia",1,1,14,5,6,2,10,12,0,3,0,0,3.49,3.28,2.18,2.19,1.68,1,1,0.272855627380198,0.290325042547833,0.436819330071969,1.10889192468843,1.60078303276374,0,9,4,0,-0.491891108075312,-2,-3,0,0
"1720","S1",10,"22.12.2019","Yes","Leganes","Espanol",2,0,11,9,5,3,11,15,1,6,0,0,2.12,3.09,3.93,2.74,1.44,3,0,0.449332312098305,0.308279773996248,0.242387913905447,1.65627671029116,1.03544351571259,2,2,2,3,0.620833194578574,-4,-5,0,0
"1721","S1",10,"22.12.2019","Yes","Osasuna","Sociedad",3,4,19,13,7,7,11,12,6,2,1,0,2.8,3.29,2.58,2.02,1.79,0,3,0.340560579677582,0.289838791214964,0.369600629107454,1.31152053024771,1.39864067853733,-1,6,0,-3,-0.087120148289614,-1,4,1,0
"1722","S1",10,"22.12.2019","Yes","Betis","Ath Madrid",1,2,15,8,2,5,11,14,4,3,0,0,3.82,3.33,2.06,2.14,1.71,0,3,0.249905280951271,0.286678130100256,0.463416588948473,1.03639397295407,1.67692789694568,-1,7,-3,-3,-0.640533923991607,-3,1,0,0
"1723","S1",10,"22.12.2019","Yes","Levante","Celta",3,1,13,12,7,5,8,15,3,6,0,0,2.62,3.49,2.6,1.72,2.1,3,0,0.362527866782795,0.272155590536081,0.365316542681124,1.35973919088447,1.36810521857945,2,1,2,3,-0.00836602769498751,-7,-3,0,0
"1724","S1",10,"22.12.2019","Yes","Real Madrid","Ath Bilbao",0,0,20,8,8,2,8,14,1,0,0,0,1.35,5.12,8.61,1.63,2.24,1,1,0.703994174264237,0.185623463917328,0.110382361818434,2.29760598671004,0.516770549372632,0,12,6,0,1.78083543733741,-6,1,0,0
"1725","S1",10,"03.01.2020","Yes","Valladolid","Leganes",2,2,14,12,5,5,16,13,3,2,0,0,2.72,2.83,3.06,3.09,1.36,1,1,0.350874776139964,0.337236533957845,0.31188868990219,1.38986086237774,1.27290260366442,0,2,0,0,0.116958258713321,3,1,0,0
"1726","S1",10,"03.01.2020","Yes","Sevilla","Ath Bilbao",1,1,9,6,2,1,16,20,2,4,0,0,1.65,3.67,5.93,2.31,1.61,1,1,0.578758134302757,0.260204610790068,0.161037254907175,1.99647901369834,0.743316375511593,0,3,1,0,1.25316263818674,-4,-2,0,0
"1727","S1",10,"04.01.2020","Yes","Valencia","Eibar",1,0,9,10,1,3,13,20,1,3,0,1,1.66,3.87,5.33,1.88,1.92,3,0,0.574585435289464,0.246463003250778,0.178951561459758,1.97021930911917,0.783317687630052,1,-1,-2,3,1.18690162148912,-7,-2,-1,0
"1728","S1",10,"04.01.2020","Yes","Getafe","Real Madrid",0,3,15,10,4,8,20,14,3,2,0,0,4.31,3.63,1.85,1.93,1.88,0,3,0.221383054825725,0.262854260688396,0.515762684485879,0.927003425165572,1.81014231414603,-3,5,-4,-3,-0.883138888980461,6,1,0,0
"1729","S1",10,"04.01.2020","Yes","Ath Madrid","Levante",2,1,17,6,8,3,9,10,1,3,0,0,1.28,5.65,11.17,1.66,2.22,3,0,0.745633570848806,0.168922295696721,0.0854441334544737,2.40582300824314,0.425254696060142,1,11,5,3,1.980568312183,-1,-2,0,0
"1730","S1",10,"04.01.2020","Yes","Espanol","Barcelona",2,2,8,14,3,7,17,11,2,2,0,1,6.76,4.69,1.45,1.59,2.33,1,1,0.14077699045064,0.202910971310517,0.656312038238844,0.625241942662435,2.17184708602705,0,-6,-4,0,-1.54660514336461,6,0,-1,0
"1731","S1",10,"05.01.2020","Yes","Granada","Mallorca",1,0,7,17,4,5,23,11,5,1,0,0,1.94,3.35,4.24,2.26,1.64,3,0,0.491001984195571,0.284341447564002,0.224656568240426,1.75734740015072,0.958311152285282,1,-10,-1,3,0.799036247865434,12,4,0,0
"1732","S1",10,"05.01.2020","Yes","Sociedad","Villarreal",1,2,10,14,2,2,16,14,5,4,0,0,1.91,3.86,3.75,1.61,2.31,0,3,0.498964153863654,0.246896770435124,0.254139075701221,1.74378923202609,1.00931399753879,-1,-4,0,-3,0.734475234487299,2,1,0,0
"1733","S1",10,"05.01.2020","Yes","Alaves","Betis",1,1,6,10,1,3,18,15,7,3,0,1,2.65,3.21,2.75,2.14,1.7,1,1,0.358528115671263,0.295981154681884,0.345490729646853,1.37156550169567,1.33245334362244,0,-4,-2,0,0.039112158073229,3,4,-1,0
"1734","S1",10,"05.01.2020","Yes","Celta","Osasuna",1,1,20,8,7,1,14,19,4,3,0,0,2.1,3.35,3.63,1.95,1.85,1,1,0.453436993120421,0.284244085239667,0.262318921639913,1.64455506460093,1.07120085015941,0,12,6,0,0.573354214441523,-5,1,0,0
"1735","S1",10,"17.01.2020","Yes","Leganes","Getafe",0,3,8,8,2,4,22,18,6,4,0,0,2.97,2.82,2.8,3.04,1.37,0,3,0.321140096146807,0.338222016154616,0.340637887698577,1.30164230459504,1.36013567925035,-3,0,-2,-3,-0.0584933746553113,4,2,0,0
"1736","S1",10,"18.01.2020","Yes","Levante","Alaves",0,1,20,14,3,6,12,20,2,4,0,0,2.06,3.47,3.61,1.89,1.91,0,3,0.462043782158862,0.274296885085665,0.263659332755473,1.66042823156225,1.06527488335208,-1,6,-3,-3,0.595153348210169,-8,-2,0,0
"1737","S1",10,"18.01.2020","Yes","Real Madrid","Sevilla",2,1,13,8,4,3,17,12,3,1,0,0,1.62,4.3,5.08,1.63,2.26,3,0,0.589747189494487,0.222183824879318,0.188068985626195,1.99142539336278,0.786390781757902,1,5,1,3,1.20503461160488,5,2,0,0
"1738","S1",10,"18.01.2020","Yes","Osasuna","Valladolid",0,0,21,5,5,3,16,10,2,2,0,0,1.85,3.43,4.61,2.25,1.64,1,1,0.515288581549421,0.277925328240941,0.206786090209638,1.8237910728892,0.898283598869854,0,16,2,0,0.925507474019351,6,0,0,0
"1739","S1",10,"18.01.2020","Yes","Eibar","Ath Madrid",2,0,9,12,4,4,16,14,1,2,0,0,4.95,3.34,1.82,2.41,1.56,3,0,0.192240550523706,0.284907402722259,0.522852046754035,0.861629054293377,1.85346354298436,2,-3,0,3,-0.991834488690988,2,-1,0,0
"1740","S1",10,"19.01.2020","Yes","Mallorca","Valencia",4,1,13,8,6,1,18,11,4,4,0,1,3.68,3.49,2.04,1.92,1.88,3,0,0.259177284310157,0.273287222424463,0.46753549326538,1.05081907535493,1.6758937022206,3,5,5,3,-0.625074626865672,7,0,-1,0
"1741","S1",10,"19.01.2020","Yes","Betis","Sociedad",3,0,14,7,6,0,8,10,3,1,0,0,2.46,3.63,2.72,1.63,2.26,3,0,0.387282012661505,0.262455578828458,0.350262408510037,1.42430161681297,1.31324280435857,3,7,6,3,0.111058812454402,-2,2,0,0
"1742","S1",10,"19.01.2020","Yes","Villarreal","Espanol",1,2,21,16,5,5,15,18,1,3,0,1,1.66,3.92,5.21,1.82,1.99,0,3,0.574024002923073,0.243081593074566,0.182894404002361,1.96515360184378,0.791764805081649,-1,5,0,-3,1.17338879676213,-3,-2,-1,0
"1743","S1",10,"19.01.2020","Yes","Ath Bilbao","Celta",1,1,22,7,6,3,18,12,4,3,0,0,1.95,3.21,4.46,2.4,1.57,1,1,0.489070170224541,0.297098701538272,0.213831128237187,1.76430921221189,0.938592086249833,0,15,3,0,0.825717125962061,6,1,0,0
"1744","S1",10,"19.01.2020","Yes","Barcelona","Granada",1,0,18,5,6,1,11,17,0,4,0,1,1.15,8.1,17.04,1.36,3.1,3,0,0.82681283134154,0.117387006918861,0.0558001617395992,2.59782550094348,0.284787492137658,1,13,5,3,2.31303800880582,-6,-4,-1,0
"1745","S1",10,"24.01.2020","Yes","Osasuna","Levante",2,0,15,6,3,2,18,11,3,3,0,0,1.69,4.07,4.78,1.64,2.26,3,0,0.565358271023013,0.234755645707344,0.199886083269643,1.93083045877638,0.834413895516272,2,9,1,3,1.09641656326011,7,0,0,0
"1746","S1",10,"25.01.2020","Yes","Espanol","Ath Bilbao",1,1,9,11,3,3,14,14,3,1,0,0,2.48,2.96,3.25,2.65,1.47,1,1,0.384480112546361,0.322131986187492,0.293387901266147,1.47557232382658,1.20229568998593,0,-2,0,0,0.273276633840644,0,2,0,0
"1747","S1",10,"25.01.2020","Yes","Valencia","Barcelona",2,0,8,14,6,5,13,16,1,3,0,0,4.77,4.29,1.65,1.55,2.42,3,0,0.199888174447861,0.222253284875594,0.577858540676545,0.821917808219178,1.95582890690523,2,-6,1,3,-1.13391109868605,-3,-2,0,0
"1748","S1",10,"25.01.2020","Yes","Alaves","Villarreal",1,2,12,11,6,6,10,12,2,1,0,0,2.8,3.24,2.6,2.07,1.76,0,3,0.340006457862448,0.293832741362609,0.366160800774943,1.31385211494995,1.39231514368744,-1,1,0,-3,-0.0784630287374877,-2,1,0,0
"1749","S1",10,"25.01.2020","Yes","Sevilla","Granada",2,0,12,8,4,1,13,18,4,1,0,0,1.38,4.62,9.29,1.93,1.87,3,0,0.690966520487607,0.206392597028766,0.102640882483627,2.27929215849159,0.514315244479648,2,4,3,3,1.76497691401194,-5,3,0,0
"1750","S1",10,"26.01.2020","Yes","Ath Madrid","Leganes",0,0,14,10,3,4,10,19,2,6,0,1,1.45,4.13,8.73,2.31,1.61,1,1,0.659116045329321,0.231408781047825,0.109475173622854,2.20875691703579,0.559834301916387,0,4,-1,0,1.6489226151194,-9,-4,-1,0
"1751","S1",10,"26.01.2020","Yes","Celta","Eibar",0,0,18,5,5,3,9,16,1,0,0,0,2.05,3.37,3.76,2.08,1.75,1,1,0.46435573536795,0.282471589763886,0.253172674868164,1.67553879586774,1.04198961436838,0,13,2,0,0.633549181499357,-7,1,0,0
"1752","S1",10,"26.01.2020","Yes","Getafe","Betis",1,0,7,8,3,1,19,12,2,4,0,1,2.03,3.3,3.94,2.23,1.65,3,0,0.469399838262477,0.288752021719039,0.241848140018484,1.69695153650647,1.01429644177449,1,-1,2,3,0.682655094731978,7,-2,-1,0
"1753","S1",10,"26.01.2020","Yes","Sociedad","Mallorca",3,0,14,8,5,4,15,7,0,2,0,0,1.45,4.54,7.05,1.65,2.23,3,0,0.655713188220231,0.209423815620999,0.134862996158771,2.17656338028169,0.614012804097311,3,6,1,3,1.56255057618438,8,-2,0,0
"1754","S1",10,"26.01.2020","Yes","Valladolid","Real Madrid",0,1,4,12,0,3,7,11,1,3,0,0,7.15,4.81,1.42,1.69,2.15,0,3,0.132948708216301,0.197626458159366,0.669424833624333,0.596472582808269,2.20590095903236,-1,-8,-3,-3,-1.6094283762241,-4,-2,0,0
"1755","S1",10,"01.02.2020","Yes","Granada","Espanol",2,1,8,22,2,4,15,17,3,3,0,0,2.69,3.07,2.85,2.44,1.55,3,0,0.354599725220168,0.31070790255448,0.334692372225352,1.37450707821499,1.31478501923054,1,-14,-2,3,0.0597220589844496,-2,0,0,0
"1756","S1",10,"01.02.2020","Yes","Real Madrid","Ath Madrid",1,0,16,4,5,1,18,11,2,3,0,0,1.8,3.57,4.63,2.16,1.69,3,0,0.528270228290363,0.266354736953124,0.205375034756513,1.85116542182421,0.882479841222662,1,12,4,3,0.968685580601551,7,-1,0,0
"1757","S1",10,"01.02.2020","Yes","Mallorca","Valladolid",0,1,16,15,4,7,11,10,4,1,0,0,2.26,3.21,3.38,2.33,1.59,0,3,0.421462755213027,0.296730787159327,0.281806457627645,1.56111905279841,1.14215016004226,-1,1,-3,-3,0.418968892756145,1,3,0,0
"1758","S1",10,"01.02.2020","Yes","Valencia","Celta",1,0,9,11,5,4,14,20,6,3,0,0,1.81,3.61,4.55,1.94,1.86,3,0,0.52654102727672,0.263999794839574,0.209459177883706,1.84362287666973,0.892377328490692,1,-2,1,3,0.951245548179041,-6,3,0,0
"1759","S1",10,"02.02.2020","Yes","Leganes","Sociedad",2,1,12,2,5,1,24,19,4,3,0,0,2.9,3.14,2.58,2.26,1.63,3,0,0.328127278324126,0.303047486350307,0.368825235325567,1.28742932132268,1.40952319232701,1,10,4,3,-0.122093871004326,5,1,0,0
"1760","S1",10,"02.02.2020","Yes","Eibar","Betis",1,1,8,14,3,6,15,16,2,2,0,0,2.48,3.39,2.83,1.9,1.9,1,1,0.383451975075242,0.280519438993097,0.336028585931661,1.43087536421882,1.28860519678808,0,-6,-3,0,0.142270167430743,-1,0,0,0
"1761","S1",10,"02.02.2020","Yes","Ath Bilbao","Getafe",0,2,8,9,2,3,11,19,2,5,0,0,2.55,2.85,3.24,2.89,1.4,0,3,0.372887515900418,0.333636198437216,0.293476285662366,1.45229874613847,1.21406505542431,-2,-1,-1,-3,0.238233690714156,-8,-3,0,0
"1762","S1",10,"02.02.2020","Yes","Sevilla","Alaves",1,1,14,4,3,3,13,12,2,1,0,0,1.35,4.95,9.11,1.82,1.98,1,1,0.703771332256479,0.191937636069949,0.104291031673573,2.30325163283938,0.504810731090666,0,10,0,0,1.79844090174872,1,1,0,0
"1763","S1",10,"02.02.2020","Yes","Villarreal","Osasuna",3,1,9,17,4,5,19,15,3,2,0,0,1.77,3.87,4.45,1.71,2.12,3,0,0.539049514991596,0.246542026236466,0.214408458771938,1.86369057121125,0.88976740255228,2,-8,-1,3,0.973923168658973,4,1,0,0
"1764","S1",10,"02.02.2020","Yes","Barcelona","Levante",2,1,23,10,9,5,6,10,2,0,0,0,1.14,9.14,16.42,1.26,3.68,3,0,0.83741292688425,0.104447564184688,0.0581395089310624,2.61668634483744,0.278866090977875,1,13,4,3,2.33782025385956,-4,2,0,0
"1765","S1",10,"07.02.2020","Yes","Alaves","Eibar",2,1,9,5,5,1,16,10,3,2,0,0,2.24,3.12,3.56,2.45,1.55,3,0,0.426046397446913,0.305879464833681,0.268074137719406,1.58401865717442,1.1101018779919,1,4,4,3,0.473916779182521,6,1,0,0
"1766","S1",10,"08.02.2020","Yes","Levante","Leganes",2,0,9,12,5,4,18,15,2,3,0,0,2.59,3.21,2.85,2.08,1.74,3,0,0.368239286102424,0.297115187229058,0.334645526668518,1.40183304553633,1.30105176723461,2,-3,1,3,0.100781278301716,3,-1,0,0
"1767","S1",10,"08.02.2020","Yes","Getafe","Valencia",3,0,22,5,10,0,12,6,4,4,0,1,2.03,3.29,3.98,2.37,1.58,3,0,0.470129935409284,0.290080172912111,0.239789891678605,1.70046997913996,1.00944984794793,3,17,10,3,0.691020131192038,6,0,-1,0
"1768","S1",10,"08.02.2020","Yes","Valladolid","Villarreal",1,1,8,8,1,3,14,22,3,3,0,0,3.03,3.19,2.44,2.17,1.68,1,1,0.313317902787562,0.297602898259032,0.389079198953406,1.23755660662172,1.46484049511925,0,0,-2,0,-0.227283888497535,-8,0,0,0
"1769","S1",10,"08.02.2020","Yes","Ath Madrid","Granada",1,0,6,10,3,2,16,19,4,6,0,0,1.4,4.19,10.44,2.41,1.56,3,0,0.681092897536185,0.227572805859346,0.0913342966044693,2.2708514984679,0.501575695672754,1,-4,1,3,1.76927580279515,-3,-2,0,0
"1770","S1",10,"09.02.2020","Yes","Espanol","Mallorca",1,0,12,7,7,3,26,15,6,2,0,0,1.65,3.87,5.43,1.99,1.81,3,0,0.577959850491349,0.246416990519567,0.175623158989084,1.98029654199361,0.773286467486819,1,5,4,3,1.20701007450679,11,4,0,0
"1771","S1",10,"09.02.2020","Yes","Sociedad","Ath Bilbao",2,1,14,6,4,3,7,15,2,2,0,1,2.1,3.2,3.81,2.41,1.56,3,0,0.453015271430164,0.297291271876045,0.249693456693791,1.65633708616654,1.04637164195742,1,8,1,3,0.609965444209118,-8,0,-1,0
"1772","S1",10,"09.02.2020","Yes","Osasuna","Real Madrid",1,4,14,17,4,7,11,15,2,2,0,0,5.83,4.38,1.54,1.7,2.14,0,3,0.163485123173723,0.217606910525755,0.618907966300523,0.708062280046923,2.07433080942732,-3,-3,-3,-3,-1.3662685293804,-4,0,0,0
"1773","S1",10,"09.02.2020","Yes","Celta","Sevilla",2,1,13,12,7,4,16,14,3,2,0,0,3.39,3.27,2.23,2.18,1.68,3,0,0.281145540557734,0.291462808101137,0.427391651341129,1.13489942977434,1.57363776212452,1,1,3,3,-0.438738332350186,2,1,0,0
"1774","S1",10,"09.02.2020","Yes","Betis","Barcelona",2,3,7,10,3,6,21,17,5,5,1,1,4,3.85,1.85,1.53,2.46,0,3,0.238031581585763,0.247305539309884,0.514662879104353,0.961400284067174,1.79129417662294,-1,-3,-3,-3,-0.829893892555769,4,0,0,0
"1775","S1",10,"14.02.2020","Yes","Valencia","Ath Madrid",2,2,9,8,3,3,12,16,3,3,0,0,3.52,3.06,2.29,2.55,1.51,1,1,0.271190507519525,0.311957707996316,0.41685178448416,1.12552923055489,1.5625130614488,0,1,0,0,-0.436983830893906,-4,0,0,0
"1776","S1",10,"15.02.2020","Yes","Mallorca","Alaves",1,0,14,10,6,0,16,15,0,2,0,0,2.44,3.13,3.11,2.37,1.58,3,0,0.389997556079952,0.304023653940921,0.305978789979127,1.47401632218078,1.2219600238783,1,4,6,3,0.252056298302477,1,-2,0,0
"1777","S1",10,"15.02.2020","Yes","Barcelona","Getafe",2,1,12,7,5,2,12,30,3,2,0,0,1.43,4.53,7.67,1.72,2.12,3,0,0.66572844795377,0.210152688868409,0.124118863177822,2.20733803272972,0.582509278401873,1,5,3,3,1.62482875432785,-18,1,0,0
"1778","S1",10,"15.02.2020","Yes","Villarreal","Levante",2,1,14,11,6,2,15,15,3,1,0,0,1.52,4.53,5.82,1.47,2.65,3,0,0.626288108778381,0.210145237382591,0.163566653839027,2.08900956371774,0.700845198899674,1,3,4,3,1.38816436481806,0,2,0,0
"1779","S1",10,"15.02.2020","Yes","Granada","Valladolid",2,1,11,6,5,4,19,13,3,2,0,0,2.46,2.97,3.27,2.68,1.46,3,0,0.387510324271914,0.320968147376737,0.291521528351348,1.48349912019248,1.19553273243078,1,5,1,3,0.287966387761698,6,1,0,0
"1780","S1",10,"16.02.2020","Yes","Sevilla","Espanol",2,2,18,5,6,3,17,9,3,4,0,1,1.6,3.91,6,2.02,1.79,1,1,0.596703632109065,0.244175399328518,0.159120968562417,2.03428629565571,0.72153830501577,0,13,3,0,1.31274799063994,8,-1,-1,0
"1781","S1",10,"16.02.2020","Yes","Leganes","Betis",0,0,11,3,1,2,15,20,5,3,0,1,2.45,3.17,3.05,2.27,1.63,1,1,0.388176252132892,0.300010037137408,0.3118137107297,1.46453879353608,1.23545116932651,0,8,-1,0,0.229087624209575,-5,2,-1,0
"1782","S1",10,"16.02.2020","Yes","Ath Bilbao","Osasuna",0,1,12,6,2,2,14,20,4,4,0,0,2.03,3.19,4.09,2.49,1.53,0,3,0.468890046899427,0.298384575299635,0.232725377800938,1.70505471599792,0.996560708702449,-1,6,0,-3,0.708494007295466,-6,0,0,0
"1783","S1",10,"16.02.2020","Yes","Real Madrid","Celta",2,2,15,5,4,3,10,10,2,2,0,0,1.28,5.94,10.2,1.49,2.57,1,1,0.745724160340295,0.160694768558178,0.0935810711015272,2.39786724957906,0.44143798186276,0,10,1,0,1.9564292677163,0,0,0,0
"1784","S1",10,"21.02.2020","Yes","Betis","Mallorca",3,3,19,11,6,4,13,12,2,1,0,0,1.48,4.52,6.7,1.7,2.14,1,1,0.645857503582884,0.211475465774927,0.142667030642189,2.14904797652358,0.639476557701495,0,8,2,0,1.50957141882208,1,1,0,0
"1785","S1",10,"22.02.2020","Yes","Celta","Leganes",1,0,3,11,1,2,13,17,3,3,1,0,1.86,3.39,4.67,2.5,1.53,3,0,0.513621365932472,0.281809952989498,0.20456868107803,1.82267405078691,0.895515996223587,1,-8,-1,3,0.927158054563328,-4,0,1,0
"1786","S1",10,"22.02.2020","Yes","Barcelona","Eibar",5,0,13,12,11,5,8,19,0,2,0,0,1.2,7.01,13.36,1.4,2.89,3,0,0.793018655755917,0.135752123667204,0.0712292205768788,2.51480809093496,0.34943978539784,5,1,6,3,2.16536830553712,-11,-2,0,0
"1787","S1",10,"22.02.2020","Yes","Sociedad","Valencia",3,0,19,6,7,1,19,9,1,1,0,0,1.69,4.03,4.79,1.72,2.11,3,0,0.564278928367851,0.23663309899297,0.199087972639179,1.92946988409652,0.833897016910507,3,13,6,3,1.09557286718602,10,0,0,0
"1788","S1",10,"22.02.2020","Yes","Levante","Real Madrid",1,0,8,19,2,7,16,10,1,2,0,0,6.2,4.93,1.46,1.42,2.8,3,0,0.153747239179935,0.193353525946369,0.652899234873696,0.654595243486173,2.15205123056746,1,-11,-5,3,-1.49745598708128,6,-1,0,0
"1789","S1",10,"23.02.2020","Yes","Osasuna","Granada",0,3,14,10,1,4,19,11,3,1,0,0,1.93,3.37,4.25,2.32,1.6,0,3,0.493384224795119,0.282561291944979,0.224054483259901,1.76271396633034,0.954724741724683,-3,4,-3,-3,0.807989224605654,8,2,0,0
"1790","S1",10,"23.02.2020","Yes","Alaves","Ath Bilbao",2,1,4,13,4,5,17,12,4,4,0,0,2.95,2.9,2.72,2.86,1.41,3,0,0.322393427882454,0.327951935259738,0.349654636857808,1.2951322189071,1.37691584583316,1,-9,-1,3,-0.0817836269260637,5,0,0,0
"1791","S1",10,"23.02.2020","Yes","Valladolid","Espanol",2,1,21,6,6,2,10,18,1,5,0,1,2.62,2.97,3.02,2.66,1.46,3,0,0.363675435466606,0.320818060916669,0.315506503616724,1.41184436731649,1.26733757176684,1,15,4,3,0.144506795549645,-8,-4,-1,0
"1792","S1",10,"23.02.2020","Yes","Getafe","Sevilla",0,3,10,8,2,5,14,17,7,3,0,0,2.32,3.08,3.39,2.6,1.49,0,3,0.410237470335853,0.309010042590643,0.280752487073504,1.5397224535982,1.15126750381116,-3,2,-3,-3,0.388454949787047,-3,4,0,0
"1793","S1",10,"23.02.2020","Yes","Ath Madrid","Villarreal",3,1,16,10,9,4,14,6,1,2,0,0,1.66,3.72,5.63,2.09,1.74,3,0,0.574354305271414,0.256297888911437,0.169347805817149,1.97936080472568,0.764341306362883,2,6,5,3,1.2150194983628,8,-1,0,0
"1794","S1",10,"28.02.2020","Yes","Sociedad","Valladolid",1,0,13,6,4,1,15,11,1,1,0,0,1.54,4.04,6.63,1.89,1.91,3,0,0.61978388134299,0.236254251799061,0.143961866857949,2.09560589582803,0.668139852372909,1,7,3,3,1.42746604345512,4,0,0,0
"1795","S1",10,"29.02.2020","Yes","Eibar","Levante",3,0,13,11,9,4,15,16,3,2,0,0,1.99,3.55,3.78,1.86,1.94,3,0,0.479152458249571,0.268595321666661,0.252252220083769,1.70605269641537,1.02535198191797,3,2,5,3,0.680700714497406,-1,1,0,0
"1796","S1",10,"29.02.2020","Yes","Valencia","Betis",2,1,10,14,5,5,13,9,2,3,0,0,2.21,3.4,3.3,1.78,2.03,3,0,0.431090790333116,0.280209013716525,0.288700195950359,1.57348138471587,1.1463096015676,1,-4,0,3,0.427171783148269,4,-1,0,0
"1797","S1",10,"29.02.2020","Yes","Leganes","Alaves",1,1,19,8,6,4,18,18,3,3,0,0,2.04,3.06,4.27,3.05,1.37,1,1,0.466326902074991,0.310884601383327,0.222788496541682,1.7098653076083,0.979250091008373,0,11,2,0,0.730615216599927,0,0,0,0
"1798","S1",10,"29.02.2020","Yes","Granada","Celta",0,0,14,6,0,2,14,11,3,5,0,0,2.81,3.06,2.72,2.44,1.54,1,1,0.338823529411765,0.311141868512111,0.350034602076125,1.32761245674741,1.36124567474048,0,8,-2,0,-0.0336332179930796,3,-2,0,0
"1799","S1",10,"01.03.2020","Yes","Sevilla","Osasuna",3,2,12,14,5,4,9,14,2,2,0,1,1.47,4.28,7.29,1.92,1.88,3,0,0.647205610559002,0.22228790829947,0.130506481141527,2.16390473997648,0.613807351724052,1,-2,1,3,1.55009738825242,-5,0,-1,0
"1800","S1",10,"01.03.2020","Yes","Ath Bilbao","Villarreal",1,0,18,10,6,3,11,13,6,6,0,0,2.31,3.29,3.18,2.17,1.68,3,0,0.411769567732871,0.289114802876271,0.299115629390859,1.52442350607488,1.18646169104885,1,8,3,3,0.337961815026036,-2,0,0,0
"1801","S1",10,"01.03.2020","Yes","Espanol","Ath Madrid",1,1,9,5,3,2,20,18,3,4,0,0,4.28,3.06,2.05,2.64,1.46,1,1,0.222891009742821,0.3117560528429,0.46535293741428,0.980429082071362,1.70781486508574,0,4,1,0,-0.727385783014376,2,-1,0,0
"1802","S1",10,"01.03.2020","Yes","Mallorca","Getafe",0,1,4,9,1,5,13,24,4,5,1,0,3.61,2.99,2.28,2.53,1.5,0,3,0.263804132049114,0.318505992206455,0.417689875744431,1.1099183883538,1.57157561943975,-1,-5,-4,-3,-0.46165723108595,-11,-1,1,0
"1803","S1",10,"01.03.2020","Yes","Real Madrid","Barcelona",2,0,13,9,5,4,13,10,2,2,0,0,2.19,3.66,3.13,1.64,2.25,3,0,0.435153214135129,0.260378562556266,0.304468223308605,1.56583820496165,1.17378323248208,2,4,1,3,0.392054972479573,3,0,0,0
"1804","S1",10,"06.03.2020","Yes","Alaves","Valencia",1,1,13,6,2,2,9,10,5,3,0,0,2.64,3.23,2.8,2.18,1.68,1,1,0.362293295731317,0.296115882579157,0.341590821689527,1.38299576977311,1.32088834764774,0,7,0,0,0.0621074221253686,-1,2,0,0
"1805","S1",10,"07.03.2020","Yes","Eibar","Mallorca",1,2,13,10,2,4,16,8,5,3,0,0,1.72,3.69,5.13,2.01,1.8,0,3,0.555121539233023,0.258755839425691,0.186122621341286,1.92412045712476,0.81712370344955,-1,3,-2,-3,1.10699675367521,8,2,0,0
"1806","S1",10,"07.03.2020","Yes","Ath Madrid","Sevilla",2,2,21,12,3,4,14,16,2,4,0,0,1.94,3.25,4.45,2.46,1.54,1,1,0.491913402833285,0.293634461998946,0.214452135167769,1.7693746704988,0.936990867502253,0,9,-1,0,0.832383802996548,-2,-2,0,0
"1807","S1",10,"07.03.2020","Yes","Barcelona","Sociedad",1,0,13,9,6,1,12,10,4,3,0,0,1.36,5.38,7.91,1.4,2.88,3,0,0.701891136760228,0.177429729738645,0.120679133501126,2.28310314001933,0.539467130242025,1,4,5,3,1.74363600977731,2,1,0,0
"1808","S1",10,"07.03.2020","Yes","Getafe","Celta",0,0,19,3,6,2,18,14,6,5,1,0,1.85,3.27,4.99,2.59,1.49,1,1,0.516398034071453,0.292151792976204,0.191450172952342,1.84134589519056,0.866502311833232,0,16,4,0,0.974843583357332,4,1,1,0
"1809","S1",10,"08.03.2020","Yes","Osasuna","Espanol",1,0,17,8,6,2,17,12,3,3,0,1,2.43,3.23,3.06,2.17,1.69,3,0,0.392705167173252,0.295440729483283,0.311854103343465,1.47355623100304,1.23100303951368,1,9,4,3,0.242553191489362,5,0,-1,0
"1810","S1",10,"08.03.2020","Yes","Valladolid","Ath Bilbao",1,4,19,10,2,5,9,13,1,2,0,0,2.98,2.82,2.79,2.98,1.38,0,3,0.320016595080047,0.338173565013667,0.341809839906287,1.29822335025381,1.36360308473253,-3,9,-3,-3,-0.065379734478719,-4,-1,0,0
"1811","S1",10,"08.03.2020","Yes","Levante","Granada",1,1,11,10,3,7,21,13,3,3,0,0,2.06,3.44,3.66,1.95,1.85,1,1,0.462603430284681,0.277024147205361,0.260372422509957,1.6648344380594,1.05814141473523,0,1,-4,0,0.606693023324172,8,0,0,0
"1812","S1",10,"08.03.2020","Yes","Villarreal","Leganes",1,2,15,12,5,7,10,11,4,3,0,0,1.74,3.7,4.97,1.98,1.81,0,3,0.549338606952095,0.258337615161256,0.192323777886649,1.90635343601754,0.835308948821203,-1,3,-2,-3,1.07104448719634,-1,1,0,0
"1813","S1",10,"08.03.2020","Yes","Betis","Real Madrid",2,1,14,13,3,4,8,11,1,1,0,0,4.24,4.02,1.77,1.55,2.41,3,0,0.224708668877309,0.237006158218854,0.538285172903837,0.911132164850782,1.85186167693036,1,1,-1,3,-0.940729512079583,-3,0,0,0
"1814","S1",10,"10.03.2020","No","Eibar","Sociedad",1,2,13,6,4,2,12,10,3,2,0,0,3.34,3.33,2.24,2.07,1.75,0,3,0.286198825921805,0.287058281855504,0.426742892222691,1.14565475962092,1.56728695852358,-1,7,2,-3,-0.421632198902659,2,1,0,0
"1815","S1",10,"11.06.2020","No","Sevilla","Betis",2,0,13,12,5,1,13,16,0,2,0,0,1.85,3.68,4.35,1.87,1.94,3,0,0.518670921962836,0.260744892834578,0.220584185202586,1.81675765872309,0.922497448442335,2,1,4,3,0.894260210280752,-3,-2,0,0
"1816","S1",10,"12.06.2020","No","Granada","Getafe",2,1,10,6,4,2,17,16,6,4,0,0,3.31,2.94,2.46,2.82,1.42,3,0,0.288069974189848,0.324323678424625,0.387606347385527,1.18853360099417,1.48714272058121,1,4,2,3,-0.298609119587038,1,2,0,0
"1817","S1",10,"12.06.2020","No","Valencia","Levante",1,1,12,14,3,4,11,13,1,4,0,1,1.73,4.08,4.48,1.61,2.31,1,1,0.552431151623589,0.234241640271767,0.213327208104645,1.89153509514253,0.874223264585701,0,-2,-1,0,1.01731183055683,-2,-3,-1,0
"1818","S1",10,"13.06.2020","No","Espanol","Alaves",2,0,19,1,9,0,16,19,4,3,0,1,2.1,3.2,3.83,2.47,1.54,3,0,0.453606721196195,0.297679410785003,0.248713868018802,1.65849957437359,1.04382101484141,2,18,9,3,0.614678559532181,-3,1,-1,0
"1819","S1",10,"13.06.2020","No","Celta","Villarreal",0,1,4,15,0,4,5,20,1,1,0,0,2.59,3.35,2.75,1.94,1.87,0,3,0.368330567938748,0.284769006257122,0.34690042580413,1.38976071007337,1.32547028366951,-1,-11,-4,-3,0.0642904264038542,-15,0,0,0
"1820","S1",10,"13.06.2020","No","Leganes","Valladolid",1,2,11,6,2,2,21,20,2,4,0,0,2.31,3.02,3.51,2.78,1.43,0,3,0.412708053495299,0.315680663435146,0.271611283069556,1.55380482392104,1.13051451264381,-1,5,0,-3,0.423290311277229,1,-2,0,0
"1821","S1",10,"13.06.2020","No","Mallorca","Barcelona",0,4,13,12,3,7,16,5,1,2,0,0,9.91,6,1.28,1.45,2.72,0,3,0.0962107014361452,0.1589080085387,0.744881290025155,0.447540112847135,2.39355187861416,-4,1,-4,-3,-1.94601176576703,11,-1,0,0
"1822","S1",10,"14.06.2020","No","Ath Bilbao","Ath Madrid",1,1,10,9,3,2,10,9,3,0,0,0,3.74,2.96,2.27,2.74,1.44,1,1,0.255683158671811,0.323059126159654,0.421257715168535,1.09010860217509,1.58683227166526,0,1,1,0,-0.496723669490171,1,3,0,0
"1823","S1",10,"14.06.2020","No","Real Madrid","Eibar",3,1,6,9,5,5,11,12,1,1,0,0,1.24,6.41,11.84,1.51,2.53,3,0,0.77031070475943,0.149014863323197,0.0806744319173728,2.45994697760149,0.391038159075315,2,-3,0,3,2.06890881852617,-1,0,0,0
"1824","S1",10,"14.06.2020","No","Sociedad","Osasuna",1,1,9,8,4,1,5,12,1,3,0,0,1.69,3.89,5.01,1.78,2.03,1,1,0.564406499874022,0.245204880407994,0.190388619717984,1.93842438003006,0.816370739561945,0,1,3,0,1.12205364046812,-7,-2,0,0
"1825","S1",10,"15.06.2020","No","Levante","Sevilla",1,1,11,10,5,4,12,10,1,1,0,0,5.09,3.98,1.67,1.75,2.09,1,1,0.187730016297087,0.240086880138737,0.572183103564176,0.803276929029998,1.95663619083126,0,1,1,0,-1.15335926180127,2,0,0,0
"1826","S1",10,"15.06.2020","No","Betis","Granada",2,2,18,8,6,5,13,18,2,4,0,0,1.94,3.48,4.11,2.04,1.79,1,1,0.492734450898117,0.274685297339755,0.232580251762128,1.75288865003411,0.972426052626139,0,10,1,0,0.780462597407966,-5,-2,0,0
"1827","S1",10,"16.06.2020","No","Getafe","Espanol",0,0,21,5,4,3,15,9,3,2,0,1,2.01,3.14,4.32,2.64,1.47,1,1,0.474967961511797,0.304040000840354,0.22099203764785,1.72894388537574,0.967016113783903,0,16,1,0,0.761927771591841,6,1,-1,0
"1828","S1",10,"16.06.2020","No","Villarreal","Mallorca",1,0,10,15,4,5,16,10,3,4,0,0,1.52,4.45,6,1.67,2.2,3,0,0.626996054856284,0.214164944580124,0.158839000563592,2.09515310914898,0.6906819462709,1,-5,-1,3,1.40447116287808,6,-1,0,0
"1829","S1",10,"16.06.2020","No","Barcelona","Leganes",2,0,10,6,5,2,16,16,5,3,0,0,1.16,8.06,17.42,1.47,2.64,3,0,0.826097598286676,0.118892458314211,0.0550099433991127,2.59718525317424,0.28392228851155,2,4,3,3,2.31326296466269,0,2,0,0
"1830","S1",10,"17.06.2020","No","Eibar","Ath Bilbao",2,2,12,6,6,3,10,11,3,2,0,0,3.28,3.04,2.41,2.51,1.52,1,1,0.29070247278037,0.313652667999873,0.395644859219757,1.18576008634098,1.50058724565914,0,6,3,0,-0.31482715931816,-1,1,0,0
"1831","S1",10,"17.06.2020","No","Valladolid","Celta",0,0,6,11,1,4,18,15,3,3,0,0,2.95,2.96,2.68,2.66,1.46,1,1,0.322854770703437,0.321764045126736,0.355381184169828,1.29032835723705,1.38790759763622,0,-5,-3,0,-0.0975792403991729,3,0,0,0
"1832","S1",10,"17.06.2020","No","Osasuna","Ath Madrid",0,5,13,10,3,6,12,8,3,3,0,0,5.01,3.25,1.85,2.47,1.54,0,3,0.190489014209451,0.293646141904415,0.515864843886134,0.865113184532767,1.84124067356282,-5,3,-3,-3,-0.97612748903005,4,0,0,0
"1833","S1",10,"18.06.2020","No","Alaves","Sociedad",2,0,15,9,7,1,21,11,3,4,1,1,4.16,3.37,1.95,2.26,1.64,3,0,0.228950586530187,0.282621495538747,0.488427917931066,0.969473255129308,1.74790524933194,2,6,6,3,-0.778431994202636,10,-1,0,0
"1834","S1",10,"18.06.2020","No","Real Madrid","Valencia",3,0,19,4,14,2,12,11,0,2,0,1,1.38,5.09,7.71,1.51,2.51,3,0,0.689603728129135,0.186965254384716,0.123431017486149,2.25577643877212,0.557258306843162,3,15,12,3,1.69851813192896,1,-2,-1,0
"1835","S1",10,"19.06.2020","No","Granada","Villarreal",0,1,14,5,4,1,17,15,0,3,0,0,3.12,3.19,2.43,2.26,1.65,0,3,0.30655973044479,0.299832714416221,0.393607555138989,1.21951190575059,1.48065537983319,-1,9,3,-3,-0.261143474082599,2,-3,0,0
"1836","S1",10,"19.06.2020","No","Mallorca","Leganes",1,1,7,16,3,4,15,11,3,6,0,0,2.77,2.93,2.9,2.62,1.48,1,1,0.344760428627653,0.325933920579727,0.32930565079262,1.36021520646269,1.31385087295759,0,-9,-1,0,0.0463643335050983,4,-3,0,0
"1837","S1",10,"19.06.2020","No","Sevilla","Barcelona",0,0,8,10,4,4,17,8,3,2,0,0,3.4,3.57,2.13,1.72,2.14,1,1,0.281799281799282,0.268380268380268,0.44982044982045,1.11377811377811,1.61784161784162,0,-2,0,0,-0.504063504063504,9,1,0,0
"1838","S1",10,"20.06.2020","No","Espanol","Levante",1,3,10,14,3,8,11,10,2,0,0,0,1.99,3.51,3.85,2.08,1.76,0,3,0.479884516635357,0.272071278662211,0.248044204702431,1.71172482856828,1.01620389276951,-2,-4,-5,-3,0.695520935798778,1,2,0,0
"1839","S1",10,"20.06.2020","No","Ath Bilbao","Betis",1,0,12,9,3,5,16,11,4,0,0,0,2.14,3.29,3.61,2.21,1.67,3,0,0.445781052362918,0.289960927676792,0.26425801996029,1.62730408476555,1.08273498755766,1,3,-2,3,0.544569097207886,5,4,0,0
"1840","S1",10,"20.06.2020","No","Getafe","Eibar",1,1,9,8,2,2,18,15,3,0,0,0,1.82,3.37,4.95,2.47,1.55,1,1,0.524181511379812,0.283089124840136,0.192729363780052,1.85563365897957,0.861277216180292,0,1,0,0,0.99435644279928,3,3,0,0
"1841","S1",10,"20.06.2020","No","Ath Madrid","Valladolid",1,0,15,6,4,2,14,12,4,2,0,0,1.38,4.48,9.86,2.2,1.68,3,0,0.69061004971702,0.212732559957475,0.0966573903255058,2.28456270910853,0.502704730933992,1,9,2,3,1.78185797817454,2,2,0,0
"1842","S1",10,"21.06.2020","No","Celta","Alaves",6,0,15,4,10,2,14,10,1,1,0,1,1.94,3.25,4.48,2.62,1.49,3,0,0.492620837590759,0.294056746131099,0.213322416278141,1.77191925890338,0.934023994965523,6,11,8,3,0.837895263937854,4,0,-1,0
"1843","S1",10,"21.06.2020","No","Valencia","Osasuna",2,0,7,13,3,3,7,19,1,2,0,0,1.94,3.57,3.94,1.89,1.91,3,0,0.491206626808962,0.266930211767335,0.241863161423702,1.74055009219422,0.992519696038442,2,-6,0,3,0.748030396155781,-12,-1,0,0
"1844","S1",10,"21.06.2020","No","Sociedad","Real Madrid",1,2,10,10,2,6,16,15,4,2,0,0,4.16,4.14,1.77,1.58,2.39,0,3,0.229615145988832,0.230724397901822,0.539660456109346,0.919569835868319,1.84970576622986,-1,0,-4,-3,-0.930135930361541,1,2,0,0
"1845","S1",10,"22.06.2020","No","Villarreal","Sevilla",2,2,7,14,5,6,16,12,3,3,0,0,2.61,3.42,2.67,1.86,1.93,1,1,0.364872154493473,0.278455065271335,0.356672780235193,1.37307152875175,1.34847340597691,0,-7,-1,0,0.0245981227748409,4,0,0,0
"1846","S1",10,"22.06.2020","No","Leganes","Granada",0,0,9,4,3,1,12,16,4,4,0,0,2.43,2.96,3.34,2.89,1.4,1,1,0.392389086896814,0.322130230121371,0.285480682981814,1.49929749081181,1.17857227906681,0,5,2,0,0.320725211745001,-4,0,0,0
"1847","S1",10,"23.06.2020","No","Levante","Ath Madrid",0,1,12,12,0,7,12,14,4,2,0,0,5.84,3.65,1.67,2.17,1.7,0,3,0.164014928304852,0.262423885287763,0.573561186407386,0.754468670202318,1.98310744450992,-1,0,-7,-3,-1.2286387743076,-2,2,0,0
"1848","S1",10,"23.06.2020","No","Valladolid","Getafe",1,1,6,15,2,1,12,19,5,2,0,0,3.39,2.81,2.53,3.16,1.35,1,1,0.281981921235607,0.340184595369647,0.377833483394746,1.18613035907647,1.47368504555389,0,-9,1,0,-0.287554686477418,-7,3,0,0
"1849","S1",10,"23.06.2020","No","Barcelona","Ath Bilbao",1,0,18,6,4,0,10,16,2,1,0,0,1.33,5.35,9.42,1.67,2.21,3,0,0.719534673213299,0.178874974836203,0.101590351950498,2.3374789944761,0.483646030687696,1,12,4,3,1.8538329637884,-6,1,0,0
"1850","S1",10,"24.06.2020","No","Alaves","Osasuna",0,1,5,7,0,1,12,14,2,3,0,0,2.63,3.07,2.91,2.4,1.57,0,3,0.362258780021978,0.310338954872248,0.327402265105774,1.39711529493818,1.29254575018957,-1,-2,-1,-3,0.104569544748612,-2,-1,0,0
"1851","S1",10,"24.06.2020","No","Sociedad","Celta",0,1,13,4,6,1,18,15,4,2,0,0,2.07,3.23,3.92,2.08,1.74,0,3,0.461057238885591,0.295476310988599,0.24346645012581,1.67864802764537,1.02587566136603,-1,9,5,-3,0.652772366279345,3,2,0,0
"1852","S1",10,"24.06.2020","No","Real Madrid","Mallorca",2,0,14,11,6,4,18,12,4,1,0,0,1.15,8.33,17.41,1.38,2.98,3,0,0.830489450901726,0.114653405586673,0.0548571435116016,2.60612175829185,0.279224836121478,2,3,2,3,2.32689692217037,6,3,0,0
"1853","S1",10,"25.06.2020","No","Eibar","Valencia",1,0,14,7,5,0,12,7,4,2,0,1,2.82,3.36,2.51,2.02,1.79,3,0,0.337519510145276,0.283275303157642,0.379205186697083,1.29583383359347,1.42089086324889,1,7,5,3,-0.125057029655421,5,2,-1,0
"1854","S1",10,"25.06.2020","No","Betis","Espanol",1,0,13,9,6,2,18,18,4,4,0,0,2.2,3.36,3.34,2.05,1.77,3,0,0.432255877730872,0.283024681847595,0.284719440421533,1.57979231504021,1.13718300311219,1,4,4,3,0.442609311928019,0,0,0,0
"1855","S1",10,"26.06.2020","No","Sevilla","Valladolid",1,1,15,11,3,5,16,17,3,2,0,0,1.43,4.32,8.86,2.32,1.62,1,1,0.670053533977795,0.221800128145428,0.108146337876777,2.23196073007881,0.546239141775759,0,4,-2,0,1.68572158830305,-1,1,0,0
"1856","S1",10,"27.06.2020","No","Ath Bilbao","Mallorca",3,1,12,14,6,2,17,16,1,2,0,0,1.48,4.11,7.84,2.19,1.68,3,0,0.645630795617571,0.232489921536254,0.121879282846174,2.16938230838897,0.598127770074777,2,-2,4,3,1.57125453831419,1,-1,0,0
"1857","S1",10,"27.06.2020","No","Celta","Barcelona",2,2,10,18,6,2,19,10,3,4,0,0,5.17,4.05,1.64,1.81,2.01,1,1,0.184196587288161,0.235134902785135,0.580668509926704,0.787724664649619,1.97714043256525,0,-8,4,0,-1.18941576791563,9,-1,0,0
"1858","S1",10,"27.06.2020","No","Osasuna","Leganes",2,1,6,21,5,7,12,15,1,1,0,0,2.35,2.98,3.48,2.65,1.47,3,0,0.405864257927159,0.320060740311685,0.274075001761156,1.53765351409316,1.14228574559515,1,-15,-2,3,0.395367768498008,-3,0,0,0
"1859","S1",10,"27.06.2020","No","Ath Madrid","Alaves",2,1,14,6,4,2,13,14,3,2,0,0,1.33,4.76,11.77,2.17,1.69,3,0,0.718178799924625,0.200667605861292,0.0811535942140825,2.35520400563517,0.44412838850354,1,8,2,3,1.91107561713163,-1,1,0,0
"1860","S1",10,"28.06.2020","No","Levante","Betis",4,2,9,17,4,8,13,14,0,4,0,0,2.65,3.41,2.65,1.79,2.03,3,0,0.360084477296727,0.279831045406547,0.360084477296727,1.36008447729673,1.36008447729673,2,-8,-4,3,0,-1,-4,0,0
"1861","S1",10,"28.06.2020","No","Villarreal","Valencia",2,0,17,4,4,0,9,18,0,2,0,0,2.2,3.54,3.21,1.84,1.97,3,0,0.433495845636201,0.269404197853007,0.297099956510792,1.56989173476161,1.16070406738538,2,13,4,3,0.409187667376228,-9,-2,0,0
"1862","S1",10,"28.06.2020","No","Granada","Eibar",1,2,14,13,5,6,8,13,1,0,0,0,2.43,2.97,3.31,2.62,1.48,0,3,0.39180027978048,0.320563865274938,0.287635854944582,1.49596470461638,1.18347143010868,-1,1,-1,-3,0.312493274507694,-5,1,0,0
"1863","S1",10,"28.06.2020","No","Espanol","Real Madrid",0,1,8,14,5,6,18,12,1,1,0,0,7.04,4.79,1.43,1.68,2.19,0,3,0.135266644944064,0.198805256869773,0.665928098186163,0.604605191701966,2.19658955142826,-1,-6,-1,-3,-1.5919843597263,6,0,0,0
"1864","S1",10,"29.06.2020","No","Getafe","Sociedad",2,1,11,5,4,1,22,11,6,3,0,0,2.51,3.04,3.1,2.55,1.51,3,0,0.379458353801429,0.313302785539995,0.307238860658576,1.45167784694428,1.23501936751572,1,6,3,3,0.216658479428558,11,3,0,0
"1865","S1",10,"30.06.2020","No","Mallorca","Celta",5,1,9,12,7,8,16,12,3,2,0,0,3.22,3.13,2.41,2.42,1.57,3,0,0.297189751832985,0.305735144058214,0.397075104108801,1.19730439955717,1.49696045638462,4,-3,-1,3,-0.299656056827449,4,1,0,0
"1866","S1",10,"30.06.2020","No","Leganes","Sevilla",0,3,9,11,3,6,23,10,4,3,0,0,4.5,3.23,1.95,2.55,1.52,0,3,0.212726075282436,0.296367597142712,0.490906327574852,0.93454582299002,1.76908657986727,-3,-2,-3,-3,-0.834540756877248,13,1,0,0
"1867","S1",10,"30.06.2020","No","Barcelona","Ath Madrid",2,2,12,10,5,3,11,15,3,5,0,0,1.84,3.62,4.45,2.02,1.8,1,1,0.520353513492561,0.264489078681302,0.215157407826138,1.82554961915898,0.909961302159714,0,2,2,0,0.91558831699927,-4,-2,0,0
"1868","S1",10,"01.07.2020","No","Alaves","Granada",0,2,11,7,4,4,18,17,3,2,0,0,2.34,3.01,3.46,2.74,1.45,0,3,0.40754625426541,0.316829978399023,0.275623767335566,1.53946874119525,1.14370128040572,-2,4,0,-3,0.395767460789532,1,1,0,0
"1869","S1",10,"01.07.2020","No","Valencia","Ath Bilbao",0,2,10,12,1,4,9,12,1,0,0,0,2.51,3.05,3.1,2.45,1.55,0,3,0.37984854267521,0.312596669545829,0.307554787778961,1.45214229757146,1.23526103288271,-2,-2,-3,-3,0.216881264688749,-3,1,0,0
"1870","S1",10,"01.07.2020","No","Betis","Villarreal",0,2,9,15,1,6,10,16,4,1,1,0,2.81,3.49,2.46,1.77,2.06,0,3,0.339278163517738,0.273172389537204,0.387549446945058,1.29100688009042,1.43582073037238,-2,-6,-5,-3,-0.144813850281961,-6,3,1,0
"1871","S1",10,"01.07.2020","No","Valladolid","Levante",0,0,15,8,4,3,10,12,2,1,0,0,2.4,3.23,3.1,2.23,1.66,1,1,0.397262447926999,0.295179527871454,0.307558024201547,1.48696687165245,1.2178536004761,0,7,1,0,0.269113271176354,-2,1,0,0
"1872","S1",10,"02.07.2020","No","Eibar","Osasuna",0,2,11,9,4,6,8,12,1,1,0,0,2.38,3.19,3.17,2.28,1.63,0,3,0.40050140401044,0.298806690139451,0.30069190585011,1.50031090217077,1.20088240768978,-2,2,-2,-3,0.299428494480992,-4,0,0,0
"1873","S1",10,"02.07.2020","No","Sociedad","Espanol",2,1,12,4,4,3,11,15,2,1,0,0,1.9,3.42,4.36,2.19,1.68,3,0,0.502175582288201,0.278986434604556,0.218837983107243,1.78551318146916,0.935500383926286,1,8,1,3,0.850012797542872,-4,1,0,0
"1874","S1",10,"02.07.2020","No","Real Madrid","Getafe",1,0,8,10,4,3,15,22,5,5,0,0,1.38,4.83,8.76,1.81,2,3,0,0.692881355932203,0.197966101694915,0.109152542372881,2.27661016949153,0.525423728813559,1,-2,1,3,1.75118644067797,-7,0,0,0
"1875","S1",10,"03.07.2020","No","Ath Madrid","Mallorca",3,0,15,13,3,1,14,11,2,1,0,0,1.3,5.39,11.01,1.9,1.92,3,0,0.735693414278258,0.17743997004856,0.0868666156731822,2.38452021288333,0.438039817068106,3,2,2,3,1.94648039581523,3,1,0,0
"1876","S1",10,"04.07.2020","No","Celta","Betis",1,1,5,10,1,3,20,18,5,4,0,0,2.18,3.4,3.38,2.05,1.78,1,1,0.437417213501621,0.28046162512751,0.282121161370868,1.59271326563237,1.12682510924012,0,-5,-2,0,0.46588815639226,2,1,0,0
"1877","S1",10,"04.07.2020","No","Valladolid","Alaves",1,0,5,7,3,0,13,17,0,0,0,0,2.6,2.78,3.28,2.89,1.4,3,0,0.366577686295951,0.342842440420674,0.290579873283376,1.44257549930853,1.2145820602708,1,-2,3,3,0.227993439037725,-4,0,0,0
"1878","S1",10,"04.07.2020","No","Granada","Valencia",2,2,17,4,4,3,18,14,2,2,0,0,2.89,3.22,2.55,2.24,1.65,1,1,0.329940569711046,0.296126784616436,0.373932645672519,1.28594849374957,1.41792472163399,0,13,1,0,-0.131976227884419,4,0,0,0
"1879","S1",10,"05.07.2020","No","Ath Bilbao","Real Madrid",0,1,7,10,1,4,13,8,4,3,0,0,5.12,3.74,1.71,1.98,1.84,0,3,0.186458072152866,0.255258109471303,0.558283818375832,0.8146323259299,1.9301095645988,-1,-3,-3,-3,-1.1154772386689,5,1,0,0
"1880","S1",10,"05.07.2020","No","Espanol","Leganes",0,1,7,4,2,2,14,22,4,3,1,0,2.66,2.98,2.97,2.61,1.48,0,3,0.358649139300418,0.320136480046682,0.3212143806529,1.39608389794794,1.28377962200538,-1,3,0,-3,0.112304275942555,-8,1,1,0
"1881","S1",10,"05.07.2020","No","Osasuna","Getafe",0,0,6,6,2,1,17,18,5,4,0,0,3.06,2.98,2.58,2.73,1.44,1,1,0.311246052951178,0.319601651688122,0.3691522953607,1.25333981054166,1.42705853777022,0,0,1,0,-0.173718727228564,-1,1,0,0
"1882","S1",10,"05.07.2020","No","Villarreal","Barcelona",1,4,11,18,4,12,11,11,1,0,0,0,4.31,3.98,1.77,1.57,2.4,0,3,0.221339675936545,0.239691960624751,0.538968363438705,0.903710988434385,1.85659705094086,-3,-7,-8,-3,-0.95288606250648,0,1,0,0
"1883","S1",10,"06.07.2020","No","Levante","Sociedad",1,1,9,8,4,3,17,12,3,2,0,0,2.94,3.42,2.4,1.85,1.96,1,1,0.324185980378217,0.278686193658467,0.397127825963316,1.25124413479312,1.47006967154841,0,1,1,0,-0.218825536755296,5,1,0,0
"1884","S1",10,"06.07.2020","No","Sevilla","Eibar",1,0,8,19,3,3,11,16,2,1,0,0,1.46,4.36,7.41,1.97,1.84,3,0,0.652786926319107,0.218593787253646,0.128619286427247,2.17695456621097,0.604451646535386,1,-11,0,3,1.57250291967558,-5,1,0,0
"1885","S1",10,"07.07.2020","No","Valencia","Valladolid",2,1,10,11,4,5,9,5,3,0,0,0,2.03,3.18,4.18,2.51,1.53,3,0,0.470807418216851,0.300546873893147,0.228645707890002,1.7129691285437,0.986483997563153,1,-1,-1,3,0.726485130980548,4,3,0,0
"1886","S1",10,"07.07.2020","No","Celta","Ath Madrid",1,1,9,10,4,2,14,13,3,3,0,0,4.41,3.16,1.99,2.62,1.49,1,1,0.216842127041817,0.302618284890638,0.480539588067545,0.95314466601609,1.74423704909327,0,-1,2,0,-0.791092383077183,1,0,0,0
"1887","S1",10,"08.07.2020","No","Betis","Osasuna",3,0,14,8,8,2,9,17,1,5,0,0,2.1,3.43,3.53,1.94,1.87,3,0,0.45307384027032,0.277392147104277,0.269534012625403,1.63661366791524,1.08599418498049,3,6,6,3,0.550619482934751,-8,-4,0,0
"1888","S1",10,"08.07.2020","No","Getafe","Villarreal",1,3,5,6,2,3,19,10,4,1,0,1,2.61,3.08,2.91,2.46,1.55,0,3,0.364390345046287,0.308785324860652,0.326824330093061,1.40195635999951,1.28925831513984,-2,-1,-1,-3,0.112698044859676,9,3,-1,0
"1889","S1",10,"08.07.2020","No","Barcelona","Espanol",1,0,9,11,2,2,8,12,0,2,1,1,1.14,8.41,20.7,1.46,2.7,3,0,0.839894747202232,0.113850179763442,0.0462550730343258,2.63353442137014,0.252615398866419,1,-2,0,3,2.38091902250372,-4,-2,0,0
"1890","S1",10,"09.07.2020","No","Eibar","Leganes",0,0,4,10,1,1,21,13,3,3,0,0,2.5,3.05,3.1,2.49,1.53,1,1,0.380789367700362,0.312122432541281,0.307088199758357,1.45449053564237,1.23338703181635,0,-6,0,0,0.221103503826017,8,0,0,0
"1891","S1",10,"09.07.2020","No","Mallorca","Levante",2,0,15,14,5,2,11,20,3,1,0,0,2.09,3.66,3.37,1.82,1.99,3,0,0.456367544927461,0.260603324835627,0.283029130236912,1.62970595961801,1.10969071554636,2,1,3,3,0.520015244071647,-9,2,0,0
"1892","S1",10,"09.07.2020","No","Ath Bilbao","Sevilla",1,2,13,20,4,7,18,9,3,2,0,0,3.05,3.02,2.55,2.55,1.5,0,3,0.311913971526357,0.315012454687215,0.373073573786427,1.25075436926629,1.4342331760465,-1,-7,-3,-3,-0.18347880678021,9,1,0,0
"1893","S1",10,"10.07.2020","No","Sociedad","Granada",2,3,19,4,5,3,12,13,2,3,0,0,1.74,3.7,4.88,1.95,1.86,0,3,0.547397014418588,0.257424541915768,0.195178443665644,1.89961558517153,0.8429598729127,-1,15,2,-3,1.05665571225883,-1,-1,0,0
"1894","S1",10,"10.07.2020","No","Real Madrid","Alaves",2,0,18,10,8,4,5,17,0,1,0,0,1.22,6.33,13.66,1.62,2.29,3,0,0.780003896961453,0.150332504627642,0.0696635984109057,2.490344195512,0.359323299860359,2,8,4,3,2.13102089565164,-12,-1,0,0
"1895","S1",10,"11.07.2020","No","Osasuna","Celta",2,1,15,12,5,3,10,11,2,2,0,0,3.1,3.11,2.46,2.35,1.6,3,0,0.3070359906251,0.306048736635952,0.386915272738948,1.22715670851125,1.46679455485279,1,3,2,3,-0.239637846341542,-1,0,0,0
"1896","S1",10,"11.07.2020","No","Valladolid","Barcelona",0,1,13,9,4,6,15,13,2,2,0,0,9.63,4.99,1.34,1.73,2.12,0,3,0.0988491303801492,0.190764955022212,0.710385914597639,0.487312346162659,2.32192269881513,-1,4,-2,-3,-1.83461035265247,2,0,0,0
"1897","S1",10,"11.07.2020","No","Ath Madrid","Betis",1,0,9,21,4,3,10,10,1,3,1,0,1.49,4.18,7.41,1.99,1.82,3,0,0.642038517584971,0.228860619904691,0.129100862510338,2.1549761726596,0.616163207435706,1,-12,1,3,1.5388129652239,0,-2,1,0
"1898","S1",10,"12.07.2020","No","Espanol","Eibar",0,2,14,11,3,6,13,14,2,2,0,0,3.39,3.24,2.25,2.43,1.56,0,3,0.281455227770249,0.294485562389242,0.424059209840509,1.13885124569999,1.56666319191077,-2,3,-3,-3,-0.427811946210779,-1,0,0,0
"1899","S1",10,"12.07.2020","No","Levante","Ath Bilbao",1,2,5,12,1,5,10,15,0,1,0,0,3.55,3.28,2.16,2.16,1.69,0,3,0.268396169232634,0.290489756334101,0.441114074433265,1.095678264032,1.61383197963389,-1,-7,-4,-3,-0.518153715601891,-5,-1,0,0
"1900","S1",10,"12.07.2020","No","Leganes","Valencia",1,0,10,16,1,5,21,9,4,1,1,0,3.37,3.13,2.3,2.45,1.55,3,0,0.282334762197968,0.303983434059793,0.41368180374224,1.1509877206537,1.54502884528651,1,-6,-4,3,-0.394041124632816,12,3,1,0
"1901","S1",10,"12.07.2020","No","Sevilla","Mallorca",2,0,14,14,5,5,14,7,3,2,0,0,1.4,4.81,7.83,1.69,2.18,3,0,0.680337004568421,0.198019086568771,0.121643908862808,2.23903010027403,0.562950813157196,2,0,0,3,1.67607928711684,7,1,0,0
"1902","S1",10,"13.07.2020","No","Alaves","Getafe",0,0,3,14,1,4,26,15,4,2,0,0,3.66,2.91,2.32,2.95,1.39,1,1,0.260734561464488,0.327934190707913,0.411331247827598,1.11013787510138,1.56192793419071,0,-11,-3,0,-0.45179005908933,11,2,0,0
"1903","S1",10,"13.07.2020","No","Villarreal","Sociedad",1,2,9,11,3,6,12,11,2,2,0,0,2.28,3.5,3.07,1.78,2.04,0,3,0.417693569579313,0.272097525325953,0.310208905094734,1.52517823406389,1.20272424061016,-1,-2,-3,-3,0.322453993453737,1,0,0,0
"1904","S1",10,"13.07.2020","No","Granada","Real Madrid",1,2,13,11,4,5,18,18,2,2,0,0,7.12,4.51,1.45,1.73,2.11,0,3,0.13352812778843,0.210802720588385,0.655669151623185,0.611387103953674,2.17781017545794,-1,2,-1,-3,-1.56642307150427,0,0,0,0
"1905","S1",10,"16.07.2020","No","Eibar","Valladolid",3,1,13,17,7,8,19,13,4,0,0,0,2.19,3.12,3.67,2.44,1.55,3,0,0.435037328318231,0.305362740069528,0.259599931612241,1.61047472502422,1.08416253490625,2,-4,-1,3,0.526312190117969,6,4,0,0
"1906","S1",10,"16.07.2020","No","Ath Bilbao","Leganes",0,2,10,16,3,4,11,11,2,3,1,0,1.81,3.41,4.91,2.56,1.49,0,3,0.526474500271993,0.2794483417866,0.194077157941407,1.85887184260258,0.861679815610821,-2,-6,-1,-3,0.997192026991758,0,-1,1,0
"1907","S1",10,"16.07.2020","No","Barcelona","Osasuna",1,2,19,9,3,5,7,14,4,1,0,1,1.15,8,17.44,1.44,2.76,0,3,0.826657818647201,0.118832061430535,0.0545101199222638,2.59880551737214,0.282362421197327,-1,10,-2,-3,2.31644309617481,-7,3,-1,0
"1908","S1",10,"16.07.2020","No","Betis","Alaves",1,2,14,9,7,5,14,18,6,4,1,1,2.35,3.25,3.16,2.17,1.69,0,3,0.405392069789015,0.293129650462826,0.30147827974816,1.50930585982987,1.1975644897073,-1,5,2,-3,0.311741370122565,-4,2,0,0
"1909","S1",10,"16.07.2020","No","Celta","Levante",2,3,16,8,6,4,11,15,3,0,1,1,1.61,4.23,5.16,1.72,2.13,0,3,0.590796514791026,0.224865812958286,0.184337672250688,1.99725535733136,0.777878829710351,-1,8,2,-3,1.21937652762101,-4,3,0,0
"1910","S1",10,"16.07.2020","No","Getafe","Ath Madrid",0,2,15,11,6,3,14,11,1,2,1,0,3.56,2.95,2.33,2.87,1.4,0,3,0.267760797497497,0.323128284437658,0.409110918064845,1.12641067693015,1.55046103863219,-2,4,3,-3,-0.424050361702045,3,-1,1,0
"1911","S1",10,"16.07.2020","No","Mallorca","Granada",1,2,18,14,5,6,14,18,7,5,2,0,2.06,3.47,3.63,2.05,1.78,0,3,0.462715955051227,0.274695927206204,0.262588117742569,1.66284379235988,1.06246028043391,-1,4,-1,-3,0.600383511925972,-4,2,2,0
"1912","S1",10,"16.07.2020","No","Real Madrid","Villarreal",2,1,12,8,7,4,13,13,3,2,0,0,1.45,4.79,6.61,1.56,2.4,3,0,0.656996300208126,0.198881969791604,0.14412173000027,2.16987087041598,0.631247159792413,1,4,3,3,1.53862371062357,0,1,0,0
"1913","S1",10,"16.07.2020","No","Sociedad","Sevilla",0,0,11,8,4,3,16,13,1,2,0,0,2.41,3.42,2.91,1.92,1.89,1,1,0.394811068134484,0.278214817018744,0.326974114846772,1.4626480214222,1.25913716155906,0,3,1,0,0.203510859863136,3,-1,0,0
"1914","S1",10,"16.07.2020","No","Valencia","Espanol",1,0,9,18,3,6,9,18,2,4,1,0,1.54,4.21,6.22,1.9,1.9,3,0,0.619815188267485,0.226725745827061,0.153459065905454,2.08617131062951,0.687102943543424,1,-9,-3,3,1.39906836708609,-9,-2,1,0
"1915","S1",10,"19.07.2020","No","Alaves","Barcelona",0,5,8,16,0,8,17,15,0,0,0,0,5.44,4.3,1.57,1.69,2.14,0,3,0.174517498280934,0.22078492805774,0.604697573661326,0.744337422900542,2.03487764904172,-5,-8,-8,-3,-1.29054022614118,2,0,0,0
"1916","S1",10,"19.07.2020","No","Valladolid","Betis",2,0,13,10,4,3,17,10,2,2,0,0,2.62,3.27,2.73,2.08,1.75,3,0,0.362196769599669,0.290200469832151,0.34760276056818,1.37679077863116,1.33300875153669,2,3,1,3,0.0437820270944655,7,0,0,0
"1917","S1",10,"19.07.2020","No","Villarreal","Eibar",4,0,12,11,5,3,4,9,0,0,0,0,1.51,4.4,6,1.67,2.18,3,0,0.627018810564317,0.215181455443663,0.15779973399202,2.09623788713661,0.688580657419723,4,1,2,3,1.40765722971689,-5,0,0,0
"1918","S1",10,"19.07.2020","No","Ath Madrid","Sociedad",1,1,6,10,3,4,16,9,1,2,0,0,1.99,3.27,4.1,2.37,1.58,1,1,0.477571215354091,0.290632024022826,0.231796760623083,1.7233456700851,0.986022305892075,0,-4,-1,0,0.737323364193023,7,-1,0,0
"1919","S1",10,"19.07.2020","No","Espanol","Celta",0,0,8,9,1,3,10,11,2,3,0,0,5.6,3.74,1.65,2.12,1.71,1,1,0.169742813918306,0.254160363086233,0.576096822995461,0.76338880484115,1.98245083207262,0,-1,-2,0,-1.21906202723147,-1,-1,0,0
"1920","S1",10,"19.07.2020","No","Granada","Ath Bilbao",4,0,11,11,6,3,10,11,1,2,0,0,2.03,3.47,3.7,2.16,1.69,3,0,0.468677561956772,0.274183127023702,0.257139311019526,1.68021581289402,1.04560106008228,4,0,3,3,0.634614752811737,-1,-1,0,0
"1921","S1",10,"19.07.2020","No","Leganes","Real Madrid",2,2,15,7,7,4,9,11,4,1,0,0,2.73,3.58,2.43,1.82,1.96,1,1,0.346497150163104,0.26422827372773,0.389274576109166,1.30371972421704,1.43205200205523,0,8,3,0,-0.128332277838187,-2,3,0,0
"1922","S1",10,"19.07.2020","No","Levante","Getafe",1,0,13,13,4,4,10,12,2,4,0,0,4.86,3.55,1.77,2.06,1.75,3,0,0.195511952879239,0.267658617181155,0.536829429939606,0.854194475818873,1.87814690699997,1,0,0,3,-1.0239524311811,-2,-2,0,0
"1923","S1",10,"19.07.2020","No","Osasuna","Mallorca",2,2,12,12,5,4,17,10,2,0,0,0,1.81,3.72,4.33,1.88,1.91,1,1,0.52505207297714,0.25546888497006,0.2194790420528,1.83062510390148,0.91390601112846,0,0,1,0,0.916719092773021,7,2,0,0
"1924","S1",10,"19.07.2020","No","Sevilla","Valencia",1,0,16,8,4,2,11,6,0,1,0,0,1.93,3.63,3.88,1.92,1.87,3,0,0.49282857512763,0.262027314048575,0.245144110823795,1.74051303943146,0.997459646519961,1,8,2,3,0.743053392911504,5,-1,0,0
"1925","S2",10,"17.08.2019","Yes","Lugo","Extremadura UD",0,0,10,13,3,3,11,15,1,1,0,0,2.45,3.09,2.95,2.27,1.61,1,1,0.381186359169507,0.302235139147344,0.31657850168315,1.44579421665586,1.25197064419679,0,-3,0,0,0.193823572459071,-4,0,0,0
"1926","S2",10,"17.08.2019","Yes","Santander","Malaga",0,1,11,5,2,4,14,14,3,2,1,0,2.86,2.88,2.68,2.59,1.48,0,3,0.326773920406435,0.324504657070279,0.348721422523285,1.30482641828959,1.37066892464014,-1,6,-2,-3,-0.0658425063505501,0,1,1,0
"1927","S2",10,"17.08.2019","Yes","Almeria","Albacete",3,0,13,2,5,0,21,19,1,1,0,0,2.35,3.03,3.18,2.35,1.57,3,0,0.39768210690539,0.308433317236854,0.293884575857757,1.50147963795302,1.19008704481012,3,11,5,3,0.311392593142899,2,0,0,0
"1928","S2",10,"17.08.2019","Yes","Elche","Fuenlabrada",0,2,5,10,1,4,14,26,2,3,0,0,1.98,3.1,4.15,2.6,1.48,0,3,0.472630418809699,0.301873622336517,0.225495958853784,1.71976487876561,0.978361498897869,-2,-5,-3,-3,0.741403379867745,-12,-1,0,0
"1929","S2",10,"17.08.2019","Yes","Vallecano","Mirandes",2,2,15,11,6,3,11,11,2,4,1,1,1.51,3.89,6.7,2,1.8,1,1,0.619752270300733,0.240572218034475,0.139675511664792,2.09982902893667,0.659598753028851,0,4,3,0,1.44023027590782,0,-2,0,0
"1930","S2",10,"17.08.2019","Yes","Zaragoza","Tenerife",2,0,15,16,8,5,16,18,1,3,0,1,1.95,3.28,4,2.2,1.64,3,0,0.480304583394348,0.285546932200908,0.234148484404744,1.72646068238395,0.987992385415141,2,-1,3,3,0.738468296968809,-2,-2,-1,0
"1931","S2",10,"18.08.2019","Yes","La Coruna","Oviedo",3,2,12,14,5,4,13,19,0,3,0,0,1.78,3.18,5.19,2.5,1.5,3,0,0.525564599335091,0.294183958118384,0.180251442546525,1.87087775612366,0.834938285757958,1,-2,1,3,1.0359394703657,-6,-3,0,0
"1932","S2",10,"18.08.2019","Yes","Numancia","Alcorcon",0,1,6,12,1,6,19,19,2,6,0,0,2,3.03,4.19,2.56,1.49,0,3,0.467859683000623,0.308818272607672,0.223322044391705,1.71239732160954,0.978784405782788,-1,-6,-5,-3,0.733612915826752,0,-4,0,0
"1933","S2",10,"18.08.2019","Yes","Girona","Sp Gijon",1,1,21,10,6,5,11,12,2,1,0,1,2.19,3,3.59,2.56,1.48,1,1,0.427345340269263,0.311962098396562,0.260692561334175,1.59399811920435,1.09403978239909,0,11,1,0,0.499958336805266,-1,1,-1,0
"1934","S2",10,"18.08.2019","Yes","Cadiz","Ponferradina",3,1,11,6,3,2,18,17,1,2,0,1,1.68,3.35,5.71,2.53,1.49,3,0,0.556881799629105,0.27927206667967,0.163846133691225,1.94991746556698,0.770810467753346,2,5,1,3,1.17910699781364,1,-1,-1,0
"1935","S2",10,"18.08.2019","Yes","Las Palmas","Huesca",0,1,9,9,1,6,14,19,3,3,0,0,2.3,3.19,3.12,2.15,1.69,0,3,0.406804600707927,0.293307392359947,0.299888006932126,1.51372119448373,1.19297141315632,-1,0,-5,-3,0.320749781327404,-5,0,0,0
"1936","S2",10,"23.08.2019","Yes","Albacete","Girona",1,0,6,11,1,1,16,16,3,2,0,0,2.4,3,3.12,2.46,1.52,3,0,0.389221556886228,0.311377245508982,0.29940119760479,1.47904191616766,1.20958083832335,1,-5,0,3,0.269461077844311,0,1,0,0
"1937","S2",10,"24.08.2019","Yes","Oviedo","Lugo",1,1,12,24,5,9,12,13,2,5,1,1,1.75,3.47,4.76,2.16,1.67,1,1,0.534196644857486,0.269407529827262,0.196395825315252,1.87199746439972,0.858595005773019,0,-12,-4,0,1.0134024586267,-1,-3,0,0
"1938","S2",10,"24.08.2019","Yes","Santander","Almeria",1,1,8,14,2,5,14,22,2,2,0,0,2.21,3.02,3.47,2.49,1.52,1,1,0.422176832928455,0.308943973765525,0.268879193306019,1.57547447255089,1.11558155368358,0,-6,-3,0,0.459892918867309,-8,0,0,0
"1939","S2",10,"24.08.2019","Yes","Mirandes","Cadiz",1,2,9,14,1,5,13,15,4,1,1,0,2.73,2.94,2.74,2.48,1.52,0,3,0.341889483065954,0.3174688057041,0.340641711229947,1.34313725490196,1.33939393939394,-1,-5,-4,-3,0.00374331550802132,-2,3,1,0
"1940","S2",10,"24.08.2019","Yes","Alcorcon","Elche",1,2,20,4,7,3,18,21,5,1,1,0,2.07,3.08,3.83,2.45,1.52,0,3,0.45196761698231,0.303757456867981,0.244274926149708,1.65966030781491,1.03658223531711,-1,16,4,-3,0.623078072497807,-3,4,1,0
"1941","S2",10,"24.08.2019","Yes","Malaga","Las Palmas",1,1,12,12,3,2,15,14,1,4,0,0,1.93,3.19,4.18,2.32,1.58,1,1,0.483854229034447,0.292739392487926,0.223406378477627,1.74430207959127,0.962958527920808,0,0,1,0,0.781343551670459,1,-3,0,0
"1942","S2",10,"25.08.2019","Yes","Ponferradina","Zaragoza",1,1,14,8,4,3,10,15,2,1,0,0,2.71,2.98,2.73,2.26,1.61,1,1,0.344581630275948,0.313361146995913,0.342057222728139,1.34710603782376,1.33953281518033,0,6,1,0,0.00757322264342752,-5,1,0,0
"1943","S2",10,"25.08.2019","Yes","Sp Gijon","Vallecano",1,1,3,19,2,4,21,18,5,5,1,1,2.13,3.13,3.54,2.35,1.56,1,1,0.438172521384252,0.298181300494715,0.263646178121033,1.61269886464747,1.08911983485781,0,-16,-2,0,0.523579029789657,3,0,0,0
"1944","S2",10,"25.08.2019","Yes","Huesca","La Coruna",3,1,10,8,6,1,14,20,1,2,0,0,2.44,3.05,2.99,2.34,1.57,3,0,0.382255177703912,0.30580414216313,0.311940680132958,1.45256967527487,1.241626182562,2,2,5,3,0.210943492712861,-6,-1,0,0
"1945","S2",10,"25.08.2019","Yes","Tenerife","Numancia",3,2,10,11,4,5,15,8,3,0,0,0,1.84,3.21,4.65,2.36,1.56,3,0,0.507895838224636,0.291130324714433,0.200973837060931,1.81481783938834,0.894051835897226,1,-1,-1,3,0.920766003491114,7,3,0,0
"1946","S2",10,"25.08.2019","Yes","Extremadura UD","Fuenlabrada",1,2,13,15,4,6,10,12,1,4,0,0,2.25,2.96,3.44,2.47,1.52,0,3,0.41421504816454,0.31485941161156,0.2709255402239,1.55750455610518,1.12763603228326,-1,-2,-2,-3,0.429868523821921,-2,-3,0,0
"1947","S2",10,"30.08.2019","Yes","Zaragoza","Elche",1,0,19,3,5,1,15,12,4,1,0,0,1.84,3.38,4.45,2.09,1.72,3,0,0.510761268940037,0.278047554689251,0.211191176370712,1.81033136150936,0.911621083801387,1,16,4,3,0.898710277707975,3,3,0,0
"1948","S2",10,"31.08.2019","Yes","Fuenlabrada","Oviedo",2,1,13,9,5,5,20,12,0,1,0,1,2.59,3.06,2.81,2.38,1.56,3,0,0.361256874451199,0.305769707460329,0.332973418088472,1.38954033081393,1.30468996172574,1,4,0,3,0.0848503690881819,8,-1,-1,0
"1949","S2",10,"31.08.2019","Yes","Numancia","Mirandes",2,0,16,10,5,2,15,13,2,0,0,0,1.97,3.15,4.12,2.45,1.53,3,0,0.475386356726581,0.297305118333767,0.227308524939652,1.72346418851351,0.979230693152722,2,6,3,3,0.744233495360789,2,2,0,0
"1950","S2",10,"31.08.2019","Yes","Almeria","Huesca",1,0,12,9,5,1,18,13,2,2,0,0,2.37,3.12,3.05,2.31,1.59,3,0,0.394218460658936,0.299454407615923,0.306327131725141,1.48210978959273,1.21843580279135,1,3,4,3,0.263673986801387,5,0,0,0
"1951","S2",10,"31.08.2019","Yes","Las Palmas","Santander",2,2,13,7,5,3,18,21,5,3,1,0,2.35,3.02,3.19,2.36,1.56,1,1,0.397642329108072,0.309423666690056,0.292934004201871,1.50235065401427,1.18822567929567,0,6,2,0,0.314124974718603,-3,2,1,0
"1952","S2",10,"01.09.2019","Yes","Lugo","Alcorcon",2,4,18,12,7,8,9,12,2,3,0,0,2.34,2.91,3.35,2.47,1.52,0,3,0.399579454766794,0.321311314142371,0.279109231090835,1.52004967844275,1.15863900741488,-2,6,-1,-3,0.361410671027877,-3,-1,0,0
"1953","S2",10,"01.09.2019","Yes","Sp Gijon","Albacete",2,0,14,8,5,2,26,19,2,3,0,0,1.92,3.25,4.19,2.27,1.61,3,0,0.488042204406088,0.288320317679905,0.223637477914007,1.75244693089817,0.959232751421926,2,6,3,3,0.793214179476244,7,-1,0,0
"1954","S2",10,"01.09.2019","Yes","Vallecano","La Coruna",3,1,8,8,4,3,18,9,1,1,0,0,2.17,3.19,3.41,2.09,1.72,3,0,0.431664411366712,0.293640054127199,0.274695534506089,1.58863328822733,1.11772665764547,2,0,1,3,0.470906630581867,9,0,0,0
"1955","S2",10,"01.09.2019","Yes","Girona","Malaga",1,0,9,10,2,1,16,13,3,3,0,0,1.87,3.25,4.45,2.52,1.5,3,0,0.501100081423349,0.288325277618973,0.210574640957677,1.79162552188902,0.920049200492005,1,-1,1,3,0.871576321397017,3,0,0,0
"1956","S2",10,"01.09.2019","Yes","Ponferradina","Tenerife",4,0,11,9,5,2,11,11,2,3,0,0,2.53,3.17,2.79,2.31,1.59,3,0,0.369697071031764,0.29505791473513,0.335245014233105,1.40414912783042,1.30079295743445,4,2,3,3,0.103356170395977,0,-1,0,0
"1957","S2",10,"01.09.2019","Yes","Cadiz","Extremadura UD",2,1,19,6,5,2,17,21,3,2,0,0,1.66,3.5,5.58,2.35,1.57,3,0,0.56440519264337,0.267689319939427,0.167905487417203,1.96090489786954,0.771405782191037,1,13,3,3,1.1894991156785,-4,1,0,0
"1958","S2",10,"06.09.2019","Yes","Santander","Cadiz",1,2,16,12,5,5,16,19,3,4,1,0,2.89,2.85,2.71,2.66,1.45,0,3,0.324627289119406,0.329183461598275,0.346189249282319,1.30306532895649,1.36775120944523,-1,4,0,-3,-0.064685880488738,-3,-1,1,0
"1959","S2",10,"07.09.2019","Yes","La Coruna","Albacete",0,1,17,11,7,1,14,17,1,5,0,1,1.71,3.38,5.31,2.31,1.59,0,3,0.547060598578992,0.276767344251502,0.176172057169506,1.91794913998848,0.80528351576002,-1,6,6,-3,1.11266562422846,-3,-4,-1,0
"1960","S2",10,"07.09.2019","Yes","Malaga","Almeria",0,1,13,14,4,4,15,13,4,4,0,0,2.46,2.98,3.04,2.54,1.49,0,3,0.379547854066464,0.313318027182383,0.307134118751152,1.45196158938178,1.23472038343584,-1,-1,0,-3,0.217241205945937,2,0,0,0
"1961","S2",10,"07.09.2019","Yes","Extremadura UD","Numancia",0,0,22,5,8,1,18,19,1,4,0,2,2.12,3.06,3.7,2.45,1.53,1,1,0.441348447757005,0.305770820014657,0.252880732228338,1.62981616328567,1.06441301669967,0,17,7,0,0.565403146586001,-1,-3,-2,0
"1962","S2",10,"07.09.2019","Yes","Fuenlabrada","Ponferradina",1,1,19,3,3,2,11,21,2,2,0,0,2.03,3.09,3.95,2.38,1.56,1,1,0.460642268659871,0.302622590737715,0.236735140602415,1.68454939671733,1.01282801254496,0,16,1,0,0.671721384172369,-10,0,0,0
"1963","S2",10,"07.09.2019","Yes","Tenerife","Las Palmas",0,0,9,10,2,2,15,10,2,5,1,0,2.05,3.16,3.79,2.17,1.67,1,1,0.456697897719256,0.296275534912809,0.247026567367935,1.66636922807058,1.03735523701661,0,-1,0,0,0.629013991053962,5,-3,1,0
"1964","S2",10,"08.09.2019","Yes","Huesca","Sp Gijon",1,0,6,12,3,4,18,14,3,3,0,1,2.03,3.09,3.94,2.24,1.63,3,0,0.460365657673328,0.302440868956911,0.23719347336976,1.6835378419769,1.01402128906619,1,-6,-1,3,0.669516552910703,4,0,-1,0
"1965","S2",10,"08.09.2019","Yes","Girona","Vallecano",3,1,17,13,8,5,10,17,1,4,0,0,2.12,3.15,3.58,2.17,1.66,3,0,0.441463166383502,0.297111718327944,0.261425115288554,1.62150121747845,1.08138706419361,2,4,3,3,0.540114153284843,-7,-3,0,0
"1966","S2",10,"08.09.2019","Yes","Elche","Lugo",1,1,13,5,4,4,18,23,3,3,0,0,2.05,3.13,3.84,2.17,1.67,1,1,0.456870041850865,0.299227982681876,0.243901975467259,1.66983810823447,1.03093390908365,0,8,0,0,0.638904199150819,-5,0,0,0
"1967","S2",10,"08.09.2019","Yes","Mirandes","Oviedo",2,1,18,7,6,1,14,12,1,1,0,1,2.46,3.13,2.89,2.34,1.58,3,0,0.379196726877916,0.298026820485519,0.322776452636565,1.43561700111927,1.26635617839521,1,11,5,3,0.169260822724053,2,0,-1,0
"1968","S2",10,"08.09.2019","Yes","Alcorcon","Zaragoza",0,3,8,16,3,5,13,11,1,2,0,0,2.49,2.91,3.06,2.4,1.55,0,3,0.374616637007308,0.320548256408315,0.304835106584378,1.44439816743024,1.23505357616145,-3,-8,-2,-3,0.209344591268789,2,-1,0,0
"1969","S2",10,"13.09.2019","Yes","Vallecano","Santander",2,0,20,4,4,0,21,16,4,2,1,1,1.76,3.48,4.78,1.98,1.81,3,0,0.533632747337354,0.269883228538432,0.196484024124214,1.87078147055049,0.859335300911074,2,16,4,3,1.01144616963942,5,2,0,0
"1970","S2",10,"14.09.2019","Yes","Mirandes","Malaga",1,1,15,9,4,1,10,16,2,3,0,0,2.68,2.9,2.84,2.53,1.5,1,1,0.348699363229915,0.322246308088335,0.32905432868175,1.36834439777808,1.30940929413359,0,6,3,0,0.0589351036444923,-6,-1,0,0
"1971","S2",10,"14.09.2019","Yes","Numancia","Huesca",1,0,8,13,3,4,18,14,2,3,0,0,3.08,3.12,2.36,2.25,1.62,3,0,0.303742327239126,0.299848194838625,0.396409477922249,1.211075176556,1.48907662860537,1,-5,-1,3,-0.27800145204937,4,-1,0,0
"1972","S2",10,"14.09.2019","Yes","Las Palmas","Almeria",0,3,9,10,0,6,11,26,3,4,0,0,2.46,3.02,2.99,2.36,1.57,0,3,0.379173945176028,0.308863544746036,0.311962510077936,1.44638538027412,1.24475107497984,-3,-1,-6,-3,0.201634305294276,-15,-1,0,0
"1973","S2",10,"14.09.2019","Yes","Cadiz","Girona",2,0,8,10,1,1,16,7,3,2,0,1,2.24,2.99,3.44,2.58,1.48,3,0,0.416609960791938,0.312109134506335,0.271280904701727,1.56193901688215,1.12595184861152,2,-2,0,3,0.435987168270632,9,1,-1,0
"1974","S2",10,"14.09.2019","Yes","Ponferradina","Alcorcon",1,1,17,8,6,3,12,25,1,5,0,2,2.35,2.94,3.27,2.49,1.51,1,1,0.397144662973566,0.317445563941456,0.285409773084979,1.50887955286215,1.17367488319639,0,9,3,0,0.335204669665762,-13,-4,-2,0
"1975","S2",10,"15.09.2019","Yes","Albacete","Tenerife",0,4,7,14,4,7,20,25,6,3,0,0,2.37,2.95,3.24,2.37,1.56,0,3,0.394497344015057,0.3169351543443,0.288567501640643,1.50042718638947,1.18263765926623,-4,-7,-3,-3,0.31778952712324,-5,3,0,0
"1976","S2",10,"15.09.2019","Yes","Oviedo","Elche",0,2,9,7,2,3,28,25,2,2,2,0,1.83,3.43,4.33,2.1,1.71,0,3,0.511205498972557,0.272742292454746,0.216052208572697,1.80635878937242,0.920898918172838,-2,2,-1,-3,0.885459871199579,3,0,2,0
"1977","S2",10,"15.09.2019","Yes","Zaragoza","Extremadura UD",3,1,16,17,9,5,14,9,1,1,0,0,1.65,3.55,5.56,2.22,1.64,3,0,0.567681444944564,0.263851939199586,0.168466615855851,1.96689627403328,0.769251786767138,2,-1,4,3,1.19764448726614,5,0,0,0
"1978","S2",10,"15.09.2019","Yes","Lugo","Fuenlabrada",2,0,8,17,3,4,10,13,1,4,0,0,2.45,2.95,3.09,2.42,1.54,3,0,0.381186359169507,0.31657850168315,0.302235139147344,1.46013757919167,1.22328391912518,2,-9,-1,3,0.236853660066489,-3,-3,0,0
"1979","S2",10,"15.09.2019","Yes","Sp Gijon","La Coruna",1,1,7,12,4,3,21,21,4,4,0,0,2.3,2.96,3.36,2.42,1.53,1,1,0.406247957649827,0.315665642768446,0.278086399581727,1.53440951571793,1.14992484151363,0,-5,1,0,0.3844846742043,0,0,0,0
"1980","S2",10,"17.09.2019","Yes","Almeria","Girona",3,1,17,7,7,1,18,14,3,4,0,1,2,3.14,4.02,2.42,1.54,3,0,0.468503644758526,0.298409964814347,0.233086390427127,1.70392089908992,0.997669136095729,2,10,6,3,0.706251762994195,4,-1,-1,0
"1981","S2",10,"17.09.2019","Yes","Malaga","Vallecano",1,1,11,14,2,3,14,13,2,2,0,0,2.55,3.12,2.82,2.3,1.61,1,1,0.367435916710516,0.300308201157634,0.33225588213185,1.40261595128918,1.29707584755318,0,-3,-1,0,0.105540103735999,1,0,0,0
"1982","S2",10,"17.09.2019","Yes","Santander","Mirandes",4,0,17,11,8,2,17,20,1,4,0,1,2.01,3.12,4.01,2.47,1.52,3,0,0.466096675048896,0.300273819502654,0.233629505448449,1.69856384464934,1.001162335848,4,6,6,3,0.697401508801341,-3,-3,-1,0
"1983","S2",10,"17.09.2019","Yes","Alcorcon","Cadiz",3,0,13,3,7,1,15,19,5,6,0,3,3.23,2.82,2.48,2.83,1.41,3,0,0.290039232600383,0.332208057198311,0.377752710201306,1.20232575499946,1.46546618780223,3,10,6,3,-0.263140432802767,-4,-1,-3,0
"1984","S2",10,"18.09.2019","Yes","Huesca","Albacete",0,1,20,7,6,2,13,23,1,7,0,0,1.71,3.42,5.19,2.17,1.66,0,3,0.546603475513428,0.273301737756714,0.180094786729858,1.913112164297,0.813586097946287,-1,13,4,-3,1.09952606635071,-10,-6,0,0
"1985","S2",10,"18.09.2019","Yes","Lugo","Ponferradina",2,2,10,12,5,4,13,17,2,4,0,0,2.44,3.06,3,2.14,1.69,1,1,0.383036250751052,0.305427598638093,0.311536150610855,1.45453635089125,1.24003605047066,0,-2,1,0,0.214500300420589,-4,-2,0,0
"1986","S2",10,"18.09.2019","Yes","La Coruna","Numancia",3,3,17,12,4,4,15,18,3,0,1,0,1.81,3.3,4.67,2.29,1.6,1,1,0.516511544507268,0.283298756229744,0.200189699262988,1.83283338975155,0.883867854018708,0,5,0,0,0.948965535732839,-3,3,1,0
"1987","S2",10,"19.09.2019","Yes","Elche","Tenerife",1,1,9,8,2,2,15,16,2,0,0,0,2.1,3.09,3.75,2.18,1.66,1,1,0.446505982313161,0.303450667591469,0.25004335009537,1.64296861453095,1.05358071787758,0,1,0,0,0.589387896653373,-1,2,0,0
"1988","S2",10,"19.09.2019","Yes","Oviedo","Extremadura UD",1,1,14,13,5,3,15,16,3,4,0,0,1.76,3.35,4.87,2.27,1.61,1,1,0.530006464880107,0.278451157668355,0.191542377451538,1.86847055230868,0.853078290022968,0,1,2,0,1.01539226228571,-1,-1,0,0
"1989","S2",10,"19.09.2019","Yes","Las Palmas","Sp Gijon",1,0,9,6,5,2,19,20,4,5,0,0,2.58,2.98,2.87,2.35,1.57,3,0,0.361699428223433,0.313149169401495,0.325151402375072,1.39824745407179,1.28860337652671,1,3,3,3,0.109644077545082,-1,-1,0,0
"1990","S2",10,"20.09.2019","Yes","Mirandes","Alcorcon",2,2,16,9,4,2,20,8,3,4,0,0,2.79,2.9,2.74,2.68,1.45,1,1,0.335534761164786,0.32280758056888,0.341657658266333,1.32941186406324,1.34778055536788,0,7,2,0,-0.0183686913046412,12,-1,0,0
"1991","S2",10,"21.09.2019","Yes","Cadiz","La Coruna",0,0,14,7,4,3,9,25,2,2,0,0,2.42,3.03,3.07,2.48,1.52,1,1,0.386555075818335,0.308733756924215,0.30471116725745,1.46839898437922,1.22286725869656,0,7,1,0,0.245531725682656,-16,0,0,0
"1992","S2",10,"21.09.2019","Yes","Zaragoza","Lugo",0,0,25,5,4,2,11,12,1,4,0,0,1.45,4.22,6.94,1.92,1.87,1,1,0.644107607854177,0.221316595115772,0.134575797030051,2.1536394186783,0.625043986205926,0,20,2,0,1.52859543247238,-1,-3,0,0
"1993","S2",10,"21.09.2019","Yes","Vallecano","Almeria",1,1,14,4,5,1,11,24,1,1,0,0,2.29,3.11,3.21,2.21,1.65,1,1,0.408208244227364,0.300577774688317,0.291213981084319,1.52520250737041,1.17421971794127,0,10,4,0,0.350982789429136,-13,0,0,0
"1994","S2",10,"21.09.2019","Yes","Albacete","Malaga",1,0,6,14,3,5,12,14,2,2,0,0,2.56,2.81,3.08,2.65,1.45,3,0,0.364670588037011,0.332226585542615,0.303102826420373,1.42623834965365,1.24153506480373,1,-8,-2,3,0.184703284849915,-2,0,0,0
"1995","S2",10,"22.09.2019","Yes","Ponferradina","Oviedo",2,1,12,8,2,5,22,20,2,3,0,0,2.68,3.03,2.73,2.29,1.6,3,0,0.348897240253578,0.308595578838148,0.342507180908274,1.35528729959888,1.33611712156297,1,4,-3,3,0.0191701780359108,2,-1,0,0
"1996","S2",10,"22.09.2019","Yes","Girona","Las Palmas",1,0,10,12,3,4,18,13,2,1,0,0,1.52,3.88,6.57,2.09,1.72,3,0,0.61610224383453,0.241359641914558,0.142538114250911,2.08966637341815,0.668973984667292,1,-2,-1,3,1.42069238875086,5,1,0,0
"1997","S2",10,"22.09.2019","Yes","Numancia","Elche",1,1,17,10,4,6,14,19,1,2,1,0,1.93,3.26,4.09,2.21,1.64,1,1,0.484517913143331,0.28684649459099,0.228635592265679,1.74040023402098,0.972753271388028,0,7,-2,0,0.767646962632954,-5,-1,1,0
"1998","S2",10,"22.09.2019","Yes","Sp Gijon","Santander",1,1,14,8,4,3,21,17,5,2,0,0,1.7,3.45,5.26,2.35,1.57,1,1,0.550676700855738,0.271347939552103,0.177975359592159,1.92337804211932,0.805274018328579,0,6,1,0,1.11810402379074,4,3,0,0
"1999","S2",10,"22.09.2019","Yes","Extremadura UD","Huesca",0,1,17,11,8,3,11,19,1,4,0,0,2.99,2.98,2.52,2.32,1.58,0,3,0.313493024304309,0.314545014318753,0.371961961376938,1.25502408723168,1.43043089844957,-1,6,5,-3,-0.175406811217887,-8,-3,0,0
"2000","S2",10,"22.09.2019","Yes","Tenerife","Fuenlabrada",0,1,15,11,1,4,20,12,5,2,1,0,1.92,3.22,4.15,2.27,1.6,0,3,0.4856906,0.2896043,0.2247051,1.746676,0.9637195,-1,4,-3,-3,0.7829567,8,3,1,0
"2001","S2",10,"27.09.2019","Yes","Las Palmas","Albacete",3,2,10,7,4,4,24,15,4,4,0,0,1.94,3.22,4.18,2.32,1.59,3,0,0.4838867,0.2915342,0.224579,1.743194,0.9652713,1,3,0,3,0.7779232,9,0,0,0
"2002","S2",10,"28.09.2019","Yes","Fuenlabrada","Vallecano",2,2,12,12,5,4,12,17,1,6,0,0,3.06,3.11,2.38,2.23,1.63,1,1,0.3058443,0.3009272,0.3932284,1.21846,1.480613,0,0,1,0,-0.2621523,-5,-5,0,0
"2003","S2",10,"28.09.2019","Yes","Alcorcon","Extremadura UD",0,2,14,11,3,4,19,19,3,3,1,0,1.78,3.28,4.92,2.48,1.52,0,3,0.52508,0.284952,0.189968,1.860192,0.8548559,-2,3,-1,-3,1.005336,0,0,1,0
"2004","S2",10,"28.09.2019","Yes","Huesca","Girona",1,0,18,7,8,0,8,17,2,5,0,0,2.31,3.02,3.27,2.43,1.54,3,0,0.4046416,0.3095106,0.2858477,1.523435,1.167054,1,11,8,3,0.3563816,-9,-3,0,0
"2005","S2",10,"28.09.2019","Yes","Elche","Ponferradina",1,0,10,8,2,4,28,18,5,3,0,0,2.27,3.05,3.31,2.42,1.54,3,0,0.411512,0.3062729,0.2822152,1.540809,1.152918,1,2,-2,3,0.3878904,10,2,0,0
"2006","S2",10,"28.09.2019","Yes","Santander","Numancia",0,0,13,12,4,2,16,16,2,2,0,0,2.01,3.17,3.9,2.45,1.53,1,1,0.4652344,0.2949909,0.2397747,1.690694,1.014315,0,1,2,0,0.6763793,0,0,0,0
"2007","S2",10,"29.09.2019","Yes","Malaga","Sp Gijon",0,0,14,8,4,5,20,16,2,1,0,0,2.31,2.99,3.29,2.64,1.45,1,1,0.4040889,0.3121891,0.283722,1.524456,1.163355,0,6,-1,0,0.3611007,4,1,0,0
"2008","S2",10,"29.09.2019","Yes","Almeria","Cadiz",1,2,7,10,3,3,20,16,2,3,0,1,2.29,3.01,3.32,2.62,1.47,0,3,0.4080706,0.310459,0.2814704,1.534671,1.15487,-1,-3,0,-3,0.3798006,4,-1,-1,0
"2009","S2",10,"29.09.2019","Yes","Oviedo","Zaragoza",2,2,15,13,5,4,12,17,4,3,0,0,2.76,3.13,2.58,2.14,1.68,1,1,0.3388043,0.2987539,0.3624418,1.315167,1.386079,0,2,1,0,-0.07091252,-5,1,0,0
"2010","S2",10,"29.09.2019","Yes","La Coruna","Mirandes",1,1,8,11,3,4,20,10,2,1,0,0,1.57,3.74,6.03,2.23,1.63,1,1,0.5951846,0.2498502,0.1549652,2.035404,0.7147457,0,-3,-1,0,1.320658,10,1,0,0
"2011","S2",10,"29.09.2019","Yes","Lugo","Tenerife",1,4,14,8,6,5,12,21,2,4,0,0,2.56,3.11,2.8,2.22,1.64,0,3,0.3653052,0.3007014,0.3339934,1.396617,1.302681,-3,6,1,-3,0.09393563,-9,-2,0,0
"2012","S2",10,"01.10.2019","Yes","Albacete","Santander",0,0,11,4,2,3,17,26,2,5,0,0,2.28,2.95,3.44,2.5,1.51,1,1,0.4105643,0.3173175,0.2721182,1.54901,1.133672,0,7,-1,0,0.4153383,-9,-3,0,0
"2013","S2",10,"01.10.2019","Yes","Extremadura UD","Elche",2,0,16,5,8,1,17,17,2,5,0,1,2.52,2.99,2.97,2.37,1.57,3,0,0.3715684,0.3131614,0.3152702,1.427867,1.258972,2,11,7,3,0.1688947,0,-3,-1,0
"2014","S2",10,"01.10.2019","Yes","Numancia","Fuenlabrada",1,0,7,13,3,6,8,16,4,5,1,0,2.24,3,3.45,2.55,1.49,3,0,0.4173724,0.311638,0.2709896,1.563755,1.124607,1,-6,-3,3,0.4391483,-8,-1,1,0
"2015","S2",10,"01.10.2019","Yes","Vallecano","Alcorcon",1,1,11,9,5,4,24,18,7,5,0,0,1.62,3.72,5.5,2.07,1.75,1,1,0.5780249,0.2517205,0.1702546,1.985795,0.7624843,0,2,1,0,1.223311,6,2,0,0
"2016","S2",10,"02.10.2019","Yes","Cadiz","Huesca",1,0,13,7,4,4,14,15,0,2,0,0,2.08,3.02,3.89,2.6,1.48,3,0,0.4497523,0.3097632,0.2404845,1.65902,1.031217,1,6,0,3,0.6278033,-1,-2,0,0
"2017","S2",10,"02.10.2019","Yes","Mirandes","Lugo",1,1,17,6,5,2,14,16,4,1,0,0,2.42,2.95,3.15,2.48,1.52,1,1,0.3863103,0.3169054,0.2967844,1.475836,1.207259,0,11,3,0,0.2685776,-2,3,0,0
"2018","S2",10,"02.10.2019","Yes","Ponferradina","Las Palmas",0,2,17,8,5,4,12,24,3,7,0,0,2.16,3.18,3.42,2.33,1.58,0,3,0.432746,0.2939407,0.2733133,1.592179,1.113881,-2,9,1,-3,0.4782982,-12,-4,0,0
"2019","S2",10,"02.10.2019","Yes","Tenerife","Oviedo",0,1,12,7,2,1,12,11,4,4,0,0,1.92,3.25,4.19,2.24,1.63,0,3,0.4880422,0.2883203,0.2236375,1.752447,0.9592328,-1,5,1,-3,0.7932142,1,0,0,0
"2020","S2",10,"03.10.2019","Yes","Sp Gijon","Almeria",4,2,17,9,7,3,17,14,1,4,0,0,2.23,3,3.48,2.61,1.47,3,0,0.4194388,0.3117829,0.2687783,1.570099,1.118118,2,8,4,3,0.4519815,3,-3,0,0
"2021","S2",10,"03.10.2019","Yes","Zaragoza","Malaga",2,2,17,12,8,2,4,12,2,4,0,0,2.22,3.17,3.3,2.35,1.58,1,1,0.4213999,0.2951129,0.2834872,1.559313,1.145575,0,5,6,0,0.4137381,-8,-2,0,0
"2022","S2",10,"03.10.2019","Yes","Girona","La Coruna",3,1,15,9,5,4,14,10,3,3,0,0,2.12,3.1,3.65,2.37,1.57,3,0,0.441561,0.3019707,0.2564683,1.626654,1.071376,2,6,1,3,0.555278,4,0,0,0
"2023","S2",10,"04.10.2019","Yes","Alcorcon","Albacete",0,1,13,6,2,3,21,23,2,4,0,0,1.98,3.12,4.2,2.74,1.43,0,3,0.4748239,0.3013306,0.2238456,1.725802,0.9728672,-1,7,-1,-3,0.752935,-2,-2,0,0
"2024","S2",10,"05.10.2019","Yes","Lugo","Las Palmas",0,2,6,12,3,5,19,16,2,5,0,0,2.84,2.99,2.61,2.29,1.6,0,3,0.3291688,0.3126553,0.358176,1.300162,1.387183,-2,-6,-2,-3,-0.08702163,3,-3,0,0
"2025","S2",10,"05.10.2019","Yes","Elche","Vallecano",1,1,11,17,3,4,11,19,2,2,0,0,2.89,3.01,2.55,2.18,1.66,1,1,0.323262,0.3103745,0.3663636,1.28016,1.409465,0,-6,-1,0,-0.1293048,-8,0,0,0
"2026","S2",10,"05.10.2019","Yes","Ponferradina","Mirandes",2,0,8,13,3,0,22,13,2,3,0,0,1.85,3.26,4.55,2.35,1.58,3,0,0.5065656,0.2874682,0.2059662,1.807165,0.9053669,2,-5,3,3,0.9017981,9,-1,0,0
"2027","S2",10,"05.10.2019","Yes","Tenerife","Extremadura UD",1,2,19,16,4,7,10,13,4,1,1,0,2.06,3.19,3.69,2.26,1.61,0,3,0.4537136,0.2929937,0.2532927,1.654134,1.052872,-1,3,-3,-3,0.6012627,-3,3,1,0
"2028","S2",10,"06.10.2019","Yes","Fuenlabrada","Sp Gijon",2,0,9,10,3,0,18,12,3,6,0,0,2.7,2.9,2.81,2.58,1.48,3,0,0.3457948,0.3219469,0.3322583,1.359331,1.318722,2,-1,3,3,0.04060935,6,-3,0,0
"2029","S2",10,"06.10.2019","Yes","Oviedo","Numancia",1,1,13,14,3,4,15,12,2,3,0,0,1.72,3.5,4.94,2.29,1.6,1,1,0.5435945,0.2671378,0.1892677,1.897921,0.834941,0,-1,-1,0,1.06298,3,-1,0,0
"2030","S2",10,"06.10.2019","Yes","Zaragoza","Cadiz",0,2,16,13,3,4,9,18,2,3,0,0,2.04,3.19,3.73,2.34,1.58,0,3,0.4573696,0.2924872,0.2501432,1.664596,1.042917,-2,3,-1,-3,0.6216794,-9,-1,0,0
"2031","S2",10,"06.10.2019","Yes","La Coruna","Almeria",0,0,15,5,7,0,16,18,3,2,1,0,2.19,3.01,3.55,2.47,1.52,1,1,0.4265345,0.3103357,0.2631297,1.589939,1.099725,0,10,7,0,0.4902143,-2,1,1,0
"2032","S2",10,"06.10.2019","Yes","Huesca","Malaga",2,0,13,10,5,1,21,14,2,3,0,1,2.17,3.03,3.59,2.49,1.52,3,0,0.4309178,0.3086111,0.2604712,1.601364,1.090025,2,3,4,3,0.5113397,7,-1,-1,0
"2033","S2",10,"06.10.2019","Yes","Santander","Girona",0,3,8,9,0,3,13,22,2,5,0,0,2.42,3.01,3.09,2.4,1.55,0,3,0.3865245,0.3107605,0.302715,1.470334,1.218905,-3,-1,-3,-3,0.2514285,-9,-3,0,0
"2034","S2",10,"11.10.2019","Yes","Vallecano","Tenerife",2,1,15,7,4,1,19,22,3,3,0,0,1.76,3.59,4.53,1.95,1.86,3,0,0.5322627,0.2609421,0.2067952,1.85773,0.8813278,1,8,3,3,0.9764024,-3,0,0,0
"2035","S2",10,"12.10.2019","Yes","Girona","Elche",0,2,18,11,5,4,15,12,4,2,0,0,1.59,3.72,5.85,2.11,1.72,0,3,0.5885073,0.2515394,0.1599533,2.017061,0.7313992,-2,7,1,-3,1.285662,3,2,0,0
"2036","S2",10,"12.10.2019","Yes","Almeria","Lugo",0,0,16,11,5,3,23,11,4,4,0,0,1.51,3.82,6.8,2.28,1.61,1,1,0.6182966,0.2444052,0.1372982,2.099295,0.6562998,0,5,2,0,1.442995,12,0,0,0
"2037","S2",10,"12.10.2019","Yes","Sp Gijon","Alcorcon",1,3,20,10,5,6,18,17,5,2,0,0,1.79,3.29,4.87,2.63,1.46,0,3,0.5231139,0.2846121,0.1922739,1.853954,0.8614339,-2,10,-1,-3,0.9925201,1,3,0,0
"2038","S2",10,"12.10.2019","Yes","Extremadura UD","Ponferradina",1,1,14,13,2,4,16,18,5,2,0,0,1.95,3.15,4.2,2.43,1.54,1,1,0.48,0.2971429,0.2228571,1.737143,0.9657143,0,1,-2,0,0.7714286,-2,3,0,0
"2039","S2",10,"12.10.2019","Yes","Malaga","Cadiz",1,2,13,7,3,4,12,13,2,2,0,0,4.72,3.24,1.81,2.72,1.43,0,3,0.1974519,0.287646,0.5149022,0.8800016,1.832352,-1,6,-1,-3,-0.9523508,-1,0,0,0
"2040","S2",10,"13.10.2019","Yes","Mirandes","Fuenlabrada",2,1,9,8,2,2,13,21,2,2,0,0,2.85,2.96,2.62,2.58,1.48,3,0,0.3278018,0.31562,0.3565783,1.299025,1.385355,1,1,0,3,-0.08632948,-8,0,0,0
"2041","S2",10,"13.10.2019","Yes","Numancia","Zaragoza",0,1,9,14,2,5,16,12,0,3,0,0,3.04,3.19,2.33,2.13,1.7,0,3,0.3069651,0.292531,0.4005039,1.213426,1.494043,-1,-5,-3,-3,-0.2806162,4,-3,0,0
"2042","S2",10,"13.10.2019","Yes","Albacete","Oviedo",1,2,12,14,5,6,18,15,2,2,0,0,2.27,3.1,3.24,2.5,1.51,0,3,0.4110363,0.3009846,0.2879791,1.534093,1.164922,-1,-2,-1,-3,0.3691715,3,0,0,0
"2043","S2",10,"13.10.2019","Yes","Huesca","Santander",1,1,20,11,5,2,9,10,0,1,0,0,1.56,3.68,6.31,2.25,1.62,1,1,0.598394,0.253667,0.1479389,2.048849,0.6974838,0,9,3,0,1.351365,-1,-1,0,0
"2044","S2",10,"13.10.2019","Yes","Las Palmas","La Coruna",3,0,13,7,7,1,11,13,4,3,0,0,2.48,2.97,3.02,2.38,1.56,3,0,0.3764764,0.3143641,0.3091594,1.443793,1.241842,3,6,6,3,0.2019509,-2,1,0,0
"2045","S2",10,"16.10.2019","Yes","Fuenlabrada","Zaragoza",2,1,9,11,5,2,21,14,3,5,0,0,2,3.38,3.5,1.9,1.87,3,0,0.46229,0.2735444,0.2641657,1.660414,1.066041,1,-2,3,3,0.5943728,7,-2,0,0
"2046","S2",10,"18.10.2019","Yes","Cadiz","Las Palmas",2,0,7,18,2,4,15,10,2,3,0,0,2.03,2.96,4.25,2.57,1.49,3,0,0.462223,0.3169975,0.2207795,1.703667,0.9793359,2,-11,-2,3,0.7243306,5,-1,0,0
"2047","S2",10,"19.10.2019","Yes","Alcorcon","Almeria",2,2,10,10,4,5,23,15,7,4,1,1,2.35,2.94,3.3,2.79,1.42,1,1,0.3981778,0.3182714,0.2835508,1.512805,1.168924,0,0,-1,0,0.3438808,8,3,0,0
"2048","S2",10,"19.10.2019","Yes","Ponferradina","Numancia",1,1,12,14,3,2,10,16,2,3,0,0,2.04,3.1,3.91,2.44,1.54,1,1,0.4587569,0.3018916,0.2393514,1.678162,1.019946,0,-2,1,0,0.6582164,-6,-1,0,0
"2049","S2",10,"19.10.2019","Yes","Elche","Sp Gijon",0,1,12,8,2,2,10,21,2,5,0,0,2.42,2.99,3.09,2.5,1.51,0,3,0.3857227,0.3121903,0.302087,1.469358,1.218451,-1,4,0,-3,0.250907,-11,-3,0,0
"2050","S2",10,"19.10.2019","Yes","Lugo","Huesca",3,2,8,18,5,6,14,19,4,5,1,1,3,3.09,2.43,2.19,1.66,3,0,0.3119695,0.302883,0.3851475,1.238791,1.458326,1,-10,-1,3,-0.2195341,-5,-1,0,0
"2051","S2",10,"19.10.2019","Yes","Extremadura UD","Vallecano",0,3,12,12,4,5,20,23,5,4,0,0,3.13,3.18,2.3,2.12,1.7,0,3,0.2989406,0.2942403,0.4068191,1.191062,1.514698,-3,0,-1,-3,-0.3236357,-3,1,0,0
"2052","S2",10,"20.10.2019","Yes","Fuenlabrada","Albacete",0,1,11,5,0,2,15,21,2,4,0,0,1.89,3.14,4.52,2.48,1.52,0,3,0.4950367,0.2979679,0.2069954,1.783078,0.9189542,-1,6,-2,-3,0.8641237,-6,-2,0,0
"2053","S2",10,"20.10.2019","Yes","La Coruna","Malaga",0,2,10,17,2,9,11,17,1,1,0,0,1.97,3.15,4.11,2.5,1.5,0,3,0.4751236,0.2971408,0.2277356,1.722512,0.9803477,-2,-7,-7,-3,0.7421638,-6,0,0,0
"2054","S2",10,"20.10.2019","Yes","Oviedo","Girona",4,2,9,12,4,4,18,22,2,4,0,1,2.56,3.02,2.87,2.28,1.61,3,0,0.3650077,0.3094105,0.3255818,1.404434,1.286156,2,-3,0,3,0.1182778,-4,-2,-1,0
"2055","S2",10,"20.10.2019","Yes","Tenerife","Santander",3,3,16,12,8,7,14,17,1,5,0,0,1.73,3.49,4.89,2.35,1.57,1,1,0.540691,0.2680216,0.1912874,1.890095,0.8418838,0,4,1,0,1.048211,-3,-4,0,0
"2056","S2",10,"20.10.2019","Yes","Zaragoza","Mirandes",1,2,16,10,2,5,15,15,2,1,0,0,1.48,3.99,7.04,2.05,1.75,0,3,0.6324492,0.2345927,0.1329581,2.13194,0.6334669,-1,6,-3,-3,1.498473,0,1,0,0
"2057","S2",10,"25.10.2019","Yes","Albacete","Cadiz",1,0,11,7,4,2,15,13,2,2,0,0,3.39,2.85,2.37,2.79,1.42,3,0,0.2762543,0.3285972,0.3951485,1.15736,1.514043,1,4,2,3,-0.3566827,2,0,0,0
"2058","S2",10,"26.10.2019","Yes","Vallecano","Ponferradina",1,3,16,7,4,3,16,11,2,2,1,0,1.55,4.03,5.61,1.89,1.9,0,3,0.6020804,0.2315694,0.1663502,2.037811,0.73062,-2,9,1,-3,1.307191,5,0,1,0
"2059","S2",10,"26.10.2019","Yes","Mirandes","Tenerife",0,0,11,14,2,1,11,7,3,1,0,0,2.61,2.98,2.84,2.32,1.58,1,1,0.3578006,0.3133757,0.3288238,1.386777,1.299847,0,-3,1,0,0.08693042,4,2,0,0
"2060","S2",10,"26.10.2019","Yes","Santander","La Coruna",1,1,9,15,1,2,21,21,2,3,0,0,2.62,3.03,2.79,2.32,1.58,1,1,0.3566646,0.3084031,0.3349323,1.378397,1.3132,0,-6,-1,0,0.06519675,0,-1,0,0
"2061","S2",10,"26.10.2019","Yes","Malaga","Oviedo",2,1,22,9,7,5,18,14,7,5,0,1,2.34,2.97,3.27,2.58,1.48,3,0,0.3994448,0.314714,0.2858412,1.513048,1.172238,1,13,2,3,0.3408107,4,2,-1,0
"2062","S2",10,"26.10.2019","Yes","Numancia","Lugo",3,1,21,11,10,3,12,14,2,3,0,0,1.96,3.2,4.08,2.27,1.61,3,0,0.4778077,0.2926572,0.2295351,1.72608,0.9812624,2,10,7,3,0.7448179,-2,-1,0,0
"2063","S2",10,"27.10.2019","Yes","Girona","Alcorcon",0,0,8,7,3,0,17,20,4,5,0,0,1.63,3.53,5.82,2.25,1.62,1,1,0.5741105,0.2650992,0.1607904,1.987431,0.7474703,0,1,3,0,1.23996,-3,-1,0,0
"2064","S2",10,"27.10.2019","Yes","Sp Gijon","Zaragoza",4,0,14,9,6,2,9,15,0,2,0,1,2.32,3.16,3.1,2.09,1.72,3,0,0.4028093,0.2957334,0.3014573,1.504161,1.200105,4,5,4,3,0.3040561,-6,-2,-1,0
"2065","S2",10,"27.10.2019","Yes","Huesca","Elche",2,0,19,8,7,3,15,21,3,4,0,0,1.62,3.52,5.96,2.2,1.66,3,0,0.5773541,0.2657141,0.1569318,1.997776,0.7365095,2,11,4,3,1.261267,-6,-1,0,0
"2066","S2",10,"27.10.2019","Yes","Las Palmas","Fuenlabrada",1,3,19,7,3,4,15,17,4,6,0,1,1.99,3.05,4.19,2.38,1.55,0,3,0.4700575,0.3066932,0.2232493,1.716866,0.976441,-2,12,-1,-3,0.7404247,-2,-2,-1,0
"2067","S2",10,"27.10.2019","Yes","Almeria","Extremadura UD",3,2,12,13,4,5,15,16,2,0,0,0,1.75,3.36,4.95,2.22,1.64,3,0,0.533513,0.2778713,0.1886157,1.87841,0.8437184,1,-1,-1,3,1.034692,-1,2,0,0
"2068","S2",10,"01.11.2019","Yes","Numancia","Albacete",1,0,12,12,2,2,14,15,2,5,0,1,2.2,2.95,3.65,2.51,1.51,3,0,0.4258033,0.3175482,0.2566485,1.594958,1.087494,1,0,0,3,0.5074642,-1,-3,-1,0
"2069","S2",10,"01.11.2019","Yes","Cadiz","Sp Gijon",3,1,10,12,5,2,16,12,3,4,0,0,2.23,2.9,3.65,2.86,1.4,3,0,0.4201814,0.323105,0.2567136,1.583649,1.093246,2,-2,3,3,0.4904035,4,-1,0,0
"2070","S2",10,"01.11.2019","Yes","Ponferradina","Malaga",1,0,14,12,6,2,17,15,1,2,0,0,2.74,2.89,2.8,2.52,1.5,3,0,0.3416855,0.3239509,0.3343636,1.349007,1.327042,1,2,4,3,0.02196549,2,-1,0,0
"2071","S2",10,"01.11.2019","Yes","Oviedo","Almeria",0,0,15,6,1,1,20,27,1,3,0,0,2.34,3.07,3.18,2.28,1.62,1,1,0.40031,0.3051223,0.2945677,1.506052,1.188825,0,9,0,0,0.3172268,-7,-2,0,0
"2072","S2",10,"02.11.2019","Yes","Fuenlabrada","La Coruna",1,1,10,6,1,1,14,26,1,3,0,0,2.33,3,3.24,2.42,1.54,1,1,0.4006727,0.3111892,0.2881381,1.513207,1.175603,0,4,0,0,0.3376039,-12,-2,0,0
"2073","S2",10,"02.11.2019","Yes","Alcorcon","Santander",1,0,12,12,3,2,20,11,5,4,0,0,2.05,3.01,3.99,2.48,1.52,3,0,0.4556125,0.3103009,0.2340866,1.677138,1.012561,1,0,1,3,0.6645776,9,1,0,0
"2074","S2",10,"02.11.2019","Yes","Tenerife","Huesca",0,0,9,11,1,3,18,13,4,2,1,0,2.71,3.07,2.64,2.26,1.61,1,1,0.343731,0.3034238,0.3528451,1.334617,1.361959,0,-2,-2,0,-0.02734224,5,2,1,0
"2075","S2",10,"03.11.2019","Yes","Extremadura UD","Girona",1,3,19,11,3,5,13,15,3,3,0,0,3.28,2.95,2.35,2.37,1.56,0,3,0.2850945,0.3169864,0.3979191,1.17227,1.510744,-2,8,-2,-3,-0.3384739,-2,0,0,0
"2076","S2",10,"03.11.2019","Yes","Lugo","Vallecano",1,0,6,20,2,5,14,14,0,1,0,0,3.42,3.17,2.17,1.96,1.83,3,0,0.2736052,0.2951829,0.4312119,1.115999,1.588819,1,-14,-3,3,-0.4728201,0,-1,0,0
"2077","S2",10,"03.11.2019","Yes","Zaragoza","Las Palmas",3,0,14,12,7,6,13,16,2,5,0,1,1.88,3.41,4.07,2.02,1.78,3,0,0.4967127,0.2738475,0.2294398,1.763986,0.9621668,3,2,1,3,0.8018188,-3,-3,-1,0
"2078","S2",10,"03.11.2019","Yes","Elche","Mirandes",4,2,8,14,4,7,21,15,2,3,0,0,2,3.05,4.14,2.43,1.54,3,0,0.4675455,0.3065872,0.2258674,1.709224,0.9841893,2,-6,-3,3,0.7250343,6,-1,0,0
"2079","S2",10,"08.11.2019","Yes","Girona","Tenerife",1,0,17,7,5,0,13,17,2,6,0,1,1.81,3.3,4.75,2.25,1.63,3,0,0.5182589,0.2842572,0.1974839,1.839034,0.8767089,1,10,5,3,0.962325,-4,-4,-1,0
"2080","S2",10,"09.11.2019","Yes","Huesca","Oviedo",3,1,14,9,7,4,13,15,2,3,0,0,1.6,3.63,5.94,2.21,1.64,3,0,0.5847503,0.2577412,0.1575085,2.011992,0.7302667,2,5,3,3,1.281725,-2,-1,0,0
"2081","S2",10,"09.11.2019","Yes","Mirandes","Extremadura UD",2,0,15,11,6,2,13,13,3,2,1,0,2.23,3.06,3.41,2.44,1.54,3,0,0.4196889,0.3058517,0.2744593,1.564919,1.12923,2,4,4,3,0.4356888,0,1,1,0
"2082","S2",10,"09.11.2019","Yes","Albacete","Lugo",0,1,15,4,5,2,20,21,2,2,0,0,1.82,3.22,4.83,2.49,1.51,0,3,0.5149254,0.2910448,0.1940299,1.835821,0.8731343,-1,11,3,-3,0.9626866,-1,0,0,0
"2083","S2",10,"09.11.2019","Yes","Sp Gijon","Numancia",0,1,16,13,2,4,25,16,2,3,0,0,1.81,3.22,4.84,2.39,1.56,0,3,0.5165079,0.2903352,0.1931569,1.839859,0.8698059,-1,3,-2,-3,0.9700531,9,-1,0,0
"2084","S2",10,"09.11.2019","Yes","Las Palmas","Alcorcon",1,1,10,5,3,2,15,15,2,1,0,0,2.15,2.94,3.8,2.46,1.53,1,1,0.4353349,0.3183572,0.2463079,1.624362,1.057281,0,5,1,0,0.567081,0,1,0,0
"2085","S2",10,"10.11.2019","Yes","La Coruna","Elche",1,3,17,11,5,5,25,11,4,4,0,0,1.81,3.27,4.73,2.36,1.57,0,3,0.5164807,0.2858808,0.1976385,1.835323,0.8787963,-2,6,0,-3,0.9565267,14,0,0,0
"2086","S2",10,"10.11.2019","Yes","Almeria","Zaragoza",1,1,10,10,3,2,13,20,4,3,0,0,1.98,3.23,3.95,2.13,1.7,1,1,0.4729767,0.2899362,0.2370871,1.708866,1.001197,0,0,1,0,0.707669,-7,1,0,0
"2087","S2",10,"10.11.2019","Yes","Malaga","Fuenlabrada",0,0,15,7,4,0,20,22,3,3,0,0,2.03,2.97,4.16,2.76,1.42,1,1,0.4605149,0.3147627,0.2247224,1.696307,0.9889299,0,8,4,0,0.7073774,-2,0,0,0
"2088","S2",10,"10.11.2019","Yes","Santander","Ponferradina",2,2,8,14,4,7,15,16,5,3,1,0,2.2,3.05,3.48,2.5,1.51,1,1,0.4248999,0.3064852,0.2686149,1.581185,1.11233,0,-6,-3,0,0.4688551,-1,2,1,0
"2089","S2",10,"10.11.2019","Yes","Vallecano","Cadiz",1,1,16,8,6,5,17,11,5,3,0,0,2.5,3.07,2.89,2.27,1.61,1,1,0.3732201,0.3039252,0.3228548,1.423585,1.272489,0,8,1,0,0.151096,6,2,0,0
"2090","S2",10,"16.11.2019","Yes","Fuenlabrada","Huesca",3,2,9,12,2,4,17,12,3,2,0,0,2.9,2.89,2.65,2.58,1.48,3,0,0.3228098,0.3239267,0.3532635,1.292356,1.383717,1,-3,-2,3,-0.09136125,5,1,0,0
"2091","S2",10,"16.11.2019","Yes","Extremadura UD","La Coruna",2,0,15,10,4,5,20,12,3,2,0,0,2.65,2.98,2.82,2.39,1.56,3,0,0.3534845,0.3143403,0.3321752,1.374794,1.310866,2,5,-1,3,0.06392805,8,1,0,0
"2092","S2",10,"16.11.2019","Yes","Elche","Almeria",1,1,4,16,1,4,13,17,2,2,0,0,2.74,2.88,2.8,2.52,1.51,1,1,0.3413016,0.3247105,0.3339879,1.348615,1.326674,0,-12,-3,0,0.02194081,-4,0,0,0
"2093","S2",10,"16.11.2019","Yes","Numancia","Vallecano",2,2,13,14,4,4,9,16,1,3,0,0,2.66,3.01,2.76,2.17,1.68,1,1,0.3511866,0.3103509,0.3384624,1.363911,1.325738,0,-1,0,0,0.03817246,-7,-2,0,0
"2094","S2",10,"16.11.2019","Yes","Zaragoza","Albacete",0,1,15,6,7,2,9,22,1,2,0,0,1.79,3.36,4.74,2.24,1.63,0,3,0.5234574,0.2788657,0.1976769,1.849238,0.8718965,-1,9,5,-3,0.9773413,-13,-1,0,0
"2095","S2",10,"17.11.2019","Yes","Ponferradina","Girona",1,1,19,7,5,5,11,11,2,0,0,0,3.1,2.97,2.43,2.48,1.51,1,1,0.301251,0.3144371,0.384312,1.21819,1.467373,0,12,0,0,-0.2491829,0,2,0,0
"2096","S2",10,"17.11.2019","Yes","Alcorcon","Malaga",1,0,12,14,6,3,15,11,3,1,0,0,1.71,3.31,5.5,2.67,1.45,3,0,0.547188,0.2826863,0.1701257,1.92425,0.7930634,1,-2,3,3,1.131187,4,2,0,0
"2097","S2",10,"17.11.2019","Yes","Oviedo","Sp Gijon",0,0,7,9,2,3,16,29,3,4,0,0,2.32,2.99,3.28,2.42,1.54,1,1,0.4027002,0.312463,0.2848367,1.520564,1.166973,0,-2,-1,0,0.3535904,-13,-1,0,0
"2098","S2",10,"17.11.2019","Yes","Lugo","Santander",1,1,8,14,2,8,13,17,2,3,0,0,2.51,2.98,2.96,2.43,1.54,1,1,0.371712,0.3130863,0.3152017,1.428222,1.258691,0,-6,-6,0,0.1695308,-4,-1,0,0
"2099","S2",10,"17.11.2019","Yes","Mirandes","Las Palmas",2,1,15,6,7,3,16,20,2,6,0,0,2.49,2.95,3.03,2.51,1.51,3,0,0.3751149,0.3166224,0.3082627,1.441967,1.241411,1,9,4,3,0.2005565,-4,-4,0,0
"2100","S2",10,"17.11.2019","Yes","Tenerife","Cadiz",1,1,17,8,3,2,17,12,1,3,0,0,2.68,2.85,2.89,2.69,1.44,1,1,0.3487132,0.3279127,0.3233741,1.374052,1.298035,0,9,1,0,0.07601705,5,-2,0,0
"2101","S2",10,"22.11.2019","Yes","Sp Gijon","Tenerife",0,2,13,7,5,3,25,20,9,3,1,0,1.88,3.21,4.52,2.29,1.61,0,3,0.4996006,0.292601,0.2077985,1.791403,0.9159964,-2,6,2,-3,0.8754063,5,6,1,0
"2102","S2",10,"23.11.2019","Yes","Vallecano","Zaragoza",0,1,21,7,6,4,18,12,1,4,0,0,1.84,3.42,4.25,1.84,1.95,0,3,0.5073688,0.2729704,0.2196608,1.795077,0.9319529,-1,14,2,-3,0.8631239,6,-3,0,0
"2103","S2",10,"23.11.2019","Yes","La Coruna","Alcorcon",0,0,11,6,2,2,16,19,3,1,0,0,2.04,3.08,3.92,2.52,1.51,1,1,0.4581385,0.3034424,0.238419,1.677858,1.0187,0,5,0,0,0.6591585,-3,2,0,0
"2104","S2",10,"23.11.2019","Yes","Santander","Extremadura UD",3,0,10,20,5,8,18,19,2,2,0,0,2.14,3.02,3.71,2.38,1.57,3,0,0.4375547,0.3100553,0.25239,1.622719,1.067225,3,-10,-3,3,0.5554939,-1,0,0,0
"2105","S2",10,"23.11.2019","Yes","Huesca","Ponferradina",2,0,10,11,6,2,12,17,3,3,0,1,1.56,3.67,6.37,2.14,1.69,3,0,0.5988146,0.254537,0.1466485,2.050981,0.6944824,2,-1,4,3,1.356498,-5,0,-1,0
"2106","S2",10,"24.11.2019","Yes","Almeria","Numancia",2,0,11,17,5,4,18,17,4,4,1,0,1.8,3.31,4.73,2.29,1.6,3,0,0.5196543,0.2825915,0.1977543,1.841554,0.8758543,2,-6,1,3,0.9657,1,0,1,0
"2107","S2",10,"24.11.2019","Yes","Albacete","Mirandes",1,2,13,7,5,3,15,11,4,2,0,0,2.12,3.04,3.72,2.53,1.5,0,3,0.4410608,0.3075819,0.2513573,1.630764,1.061654,-1,6,2,-3,0.5691108,4,2,0,0
"2108","S2",10,"24.11.2019","Yes","Malaga","Elche",3,3,25,14,9,4,20,11,4,6,0,0,1.91,3.23,4.21,2.41,1.54,1,1,0.4889945,0.2891577,0.2218478,1.756141,0.9547012,0,11,5,0,0.8014398,9,-2,0,0
"2109","S2",10,"24.11.2019","Yes","Girona","Fuenlabrada",2,0,13,7,3,2,18,17,2,2,0,0,1.89,3.18,4.4,2.36,1.57,3,0,0.4940992,0.2936627,0.2122381,1.77596,0.9303769,2,6,1,3,0.8455834,1,0,0,0
"2110","S2",10,"24.11.2019","Yes","Las Palmas","Oviedo",3,1,13,14,6,7,18,13,2,3,0,0,2.01,3.18,3.88,2.33,1.59,3,0,0.465091,0.2939726,0.2409363,1.689246,1.016782,2,-1,-1,3,0.6724641,5,-1,0,0
"2111","S2",10,"24.11.2019","Yes","Cadiz","Lugo",2,1,17,8,7,2,15,10,1,2,0,0,1.53,3.74,6.66,2.24,1.63,3,0,0.6101949,0.2496252,0.1401799,2.08021,0.6701649,1,9,5,3,1.410045,5,-1,0,0
"2112","S2",10,"29.11.2019","Yes","Numancia","Malaga",0,0,17,10,2,2,13,16,3,0,0,0,2.31,3.06,3.27,2.34,1.59,1,1,0.4062854,0.3067056,0.287009,1.525562,1.167733,0,7,0,0,0.3578293,-3,3,0,0
"2113","S2",10,"30.11.2019","Yes","Alcorcon","Huesca",0,2,13,9,2,5,17,15,3,1,0,0,3.22,2.96,2.38,2.58,1.48,0,3,0.2906319,0.3161603,0.3932078,1.188056,1.495784,-2,4,-3,-3,-0.3077279,2,2,0,0
"2114","S2",10,"30.11.2019","Yes","Mirandes","Sp Gijon",0,0,10,12,1,3,15,15,2,1,0,0,2.33,2.99,3.28,2.52,1.5,1,1,0.4016661,0.313004,0.2853299,1.518002,1.168994,0,-2,-2,0,0.3490087,0,1,0,0
"2115","S2",10,"30.11.2019","Yes","Ponferradina","Albacete",1,1,13,8,2,5,17,19,1,3,0,0,2.14,2.95,3.79,2.58,1.49,1,1,0.4366683,0.3167696,0.2465621,1.626775,1.056456,0,5,-3,0,0.5703188,-2,-2,0,0
"2116","S2",10,"30.11.2019","Yes","Tenerife","Almeria",1,3,12,12,2,6,17,12,5,1,0,0,2.26,3.04,3.36,2.44,1.53,0,3,0.4139004,0.3077023,0.2783973,1.549404,1.142894,-2,0,-4,-3,0.4065093,5,4,0,0
"2117","S2",10,"30.11.2019","Yes","Zaragoza","Girona",3,3,17,16,6,5,10,9,2,3,0,0,2.29,3.25,3.08,1.95,1.84,1,1,0.4084764,0.2878188,0.3037049,1.513248,1.198933,0,1,1,0,0.3143146,1,-1,0,0
"2118","S2",10,"01.12.2019","Yes","Fuenlabrada","Cadiz",1,0,11,6,4,0,15,12,5,5,0,1,2.54,2.9,3.01,2.72,1.43,3,0,0.3676855,0.3220418,0.3102728,1.425098,1.25286,1,5,4,3,0.172238,3,0,-1,0
"2119","S2",10,"01.12.2019","Yes","Oviedo","Vallecano",2,1,7,9,3,2,13,15,2,4,0,0,2.72,3.04,2.69,2.09,1.73,3,0,0.3441287,0.3079047,0.3479666,1.340291,1.351804,1,-2,1,3,-0.0115136,-2,-2,0,0
"2120","S2",10,"01.12.2019","Yes","Elche","Santander",2,0,15,13,3,3,20,18,2,4,0,0,2.09,3.03,3.82,2.38,1.56,3,0,0.4470494,0.3083608,0.2445898,1.649509,1.04213,2,2,0,3,0.6073786,2,-2,0,0
"2121","S2",10,"01.12.2019","Yes","Lugo","La Coruna",0,0,14,12,2,3,9,13,2,3,0,0,2.92,3.02,2.53,2.33,1.59,1,1,0.3204063,0.3097968,0.369797,1.271016,1.419188,0,2,-1,0,-0.1481721,-4,-1,0,0
"2122","S2",10,"01.12.2019","Yes","Extremadura UD","Las Palmas",0,1,12,15,3,5,16,15,3,7,0,1,2.44,3.13,2.94,2.26,1.62,0,3,0.3832174,0.2987382,0.3180444,1.44839,1.252871,-1,-3,-2,-3,0.1955191,1,-4,-1,0
"2123","S2",10,"06.12.2019","Yes","Albacete","Extremadura UD",1,1,11,11,3,4,12,18,3,4,0,0,2.14,2.95,3.81,2.47,1.53,1,1,0.4372343,0.3171801,0.2455856,1.628883,1.053937,0,0,-1,0,0.5749458,-6,-1,0,0
"2124","S2",10,"06.12.2019","Yes","Santander","Fuenlabrada",2,2,8,17,3,8,13,16,4,3,1,0,2.79,2.82,2.82,2.8,1.42,1,1,0.3357143,0.3321429,0.3321429,1.339286,1.328571,0,-9,-5,0,0.01071429,-3,1,1,0
"2125","S2",10,"06.12.2019","Yes","Alcorcon","Oviedo",1,3,11,8,1,4,15,21,2,2,0,0,2.29,2.9,3.48,2.51,1.5,0,3,0.4085466,0.3226109,0.2688425,1.548251,1.129138,-2,3,-3,-3,0.4191125,-6,0,0,0
"2126","S2",10,"06.12.2019","Yes","Malaga","Tenerife",2,0,11,11,5,1,7,13,1,3,0,0,1.88,3.21,4.52,2.38,1.57,3,0,0.4996006,0.292601,0.2077985,1.791403,0.9159964,2,0,4,3,0.8754063,-6,-2,0,0
"2127","S2",10,"07.12.2019","Yes","Huesca","Vallecano",0,2,15,13,7,9,16,15,4,3,0,0,1.92,3.36,3.98,1.98,1.82,0,3,0.4868927,0.2782244,0.2348829,1.738902,0.9828731,-2,2,-2,-3,0.7560294,1,1,0,0
"2128","S2",10,"07.12.2019","Yes","Sp Gijon","Ponferradina",1,0,13,14,6,2,20,12,2,4,0,1,1.85,3.23,4.55,2.39,1.56,3,0,0.5052167,0.2893656,0.2054178,1.805016,0.9056189,1,-1,4,3,0.8993967,8,-2,-1,0
"2129","S2",10,"07.12.2019","Yes","Almeria","Mirandes",3,1,12,6,6,3,11,10,4,3,1,1,1.75,3.35,4.97,2.22,1.64,3,0,0.5334754,0.2786812,0.1878434,1.879107,0.8422115,2,6,3,3,1.036896,1,1,0,0
"2130","S2",10,"08.12.2019","Yes","Girona","Lugo",3,1,13,12,4,5,17,12,2,4,0,1,1.48,3.96,7.09,2.01,1.79,3,0,0.6319187,0.2361716,0.1319097,2.131928,0.6319007,2,1,-1,3,1.500027,5,-2,-1,0
"2131","S2",10,"08.12.2019","Yes","La Coruna","Zaragoza",1,3,14,17,6,10,14,15,1,2,0,0,2.36,3.2,2.97,2.04,1.76,0,3,0.3949271,0.2912587,0.3138141,1.47604,1.232701,-2,-3,-4,-3,0.2433389,-1,-1,0,0
"2132","S2",10,"08.12.2019","Yes","Las Palmas","Numancia",3,1,13,9,4,4,18,16,4,4,0,0,2.1,3.19,3.57,2.13,1.69,3,0,0.4451285,0.2930313,0.2618403,1.628417,1.078552,2,4,0,3,0.5498646,2,0,0,0
"2133","S2",10,"08.12.2019","Yes","Cadiz","Elche",0,0,14,7,2,1,14,16,2,2,0,0,1.71,3.31,5.46,2.39,1.56,1,1,0.5465069,0.2823344,0.1711587,1.921855,0.7958106,0,7,1,0,1.126044,-2,0,0,0
"2134","S2",10,"13.12.2019","Yes","Numancia","Girona",2,0,11,15,5,5,20,13,6,1,0,0,2.92,3.04,2.51,2.11,1.71,3,0,0.3201155,0.3074793,0.3724052,1.267826,1.424695,2,-4,0,3,-0.1568693,7,5,0,0
"2135","S2",10,"14.12.2019","Yes","Mirandes","Huesca",2,0,8,9,7,3,20,11,3,4,0,0,2.82,2.96,2.64,2.38,1.57,3,0,0.3310289,0.3153721,0.353599,1.308459,1.376169,2,-1,4,3,-0.06771045,9,-1,0,0
"2136","S2",10,"14.12.2019","Yes","Ponferradina","La Coruna",2,0,18,4,4,3,13,17,2,3,0,1,2.17,2.99,3.65,2.43,1.54,3,0,0.4309838,0.3127875,0.2562287,1.605739,1.081474,2,14,1,3,0.5242652,-4,-1,-1,0
"2137","S2",10,"14.12.2019","Yes","Tenerife","Alcorcon",0,0,8,9,2,2,23,15,4,4,0,0,2.08,3.01,3.9,2.51,1.51,1,1,0.4495669,0.3106641,0.239769,1.659365,1.029971,0,-1,0,0,0.6293936,8,0,0,0
"2138","S2",10,"14.12.2019","Yes","Zaragoza","Santander",2,0,13,4,6,1,12,13,2,4,0,0,1.61,3.79,5.46,1.89,1.9,3,0,0.5815056,0.2470248,0.1714696,1.991542,0.7614336,2,9,5,3,1.230108,-1,-2,0,0
"2139","S2",10,"15.12.2019","Yes","Extremadura UD","Malaga",0,0,11,9,3,1,15,12,2,2,0,0,2.75,2.81,2.84,2.5,1.51,1,1,0.339333,0.3320875,0.3285795,1.350087,1.317826,0,2,2,0,0.03226053,3,0,0,0
"2140","S2",10,"15.12.2019","Yes","Oviedo","Cadiz",0,2,13,7,3,4,13,15,3,1,0,0,2.33,2.91,3.35,2.57,1.48,0,3,0.4006074,0.3207612,0.2786314,1.522583,1.156655,-2,6,-1,-3,0.3659279,-2,2,0,0
"2141","S2",10,"15.12.2019","Yes","Elche","Las Palmas",2,3,6,19,5,10,18,14,3,1,0,0,2.54,2.89,3,2.34,1.58,0,3,0.3668972,0.3224632,0.3106396,1.423155,1.254382,-1,-13,-5,-3,0.1687727,4,2,0,0
"2142","S2",10,"15.12.2019","Yes","Lugo","Sp Gijon",1,2,9,12,2,4,14,21,2,3,1,0,3.19,2.98,2.37,2.38,1.56,0,3,0.2927005,0.3133271,0.3939724,1.191429,1.495244,-1,-3,-2,-3,-0.3038157,-7,-1,1,0
"2143","S2",10,"15.12.2019","Yes","Fuenlabrada","Almeria",2,2,8,10,2,4,14,21,1,5,0,0,2.3,2.94,3.38,2.53,1.49,1,1,0.4060442,0.3176536,0.2763022,1.535786,1.14656,0,-2,-2,0,0.3892258,-7,-4,0,0
"2144","S2",10,"20.12.2019","Yes","La Coruna","Tenerife",2,1,11,9,3,3,23,16,4,1,0,0,2.39,2.99,3.16,2.52,1.51,3,0,0.3912883,0.3127689,0.2959428,1.486634,1.200597,1,2,0,3,0.2860367,7,3,0,0
"2145","S2",10,"21.12.2019","Yes","Albacete","Elche",0,1,22,12,4,3,18,15,3,3,0,0,2.11,3.1,3.68,2.37,1.56,0,3,0.4436528,0.3019701,0.254377,1.632929,1.065101,-1,10,1,-3,0.5678274,3,0,0,0
"2146","S2",10,"21.12.2019","Yes","Malaga","Lugo",1,1,12,12,3,5,17,13,5,4,0,0,1.5,3.86,6.96,2.25,1.63,1,1,0.6233954,0.2422521,0.1343525,2.112438,0.6453095,0,0,-2,0,1.467129,4,1,0,0
"2147","S2",10,"21.12.2019","Yes","Las Palmas","Vallecano",1,1,20,4,6,1,12,17,3,3,0,1,2.3,3.12,3.19,1.98,1.81,1,1,0.4068046,0.299888,0.2933074,1.520302,1.17981,0,16,5,0,0.3404916,-5,0,-1,0
"2148","S2",10,"21.12.2019","Yes","Sp Gijon","Extremadura UD",0,1,11,5,1,1,10,19,2,1,0,0,1.7,3.39,5.38,2.36,1.57,0,3,0.5502184,0.2759207,0.1738608,1.926576,0.7975033,-1,6,0,-3,1.129073,-9,1,0,0
"2149","S2",10,"21.12.2019","Yes","Santander","Oviedo",1,1,16,13,5,6,19,16,2,5,1,1,2.72,2.92,2.79,2.4,1.55,1,1,0.3440662,0.3205,0.3354337,1.352699,1.326801,0,3,-1,0,0.02589746,3,-3,0,0
"2150","S2",10,"21.12.2019","Yes","Cadiz","Numancia",2,4,13,12,3,4,15,13,5,1,1,0,1.76,3.2,5.36,2.47,1.52,0,3,0.5323798,0.2928089,0.1748113,1.889948,0.8172427,-2,1,-1,-3,1.072706,2,4,1,0
"2151","S2",10,"22.12.2019","Yes","Almeria","Ponferradina",2,3,18,16,7,5,21,16,4,1,0,0,1.77,3.36,4.81,2.26,1.62,0,3,0.5277688,0.2780211,0.1942101,1.861327,0.8606515,-1,2,2,-3,1.000676,5,3,0,0
"2152","S2",10,"22.12.2019","Yes","Huesca","Zaragoza",2,1,8,7,2,1,9,12,3,4,0,2,1.87,3.38,4.18,2.06,1.74,3,0,0.4998443,0.2765411,0.2236146,1.776074,0.9473848,1,1,1,3,0.8286893,-3,-1,-2,0
"2153","S2",10,"22.12.2019","Yes","Alcorcon","Fuenlabrada",1,1,8,8,3,2,20,24,5,3,0,0,2.48,2.79,3.22,2.84,1.4,1,1,0.3760706,0.334285,0.2896444,1.462497,1.203218,0,0,1,0,0.2592785,-4,2,0,0
"2154","S2",10,"22.12.2019","Yes","Girona","Mirandes",0,3,20,12,8,6,11,16,1,2,0,0,1.67,3.49,5.41,2.15,1.68,0,3,0.5595352,0.2677432,0.1727216,1.946349,0.785908,-3,8,2,-3,1.160441,-5,-1,0,0
"2155","S2",10,"03.01.2020","Yes","Extremadura UD","Alcorcon",0,0,10,12,0,4,11,20,3,1,1,0,2.44,2.8,3.3,2.82,1.41,1,1,0.3830211,0.3337755,0.2832034,1.482839,1.183386,0,-2,-4,0,0.2994528,-9,2,1,0
"2156","S2",10,"04.01.2020","Yes","Fuenlabrada","Las Palmas",0,0,7,9,0,2,18,16,2,5,1,0,2.23,3.07,3.37,2.46,1.52,1,1,0.418742,0.3041676,0.2770904,1.560394,1.135439,0,-2,-2,0,0.4249548,2,-3,1,0
"2157","S2",10,"04.01.2020","Yes","Ponferradina","Cadiz",0,0,11,13,7,4,16,11,0,4,0,1,2.49,2.88,3.11,2.75,1.43,1,1,0.3752026,0.324394,0.3004034,1.450002,1.225604,0,-2,3,0,0.2243977,5,-4,-1,0
"2158","S2",10,"04.01.2020","Yes","Lugo","Almeria",0,4,9,16,1,7,15,12,2,1,0,0,3.21,3.09,2.3,2.18,1.66,0,3,0.2911643,0.3024716,0.4063641,1.175965,1.521564,-4,-7,-6,-3,-0.3455994,3,1,0,0
"2159","S2",10,"04.01.2020","Yes","Tenerife","Albacete",4,2,14,10,9,2,19,16,1,2,0,0,2.02,3.08,3.99,2.57,1.48,3,0,0.4625112,0.3033353,0.2341535,1.690869,1.005796,2,4,7,3,0.685073,3,-1,0,0
"2160","S2",10,"04.01.2020","Yes","Elche","Huesca",1,1,10,7,4,5,13,13,3,3,0,0,3.05,3.02,2.43,2.31,1.58,1,1,0.3062714,0.3093138,0.3844147,1.228128,1.462558,0,3,-1,0,-0.23443,0,0,0,0
"2161","S2",10,"04.01.2020","Yes","Mirandes","Santander",0,0,11,13,3,5,14,22,2,1,0,0,1.76,3.36,4.91,2.34,1.58,1,1,0.5312758,0.2782873,0.1904369,1.872115,0.8495981,0,-2,-2,0,1.022516,-8,1,0,0
"2162","S2",10,"05.01.2020","Yes","Numancia","La Coruna",0,1,13,15,2,7,11,14,2,2,1,0,2.15,3.08,3.58,2.39,1.55,0,3,0.4350454,0.3036843,0.2612703,1.608821,1.087495,-1,-2,-5,-3,0.5213254,-3,0,1,0
"2163","S2",10,"05.01.2020","Yes","Vallecano","Girona",1,0,13,11,4,4,19,16,3,3,0,0,2.28,3.16,3.17,1.99,1.8,3,0,0.4097081,0.2956122,0.2946797,1.524737,1.179651,1,2,0,3,0.3450854,3,0,0,0
"2164","S2",10,"05.01.2020","Yes","Oviedo","Malaga",1,1,14,15,3,2,20,15,4,3,0,0,2.3,2.98,3.32,2.51,1.5,1,1,0.4057481,0.3131613,0.2810906,1.530406,1.156433,0,-1,1,0,0.3739727,5,1,0,0
"2165","S2",10,"07.01.2020","Yes","Zaragoza","Sp Gijon",2,0,14,12,4,4,8,19,2,2,0,1,1.74,3.4,5.03,2.12,1.7,3,0,0.5383032,0.2754846,0.1862122,1.890394,0.8341213,2,2,0,3,1.056273,-11,0,-1,0
"2166","S2",10,"14.01.2020","Yes","Albacete","Fuenlabrada",1,1,7,8,3,2,12,14,5,3,0,0,2.53,2.71,3.3,3.17,1.33,1,1,0.3703366,0.3457386,0.2839247,1.456749,1.197513,0,-1,1,0,0.2592356,-2,2,0,0
"2167","S2",10,"14.01.2020","Yes","Sp Gijon","Elche",1,0,10,10,4,2,17,7,2,2,0,0,2.05,3.02,3.99,2.5,1.51,3,0,0.4560811,0.3095915,0.2343274,1.677835,1.012574,1,0,2,3,0.6652612,10,0,0,0
"2168","S2",10,"14.01.2020","Yes","Malaga","Ponferradina",1,0,6,7,2,3,21,17,4,3,0,0,2.05,3.04,3.99,2.4,1.55,3,0,0.457012,0.3081824,0.2348056,1.679218,1.012599,1,-1,-1,3,0.6666189,4,1,0,0
"2169","S2",10,"14.01.2020","Yes","Las Palmas","Zaragoza",0,1,10,8,4,2,18,12,3,0,0,0,2.47,3.26,2.8,1.91,1.87,0,3,0.3788149,0.2870162,0.3341689,1.423461,1.289523,-1,2,2,-3,0.1339381,6,3,0,0
"2170","S2",10,"15.01.2020","Yes","Alcorcon","Numancia",2,2,25,13,9,4,16,13,3,2,0,0,2.14,2.97,3.72,2.62,1.46,1,1,0.4355766,0.3138498,0.2505736,1.62058,1.065571,0,12,5,0,0.5550089,3,1,0,0
"2171","S2",10,"15.01.2020","Yes","Huesca","Tenerife",2,1,13,13,5,5,17,18,1,3,0,0,1.69,3.39,5.42,2.23,1.63,3,0,0.5523845,0.2753775,0.172238,1.932531,0.7920914,1,0,0,3,1.14044,-1,-2,0,0
"2172","S2",10,"15.01.2020","Yes","Vallecano","Lugo",1,0,11,4,5,2,16,11,4,3,0,0,1.43,4.29,7.15,1.83,1.95,3,0,0.6521739,0.2173913,0.1304348,2.173913,0.6086957,1,7,3,3,1.565217,5,1,0,0
"2173","S2",10,"15.01.2020","Yes","Cadiz","Mirandes",3,3,11,8,4,6,18,17,0,1,0,0,1.9,3.05,4.64,2.54,1.49,1,1,0.492021,0.3065049,0.2014741,1.782568,0.9109272,0,3,-2,0,0.8716406,1,-1,0,0
"2174","S2",10,"16.01.2020","Yes","La Coruna","Santander",2,1,15,19,8,8,20,21,6,1,1,0,2.01,2.99,4.15,2.55,1.49,3,0,0.4636975,0.3117164,0.224586,1.702809,0.9854745,1,-4,0,3,0.7173345,-1,5,1,0
"2175","S2",10,"16.01.2020","Yes","Girona","Extremadura UD",3,1,11,13,6,2,22,16,4,3,0,0,1.55,3.72,6.32,2.11,1.71,3,0,0.6017137,0.2507141,0.1475722,2.055855,0.6934307,2,-2,4,3,1.362425,6,1,0,0
"2176","S2",10,"16.01.2020","Yes","Almeria","Oviedo",2,0,11,7,3,0,13,14,3,0,0,0,1.85,3.27,4.4,2.16,1.67,3,0,0.503473,0.2848395,0.2116875,1.795259,0.919902,2,4,3,3,0.8753565,-1,3,0,0
"2177","S2",10,"17.01.2020","Yes","Fuenlabrada","Malaga",0,0,13,1,1,0,18,14,2,4,0,0,2.31,2.76,3.67,2.98,1.37,1,1,0.4054518,0.3393455,0.2552026,1.555701,1.104953,0,12,1,0,0.4507475,4,-2,0,0
"2178","S2",10,"18.01.2020","Yes","Numancia","Sp Gijon",2,0,7,20,2,3,19,15,1,3,0,0,2.35,2.94,3.25,2.37,1.56,3,0,0.3964484,0.316889,0.2866627,1.506234,1.176877,2,-13,-1,3,0.3293571,4,-2,0,0
"2179","S2",10,"18.01.2020","Yes","Lugo","Albacete",1,0,7,16,4,3,17,10,5,4,0,0,2.76,2.81,2.83,2.55,1.49,3,0,0.3381267,0.3321102,0.3297631,1.34649,1.3214,1,-9,1,3,0.02509067,7,1,0,0
"2180","S2",10,"18.01.2020","Yes","Ponferradina","Vallecano",1,1,12,8,5,5,21,19,4,4,0,0,2.49,3.01,2.94,2.13,1.69,1,1,0.3739462,0.3093442,0.3167096,1.431183,1.259473,0,4,0,0,0.17171,2,0,0,0
"2181","S2",10,"19.01.2020","Yes","Elche","Alcorcon",1,1,14,9,5,2,12,29,2,3,0,1,2.14,2.98,3.72,2.54,1.49,1,1,0.4360358,0.3131264,0.2508378,1.621234,1.06564,0,5,3,0,0.555594,-17,-1,-1,0
"2182","S2",10,"19.01.2020","Yes","La Coruna","Cadiz",1,0,8,12,1,2,13,18,2,3,0,0,2.62,2.82,2.97,2.61,1.47,3,0,0.3557158,0.3304877,0.3137964,1.397635,1.271877,1,-4,-1,3,0.1257581,-5,-1,0,0
"2183","S2",10,"19.01.2020","Yes","Oviedo","Huesca",1,1,12,9,3,4,17,18,3,3,0,0,2.73,2.87,2.79,2.38,1.55,1,1,0.3413302,0.32468,0.3339898,1.348671,1.326649,0,3,-1,0,0.02202131,-1,0,0,0
"2184","S2",10,"19.01.2020","Yes","Santander","Las Palmas",1,1,9,8,3,3,15,15,3,0,0,0,2.73,2.9,2.76,2.47,1.51,1,1,0.3412376,0.321234,0.3375285,1.344947,1.333819,0,1,0,0,0.01112731,0,3,0,0
"2185","S2",10,"19.01.2020","Yes","Extremadura UD","Almeria",1,2,21,9,9,4,18,11,2,4,0,0,3.06,2.9,2.49,2.48,1.51,0,3,0.3044985,0.3212985,0.374203,1.234794,1.443907,-1,12,5,-3,-0.2091135,7,-2,0,0
"2186","S2",10,"19.01.2020","Yes","Tenerife","Girona",1,0,6,15,3,4,24,13,4,1,0,0,2.58,2.96,2.87,2.23,1.62,3,0,0.3609357,0.3145994,0.3244649,1.397407,1.287994,1,-9,-1,3,0.1094126,11,3,0,0
"2187","S2",10,"24.01.2020","Yes","Cadiz","Santander",1,0,18,2,2,0,15,17,4,3,0,1,1.58,3.39,7.02,2.63,1.47,3,0,0.5913143,0.2755978,0.1330878,2.049541,0.6748614,1,16,2,3,1.374679,-2,1,-1,0
"2188","S2",10,"25.01.2020","Yes","Huesca","Lugo",2,1,22,6,6,3,15,12,2,2,0,0,1.43,4.09,7.72,1.94,1.84,3,0,0.6515225,0.2277939,0.1206836,2.182361,0.5898446,1,16,3,3,1.592517,3,0,0,0
"2189","S2",10,"25.01.2020","Yes","Sp Gijon","Fuenlabrada",1,0,9,16,3,3,21,19,4,2,0,0,2.16,2.85,3.92,2.89,1.39,3,0,0.4331038,0.3282471,0.2386491,1.627559,1.044194,1,-7,0,3,0.5833643,2,2,0,0
"2190","S2",10,"25.01.2020","Yes","Las Palmas","Tenerife",0,0,18,6,3,2,9,17,3,4,0,1,2.01,3.14,3.93,2.27,1.61,1,1,0.4647752,0.2975153,0.2377095,1.691841,1.010644,0,12,1,0,0.6811972,-8,-1,-1,0
"2191","S2",10,"25.01.2020","Yes","Zaragoza","Numancia",1,0,17,11,7,5,16,9,4,1,0,0,1.66,3.55,5.31,1.99,1.8,3,0,0.5617273,0.2626668,0.1756059,1.947849,0.7894845,1,6,2,3,1.158364,7,3,0,0
"2192","S2",10,"26.01.2020","Yes","Malaga","Mirandes",2,2,16,13,4,3,11,12,2,2,0,0,1.94,3.17,4.17,2.42,1.54,1,1,0.4814138,0.2946192,0.2239671,1.73886,0.9665204,0,3,1,0,0.7723401,-1,0,0,0
"2193","S2",10,"26.01.2020","Yes","Albacete","La Coruna",0,1,20,5,6,4,17,14,3,4,0,0,2.42,2.9,3.19,2.79,1.41,0,3,0.3856383,0.3218085,0.2925532,1.478723,1.199468,-1,15,2,-3,0.2792553,3,-1,0,0
"2194","S2",10,"26.01.2020","Yes","Almeria","Elche",0,2,11,9,3,6,12,14,4,5,1,0,1.74,3.4,4.94,2.14,1.69,0,3,0.5364832,0.2745531,0.1889637,1.884003,0.8414442,-2,2,-3,-3,1.042558,-2,-1,1,0
"2195","S2",10,"26.01.2020","Yes","Alcorcon","Ponferradina",3,1,9,10,5,4,17,17,2,3,0,0,2.28,2.83,3.56,2.67,1.45,3,0,0.4088135,0.3293621,0.2618244,1.555803,1.114835,2,-1,1,3,0.4409674,0,-1,0,0
"2196","S2",10,"26.01.2020","Yes","Vallecano","Extremadura UD",1,1,4,4,1,3,20,26,3,3,0,0,1.61,3.59,5.83,2.07,1.73,1,1,0.5798359,0.2600378,0.1601262,1.999546,0.7404165,0,0,-2,0,1.259129,-6,0,0,0
"2197","S2",10,"26.01.2020","Yes","Girona","Oviedo",1,1,14,5,5,1,18,21,1,4,0,0,1.7,3.46,5.15,2.1,1.71,1,1,0.5490202,0.2697498,0.18123,1.91681,0.8134397,0,9,4,0,1.103371,-3,-3,0,0
"2198","S2",10,"31.01.2020","Yes","Tenerife","Sp Gijon",2,1,6,18,4,4,14,13,0,1,0,0,2.41,2.82,3.33,2.7,1.44,3,0,0.3878474,0.3314582,0.2806944,1.495,1.173541,1,-12,0,3,0.3214591,1,-1,0,0
"2199","S2",10,"01.02.2020","Yes","Extremadura UD","Lugo",1,0,9,12,5,1,15,5,0,1,1,1,1.84,3.24,4.59,2.45,1.53,3,0,0.5079307,0.2884544,0.2036149,1.812246,0.8992992,1,-3,4,3,0.9129473,10,-1,0,0
"2200","S2",10,"01.02.2020","Yes","La Coruna","Las Palmas",2,1,9,8,3,2,14,12,0,4,0,0,2.26,2.92,3.49,2.54,1.49,3,0,0.4129608,0.3196204,0.2674188,1.558503,1.121877,1,1,1,3,0.4366262,2,-4,0,0
"2201","S2",10,"01.02.2020","Yes","Ponferradina","Huesca",3,1,15,8,6,3,24,19,2,5,0,0,2.84,2.95,2.64,2.36,1.56,3,0,0.3291131,0.3168411,0.3540459,1.30418,1.378979,2,7,3,3,-0.07479842,5,-3,0,0
"2202","S2",10,"01.02.2020","Yes","Elche","Malaga",2,0,11,9,4,3,14,9,2,2,0,0,2.29,2.91,3.43,2.55,1.49,3,0,0.4074017,0.3206013,0.271997,1.542806,1.136592,2,2,1,3,0.4062139,5,0,0,0
"2203","S2",10,"02.02.2020","Yes","Fuenlabrada","Girona",0,1,8,11,4,4,18,20,4,5,1,0,2.54,2.93,2.96,2.5,1.51,0,3,0.3669722,0.318126,0.3149018,1.419043,1.262831,-1,-3,0,-3,0.1562111,-2,-1,1,0
"2204","S2",10,"02.02.2020","Yes","Cadiz","Zaragoza",1,1,20,4,9,3,13,16,3,2,0,0,2.16,2.99,3.63,2.28,1.6,1,1,0.4315089,0.3117255,0.2567656,1.606252,1.082022,0,16,6,0,0.5242298,-3,1,0,0
"2205","S2",10,"02.02.2020","Yes","Mirandes","Vallecano",0,0,7,10,2,4,12,18,1,1,0,0,2.55,2.99,2.89,2.09,1.71,1,1,0.3656045,0.3118032,0.3225922,1.408617,1.27958,0,-3,-2,0,0.1290369,-6,0,0,0
"2206","S2",10,"02.02.2020","Yes","Numancia","Almeria",1,1,12,16,4,2,15,15,3,4,0,0,2.48,2.94,3.04,2.33,1.57,1,1,0.376035,0.3171996,0.3067654,1.445305,1.237496,0,-4,2,0,0.2078088,0,-1,0,0
"2207","S2",10,"02.02.2020","Yes","Oviedo","Albacete",3,1,13,13,6,4,19,25,5,3,0,0,2.12,3.03,3.71,2.5,1.5,3,0,0.4403155,0.3080756,0.2516089,1.629022,1.062902,2,0,2,3,0.56612,-6,2,0,0
"2208","S2",10,"02.02.2020","Yes","Santander","Alcorcon",1,1,20,10,3,4,17,14,1,3,0,1,2.63,2.82,2.95,2.57,1.48,1,1,0.3540889,0.3302318,0.3156793,1.392499,1.27727,0,10,-1,0,0.1152289,3,-2,-1,0
"2209","S2",10,"07.02.2020","Yes","Almeria","Santander",0,1,6,6,4,2,14,12,2,3,0,0,1.59,3.55,6.19,2.2,1.65,0,3,0.5865952,0.2627285,0.1506763,2.022514,0.7147574,-1,0,2,-3,1.307757,2,-1,0,0
"2210","S2",10,"08.02.2020","Yes","Extremadura UD","Tenerife",2,4,15,17,6,7,12,13,4,1,1,0,2.44,2.85,3.23,2.54,1.49,0,3,0.3829131,0.3278274,0.2892595,1.476567,1.195606,-2,-2,-1,-3,0.280961,-1,3,1,0
"2211","S2",10,"08.02.2020","Yes","Girona","Huesca",1,0,16,5,8,1,17,17,4,3,0,1,2.03,3.12,3.91,2.24,1.63,3,0,0.4608672,0.2998591,0.2392737,1.682461,1.01768,1,11,7,3,0.6647803,0,1,-1,0
"2212","S2",10,"08.02.2020","Yes","Las Palmas","Cadiz",1,2,26,4,9,3,12,14,2,1,0,0,2.57,2.77,3.11,2.7,1.44,0,3,0.3630865,0.3368709,0.3000426,1.42613,1.236999,-1,22,6,-3,0.1891319,-2,1,0,0
"2213","S2",10,"08.02.2020","Yes","Zaragoza","Fuenlabrada",0,0,13,10,2,0,15,15,4,3,0,0,1.74,3.24,5.35,2.34,1.58,1,1,0.5369789,0.2883775,0.1746436,1.899314,0.8123083,0,3,2,0,1.087006,0,1,0,0
"2214","S2",10,"09.02.2020","Yes","Albacete","Ponferradina",1,1,18,8,4,4,12,13,5,1,0,0,2.49,2.82,3.17,2.64,1.46,1,1,0.3747469,0.3308935,0.2943596,1.455134,1.213972,0,10,0,0,0.241162,-1,4,0,0
"2215","S2",10,"09.02.2020","Yes","Alcorcon","La Coruna",0,1,19,5,5,2,14,10,1,4,0,0,2.51,2.7,3.29,2.77,1.42,0,3,0.3713955,0.3452602,0.2833443,1.459447,1.195293,-1,14,3,-3,0.2641536,4,-3,0,0
"2216","S2",10,"09.02.2020","Yes","Sp Gijon","Mirandes",2,2,18,4,8,3,10,17,1,2,0,0,1.87,3.14,4.54,2.42,1.53,1,1,0.498148,0.2966677,0.2051843,1.791112,0.9122206,0,14,5,0,0.878891,-7,-1,0,0
"2217","S2",10,"09.02.2020","Yes","Lugo","Elche",2,2,10,14,3,3,24,13,4,3,0,0,2.99,2.89,2.54,2.3,1.59,1,1,0.311355,0.3221286,0.3665164,1.256194,1.421678,0,-4,0,0,-0.165484,11,1,0,0
"2218","S2",10,"09.02.2020","Yes","Vallecano","Oviedo",1,1,12,11,5,3,18,14,4,3,1,0,1.76,3.42,4.73,2.04,1.75,1,1,0.5300223,0.27276,0.1972176,1.862827,0.8644129,0,1,2,0,0.9984142,4,1,1,0
"2219","S2",10,"09.02.2020","Yes","Malaga","Numancia",2,1,20,6,6,1,14,23,3,4,0,0,2.08,3,3.87,2.4,1.55,3,0,0.4482695,0.3108002,0.2409304,1.655609,1.033591,1,14,5,3,0.6220173,-9,-1,0,0
"2220","S2",10,"14.02.2020","Yes","La Coruna","Girona",2,2,6,20,3,6,10,14,4,2,1,0,2.91,2.84,2.69,2.67,1.45,1,1,0.3219127,0.3298472,0.3482401,1.295585,1.374568,0,-14,-3,0,-0.0789823,-4,2,1,0
"2221","S2",10,"15.02.2020","Yes","Huesca","Almeria",3,2,21,8,8,3,11,16,0,3,0,0,2.04,3.11,3.87,2.27,1.61,3,0,0.4580683,0.3004693,0.2414624,1.674674,1.024856,1,13,5,3,0.6498179,-5,-3,0,0
"2222","S2",10,"15.02.2020","Yes","Numancia","Las Palmas",1,1,10,14,5,5,13,10,1,2,0,0,2.5,2.88,3.08,2.45,1.53,1,1,0.37317,0.3239323,0.3028977,1.443442,1.232625,0,-4,0,0,0.2108168,3,-1,0,0
"2223","S2",10,"15.02.2020","Yes","Oviedo","Alcorcon",1,2,20,13,6,6,24,24,3,5,0,0,2.23,2.88,3.63,2.49,1.51,0,3,0.4186499,0.324163,0.2571871,1.580113,1.095724,-1,7,0,-3,0.4843883,0,-2,0,0
"2224","S2",10,"15.02.2020","Yes","Elche","Zaragoza",1,2,6,16,2,7,14,16,3,2,0,0,2.84,2.94,2.64,2.21,1.64,0,3,0.3287588,0.3175765,0.3536647,1.303853,1.378571,-1,-10,-5,-3,-0.0747179,-2,1,0,0
"2225","S2",10,"16.02.2020","Yes","Fuenlabrada","Lugo",0,1,14,4,3,1,18,32,4,4,0,0,1.71,3.34,5.37,2.4,1.54,0,3,0.5463251,0.2797054,0.1739695,1.918681,0.8016138,-1,10,2,-3,1.117067,-14,0,0,0
"2226","S2",10,"16.02.2020","Yes","Mirandes","Albacete",1,1,9,13,2,5,16,20,4,6,1,1,2.26,2.96,3.44,2.46,1.52,1,1,0.4131394,0.3154375,0.271423,1.554856,1.129707,0,-4,-3,0,0.4251493,-4,-2,0,0
"2227","S2",10,"16.02.2020","Yes","Cadiz","Malaga",0,1,10,7,0,2,19,21,4,4,0,0,1.94,2.97,4.58,2.87,1.39,0,3,0.4815148,0.3145248,0.2039604,1.759069,0.926406,-1,3,-2,-3,0.8326631,-2,0,0,0
"2228","S2",10,"16.02.2020","Yes","Ponferradina","Extremadura UD",0,0,16,9,3,0,10,19,2,6,0,1,1.92,3.11,4.39,2.37,1.57,1,1,0.4866841,0.3004609,0.212855,1.760513,0.9390259,0,7,3,0,0.8214873,-9,-4,-1,0
"2229","S2",10,"16.02.2020","Yes","Santander","Sp Gijon",0,2,6,13,2,6,6,18,1,3,0,0,2.64,2.86,2.92,2.56,1.49,0,3,0.3537085,0.3265002,0.3197913,1.387626,1.285874,-2,-7,-4,-3,0.1017518,-12,-2,0,0
"2230","S2",10,"16.02.2020","Yes","Tenerife","Vallecano",0,0,12,12,3,3,16,17,1,4,0,0,2.57,3.01,2.86,2.14,1.68,1,1,0.3633164,0.310207,0.3264766,1.400156,1.289637,0,0,0,0,0.1105193,-1,-3,0,0
"2231","S2",10,"19.02.2020","Yes","Mirandes","Zaragoza",1,1,5,15,2,2,15,10,5,3,0,0,2.93,3.02,2.5,2.09,1.72,1,1,0.3182485,0.3087643,0.3729872,1.26351,1.427726,0,-10,0,0,-0.1642162,5,2,0,0
"2232","S2",10,"21.02.2020","Yes","Sp Gijon","Cadiz",1,0,13,15,2,3,14,11,2,5,0,1,2.61,2.63,3.28,3.03,1.36,3,0,0.3586637,0.3559362,0.2854001,1.431927,1.212136,1,-2,-1,3,0.2197909,3,-3,-1,0
"2233","S2",10,"22.02.2020","Yes","Alcorcon","Las Palmas",1,1,8,7,1,3,22,17,3,4,0,0,2.65,2.81,2.96,2.62,1.46,1,1,0.3523198,0.3322588,0.3154214,1.389218,1.278523,0,1,-2,0,0.1106951,5,-1,0,0
"2234","S2",10,"22.02.2020","Yes","Almeria","Fuenlabrada",0,0,6,7,0,0,20,26,1,1,0,0,1.93,3.08,4.38,2.45,1.53,1,1,0.4837315,0.3031174,0.2131511,1.754312,0.9425707,0,-1,0,0,0.8117412,-6,0,0,0
"2235","S2",10,"22.02.2020","Yes","Girona","Ponferradina",2,0,14,5,5,0,18,14,3,2,0,0,1.75,3.32,5.04,2.2,1.65,3,0,0.5335238,0.2812249,0.1852513,1.881796,0.8369788,2,9,5,3,1.044817,4,1,0,0
"2236","S2",10,"22.02.2020","Yes","Tenerife","Elche",1,0,13,7,5,1,19,12,2,5,0,0,2.21,3.01,3.49,2.4,1.55,3,0,0.4223941,0.3101299,0.2674759,1.577312,1.112558,1,6,4,3,0.4647546,7,-3,0,0
"2237","S2",10,"22.02.2020","Yes","Albacete","Numancia",2,1,15,7,8,1,21,16,3,3,0,0,2.35,2.83,3.43,2.7,1.44,3,0,0.3975321,0.3301062,0.2723617,1.522703,1.147191,1,8,7,3,0.3755114,5,0,0,0
"2238","S2",10,"23.02.2020","Yes","Lugo","Oviedo",1,0,4,7,1,2,17,12,3,3,0,0,3.01,2.91,2.53,2.38,1.55,3,0,0.3101653,0.3208239,0.3690109,1.25132,1.427856,1,-3,-1,3,-0.1765368,5,0,0,0
"2239","S2",10,"23.02.2020","Yes","Zaragoza","La Coruna",3,1,15,12,5,2,11,13,2,5,0,1,1.83,3.22,4.71,2.23,1.62,3,0,0.5110233,0.2904263,0.1985504,1.823496,0.8860776,2,3,3,3,0.9374185,-2,-3,-1,0
"2240","S2",10,"23.02.2020","Yes","Extremadura UD","Mirandes",3,2,20,13,6,7,11,17,3,3,0,0,2.27,2.95,3.41,2.41,1.54,3,0,0.4106471,0.3159895,0.2733634,1.547931,1.13608,1,7,-1,3,0.4118514,-6,0,0,0
"2241","S2",10,"23.02.2020","Yes","Malaga","Santander",2,0,16,7,5,1,19,16,1,1,0,0,1.79,3.18,5.04,2.51,1.5,3,0,0.5213623,0.2934713,0.1851664,1.857558,0.8489704,2,9,4,3,1.008588,3,0,0,0
"2242","S2",10,"23.02.2020","Yes","Vallecano","Huesca",2,0,21,9,5,4,24,17,3,4,0,0,2.22,3.05,3.4,2.22,1.63,3,0,0.4200251,0.3057232,0.2742517,1.565799,1.128478,2,12,1,3,0.4373203,7,-1,0,0
"2243","S2",10,"28.02.2020","Yes","Las Palmas","Malaga",1,1,12,15,7,4,14,16,4,3,0,0,2.42,2.82,3.34,2.73,1.43,1,1,0.3871907,0.33227,0.2805393,1.493842,1.173888,0,-3,3,0,0.319954,-2,1,0,0
"2244","S2",10,"29.02.2020","Yes","Huesca","Extremadura UD",2,2,11,9,6,5,15,17,3,3,0,0,1.56,3.67,6.41,2.17,1.66,1,1,0.599363,0.2547701,0.1458668,2.052859,0.6923706,0,2,1,0,1.360489,-2,0,0,0
"2245","S2",10,"29.02.2020","Yes","Ponferradina","Sp Gijon",1,0,11,12,3,5,14,15,2,2,0,0,2.41,2.87,3.24,2.55,1.48,3,0,0.3870645,0.3250263,0.2879091,1.48622,1.188754,1,-1,-2,3,0.2974663,-1,0,0,0
"2246","S2",10,"29.02.2020","Yes","Cadiz","Almeria",2,1,7,8,1,2,21,18,2,2,0,0,2.11,2.91,3.93,2.61,1.46,3,0,0.4420902,0.3205534,0.2373563,1.646824,1.032622,1,-1,-1,3,0.6142017,3,0,0,0
"2247","S2",10,"29.02.2020","Yes","Albacete","Vallecano",1,1,11,7,2,5,15,21,3,2,0,0,2.65,2.87,2.88,2.47,1.52,1,1,0.3516813,0.3247231,0.3235956,1.379767,1.29551,0,4,-3,0,0.08425697,-6,1,0,0
"2248","S2",10,"29.02.2020","Yes","Santander","Zaragoza",2,2,16,9,3,4,21,17,3,4,1,1,3.66,3.11,2.09,2.18,1.66,1,1,0.2545796,0.2996017,0.4458188,1.06334,1.637058,0,7,-1,0,-0.5737176,4,-1,0,0
"2249","S2",10,"01.03.2020","Yes","Mirandes","Girona",1,1,9,11,3,6,11,23,2,2,0,0,3.62,3.06,2.13,2.35,1.57,1,1,0.2575635,0.3046994,0.4377371,1.07739,1.617911,0,-2,-3,0,-0.5405207,-12,0,0,0
"2250","S2",10,"01.03.2020","Yes","Elche","Numancia",2,0,15,6,5,2,15,16,2,1,0,1,2.15,2.97,3.67,2.4,1.55,3,0,0.4329498,0.3134148,0.2536354,1.612264,1.074321,2,9,3,3,0.537943,-1,1,-1,0
"2251","S2",10,"01.03.2020","Yes","La Coruna","Lugo",0,0,9,8,3,1,10,14,0,1,0,0,1.65,3.45,5.62,2.42,1.53,1,1,0.5643802,0.269921,0.1656988,1.963062,0.7670174,0,1,2,0,1.196044,-4,-1,0,0
"2252","S2",10,"01.03.2020","Yes","Fuenlabrada","Alcorcon",3,4,10,18,4,9,12,11,5,2,2,0,2.2,2.88,3.7,2.94,1.38,0,3,0.4240013,0.3238899,0.2521089,1.595894,1.080216,-1,-8,-5,-3,0.5156772,1,3,2,0
"2253","S2",10,"01.03.2020","Yes","Oviedo","Tenerife",1,0,10,9,4,1,18,13,3,6,0,0,2.29,2.99,3.31,2.3,1.59,3,0,0.4068797,0.3116235,0.2814968,1.532263,1.156114,1,1,3,3,0.3761486,5,-3,0,0
"2254","S2",10,"06.03.2020","Yes","Lugo","Cadiz",1,1,21,5,7,1,23,10,2,4,0,1,3.55,2.83,2.32,2.91,1.39,1,1,0.2642295,0.3314539,0.4043166,1.124142,1.544404,0,16,6,0,-0.4202615,13,-2,-1,0
"2255","S2",10,"07.03.2020","Yes","Extremadura UD","Oviedo",1,2,16,11,5,5,14,15,2,4,0,0,2.69,2.85,2.86,2.51,1.5,0,3,0.3466903,0.3272269,0.3260828,1.367298,1.305475,-1,5,0,-3,0.06182239,-1,-2,0,0
"2256","S2",10,"07.03.2020","Yes","Girona","Albacete",1,1,6,9,3,2,25,30,4,2,0,0,1.63,3.51,5.86,2.31,1.59,1,1,0.5738734,0.2664996,0.1596269,1.98812,0.7453804,0,-3,1,0,1.24274,-5,2,0,0
"2257","S2",10,"07.03.2020","Yes","Huesca","Fuenlabrada",2,0,9,4,5,1,20,21,3,1,0,0,1.73,3.35,5.13,2.41,1.54,3,0,0.5394762,0.2785952,0.1819286,1.897024,0.824381,2,5,4,3,1.072643,-1,2,0,0
"2258","S2",10,"07.03.2020","Yes","Numancia","Santander",1,2,14,7,3,3,23,15,2,6,0,1,1.72,3.33,5.28,2.32,1.58,0,3,0.5428074,0.280369,0.1768236,1.908791,0.8108398,-1,7,0,-3,1.097951,8,-4,-1,0
"2259","S2",10,"07.03.2020","Yes","Almeria","La Coruna",4,0,15,13,8,2,13,4,1,2,0,0,1.87,3.14,4.59,2.39,1.55,3,0,0.4992639,0.2973323,0.2034038,1.795124,0.9075437,4,2,6,3,0.8875802,9,-1,0,0
"2260","S2",10,"08.03.2020","Yes","Vallecano","Elche",2,3,17,12,9,5,20,13,3,3,1,0,2.02,3.15,3.88,2.17,1.66,0,3,0.4625586,0.2966249,0.2408166,1.684301,1.019075,-1,5,4,-3,0.665226,7,0,1,0
"2261","S2",10,"08.03.2020","Yes","Malaga","Zaragoza",0,1,16,10,3,4,14,10,2,3,0,0,2.56,2.96,2.89,2.25,1.62,0,3,0.3635467,0.3144188,0.3220345,1.405059,1.280522,-1,6,-1,-3,0.1245368,4,-1,0,0
"2262","S2",10,"08.03.2020","Yes","Alcorcon","Mirandes",1,2,11,8,3,4,15,13,6,1,1,0,2.13,2.99,3.74,2.41,1.54,0,3,0.4382326,0.3121858,0.2495817,1.626884,1.060931,-1,3,-1,-3,0.5659528,2,5,1,0
"2263","S2",10,"08.03.2020","Yes","Sp Gijon","Las Palmas",4,0,11,8,6,5,18,12,1,2,0,1,2.05,2.99,4.02,2.56,1.48,3,0,0.4554628,0.3122738,0.2322634,1.678662,1.009064,4,3,1,3,0.6695983,6,-1,-1,0
"2264","S2",10,"08.03.2020","Yes","Tenerife","Ponferradina",1,0,8,4,4,1,13,12,2,0,0,0,2.13,2.99,3.74,2.34,1.57,3,0,0.4382326,0.3121858,0.2495817,1.626884,1.060931,1,4,3,3,0.5659528,1,2,0,0
"2265","S2",10,"10.06.2020","No","Vallecano","Albacete",1,0,16,7,6,1,12,18,3,3,0,1,1.6,3.73,5.58,2.03,1.76,3,0,0.5828549,0.2500182,0.1671269,1.998583,0.7513988,1,9,5,3,1.247184,-6,0,-1,0
"2266","S2",10,"12.06.2020","No","Elche","Extremadura UD",1,1,5,13,2,3,9,14,1,2,0,1,2.12,3.08,3.62,2.3,1.6,1,1,0.439764,0.3026947,0.2575413,1.621987,1.075319,0,-8,-1,0,0.5466679,-5,-1,-1,0
"2267","S2",10,"12.06.2020","No","Fuenlabrada","Tenerife",1,0,4,11,2,1,15,20,4,3,0,0,2.6,2.78,3.06,2.71,1.44,3,0,0.3590761,0.3358266,0.3050973,1.413055,1.251119,1,-7,1,3,0.1619363,-5,1,0,0
"2268","S2",10,"12.06.2020","No","Malaga","Huesca",1,3,14,8,5,4,18,14,1,4,1,1,2.76,3.04,2.63,2.48,1.52,0,3,0.3381435,0.3069987,0.3548578,1.321429,1.371572,-2,6,1,-3,-0.05014295,4,-3,0,0
"2269","S2",10,"12.06.2020","No","Oviedo","Ponferradina",0,0,4,10,0,4,15,25,2,3,0,0,2.25,2.94,3.49,2.48,1.52,1,1,0.4149369,0.3175537,0.2675094,1.562364,1.120082,0,-6,-4,0,0.4422823,-10,-1,0,0
"2270","S2",10,"13.06.2020","No","Santander","Lugo",1,2,6,13,1,5,17,19,4,2,1,0,2.22,2.98,3.49,2.71,1.44,0,3,0.4199793,0.3128705,0.2671502,1.572808,1.114321,-1,-7,-4,-3,0.4584875,-2,2,1,0
"2271","S2",10,"13.06.2020","No","Las Palmas","Girona",0,0,6,6,1,3,13,14,4,3,0,0,3.08,2.93,2.45,2.42,1.54,1,1,0.3022666,0.317741,0.3799923,1.224541,1.457718,0,0,-2,0,-0.2331771,-1,1,0,0
"2272","S2",10,"13.06.2020","No","Zaragoza","Alcorcon",1,3,16,7,4,5,12,21,1,1,1,0,1.76,3.39,4.73,2.15,1.68,0,3,0.5287461,0.2745112,0.1967427,1.860749,0.8647394,-2,9,-1,-3,0.99601,-9,0,1,0
"2273","S2",10,"14.06.2020","No","La Coruna","Sp Gijon",0,0,14,14,0,3,19,8,1,0,0,0,2.68,2.8,2.91,2.68,1.44,1,1,0.3474508,0.3325601,0.3199891,1.374913,1.292527,0,0,-3,0,0.08238525,11,1,0,0
"2274","S2",10,"14.06.2020","No","Mirandes","Numancia",2,1,8,13,5,2,14,15,2,2,1,0,2.36,2.99,3.14,2.3,1.59,3,0,0.3935629,0.3106383,0.2957989,1.491327,1.198035,1,-5,3,3,0.2932921,-1,0,1,0
"2275","S2",10,"14.06.2020","No","Albacete","Almeria",0,1,12,10,6,3,9,15,4,3,0,0,2.87,2.94,2.59,2.35,1.57,0,3,0.3242228,0.3165032,0.3592739,1.289172,1.394325,-1,2,3,-3,-0.1051533,-6,1,0,0
"2276","S2",10,"14.06.2020","No","Cadiz","Vallecano",1,1,9,14,2,4,16,21,3,3,0,1,2.47,2.88,3.1,2.58,1.48,1,1,0.3767311,0.3230993,0.3001696,1.453293,1.223608,0,-5,-2,0,0.2296845,-5,0,-1,0
"2277","S2",10,"15.06.2020","No","Ponferradina","Elche",2,1,12,3,5,1,21,30,5,4,1,0,2.49,2.87,3.14,2.55,1.5,3,0,0.3758566,0.3260916,0.2980519,1.453661,1.220247,1,9,4,3,0.2334141,-9,1,1,0
"2278","S2",10,"15.06.2020","No","Tenerife","Malaga",0,0,30,4,6,2,13,4,2,3,0,1,2.48,2.83,3.22,2.67,1.45,1,1,0.3778559,0.3311246,0.2910195,1.464692,1.204183,0,26,4,0,0.2605094,9,-1,-1,0
"2279","S2",10,"16.06.2020","No","Lugo","Zaragoza",1,3,14,10,3,5,13,12,0,0,1,0,3.98,3.16,1.98,2.1,1.71,0,3,0.2342143,0.2949914,0.4707943,0.9976342,1.707374,-2,4,-2,-3,-0.7097402,1,0,1,0
"2280","S2",10,"16.06.2020","No","Girona","Santander",0,0,13,6,1,2,20,19,3,2,0,0,1.66,3.51,5.38,2.22,1.64,1,1,0.5613296,0.2654721,0.1731983,1.949461,0.7850671,0,7,-1,0,1.164394,1,1,0,0
"2281","S2",10,"17.06.2020","No","Almeria","Las Palmas",0,1,4,7,2,2,20,12,5,2,0,0,1.83,3.29,4.49,2.23,1.64,0,3,0.5092159,0.2832417,0.2075424,1.81089,0.9058688,-1,-3,0,-3,0.9050208,8,3,0,0
"2282","S2",10,"17.06.2020","No","Extremadura UD","Albacete",0,1,14,8,1,2,19,13,2,6,0,0,2.49,2.86,3.09,2.57,1.48,0,3,0.3736286,0.325292,0.3010794,1.446178,1.22853,-1,6,-1,-3,0.2176477,6,-4,0,0
"2283","S2",10,"17.06.2020","No","Oviedo","La Coruna",2,2,14,7,6,4,13,13,3,2,0,0,2.22,2.98,3.48,2.52,1.5,1,1,0.4196572,0.3126305,0.2677123,1.571602,1.115767,0,7,2,0,0.4558345,0,1,0,0
"2284","S2",10,"17.06.2020","No","Vallecano","Fuenlabrada",1,0,6,8,3,2,19,20,3,4,0,0,2.05,3.03,3.9,2.45,1.53,3,0,0.4540896,0.3072223,0.2386881,1.669491,1.023287,1,-2,1,3,0.6462044,-1,-1,0,0
"2285","S2",10,"18.06.2020","No","Huesca","Mirandes",1,2,16,9,6,5,7,19,0,4,0,0,1.75,3.34,4.89,2.19,1.65,0,3,0.531399,0.2784276,0.1901734,1.872624,0.8489479,-1,7,1,-3,1.023677,-12,-4,0,0
"2286","S2",10,"18.06.2020","No","Numancia","Cadiz",1,2,12,12,4,3,15,22,3,2,0,1,2.97,2.88,2.55,2.54,1.49,0,3,0.3128954,0.3226734,0.3644312,1.26136,1.415967,-1,0,1,-3,-0.1546072,-7,1,-1,0
"2287","S2",10,"18.06.2020","No","Alcorcon","Sp Gijon",0,2,9,14,6,4,17,17,2,2,0,0,2.62,2.82,2.95,2.62,1.47,0,3,0.3549607,0.3297861,0.3152532,1.394668,1.275546,-2,-5,2,-3,0.1191224,0,0,0,0
"2288","S2",10,"19.06.2020","No","Elche","Girona",1,0,8,13,4,6,18,16,3,5,0,0,3.03,2.88,2.56,2.58,1.49,3,0,0.3090543,0.3251509,0.3657948,1.252314,1.422535,1,-5,-2,3,-0.1702213,2,-2,0,0
"2289","S2",10,"20.06.2020","No","La Coruna","Vallecano",3,3,12,11,4,4,15,12,0,3,0,0,3.1,2.88,2.49,2.4,1.55,1,1,0.3010807,0.3240799,0.3748394,1.227322,1.448598,0,1,0,0,-0.2212762,3,-3,0,0
"2290","S2",10,"20.06.2020","No","Las Palmas","Lugo",1,0,18,4,3,1,10,22,3,4,0,1,1.93,3.16,4.21,2.46,1.53,3,0,0.4832805,0.2951681,0.2215514,1.74501,0.9598223,1,14,2,3,0.7851873,-12,-1,-1,0
"2291","S2",10,"20.06.2020","No","Zaragoza","Almeria",0,2,10,8,3,4,9,19,4,2,0,0,2.37,3,3.17,2.24,1.63,0,3,0.3940678,0.3113136,0.2946185,1.493517,1.195169,-2,2,-1,-3,0.2983479,-10,2,0,0
"2292","S2",10,"20.06.2020","No","Malaga","Extremadura UD",1,1,13,7,5,4,18,19,2,1,0,0,1.97,3.04,4.26,2.46,1.53,1,1,0.4738286,0.3070534,0.2191179,1.728539,0.9644072,0,6,1,0,0.7641321,-1,1,0,0
"2293","S2",10,"21.06.2020","No","Mirandes","Ponferradina",1,2,7,15,3,9,13,19,6,4,1,0,2.47,2.88,3.11,2.52,1.5,0,3,0.3770951,0.3234114,0.2994935,1.454697,1.221892,-1,-8,-6,-3,0.2328047,-6,2,1,0
"2294","S2",10,"21.06.2020","No","Santander","Tenerife",1,2,10,12,3,5,20,19,4,2,0,0,3.03,2.84,2.57,2.54,1.49,0,3,0.3080819,0.3286931,0.363225,1.252939,1.418368,-1,-2,-2,-3,-0.1654292,1,2,0,0
"2295","S2",10,"21.06.2020","No","Albacete","Huesca",2,2,9,11,2,4,18,14,3,2,0,1,3.15,2.88,2.44,2.4,1.55,1,1,0.2954442,0.3231421,0.3814137,1.209475,1.467383,0,-2,-2,0,-0.2579083,4,1,-1,0
"2296","S2",10,"21.06.2020","No","Cadiz","Alcorcon",1,1,7,3,2,1,8,27,2,3,0,0,2.05,3.02,3.93,2.54,1.5,1,1,0.4544553,0.3084879,0.2370568,1.671854,1.019658,0,4,1,0,0.6521954,-19,-1,0,0
"2297","S2",10,"21.06.2020","No","Fuenlabrada","Numancia",2,0,8,13,3,5,15,12,4,3,0,0,2.36,2.86,3.34,2.62,1.46,3,0,0.3949819,0.3259291,0.279089,1.510875,1.163196,2,-5,-2,3,0.3476787,3,1,0,0
"2298","S2",10,"22.06.2020","No","Sp Gijon","Oviedo",0,1,6,8,2,2,23,14,2,3,0,0,2.24,3,3.4,2.57,1.48,0,3,0.4157157,0.310401,0.2738833,1.557548,1.132051,-1,-2,0,-3,0.4254972,9,-1,0,0
"2299","S2",10,"23.06.2020","No","Elche","La Coruna",0,1,22,9,3,2,13,8,4,1,1,1,2.31,2.97,3.35,2.39,1.55,0,3,0.4052964,0.3152305,0.279473,1.53112,1.15365,-1,13,1,-3,0.3774701,5,3,0,0
"2300","S2",10,"23.06.2020","No","Lugo","Malaga",0,0,8,9,1,6,16,9,2,2,0,0,3.17,2.82,2.52,2.58,1.48,1,1,0.2956787,0.3323764,0.371945,1.219412,1.448211,0,-1,-5,0,-0.228799,7,0,0,0
"2301","S2",10,"23.06.2020","No","Extremadura UD","Zaragoza",1,2,11,11,4,5,24,17,3,2,1,0,3.15,3.05,2.37,2.16,1.67,0,3,0.2974508,0.3072033,0.395346,1.199556,1.493241,-1,0,-1,-3,-0.2936856,7,1,1,0
"2302","S2",10,"24.06.2020","No","Girona","Numancia",2,0,11,9,3,3,17,14,2,0,0,0,1.71,3.35,5.34,2.28,1.61,3,0,0.5462474,0.2788307,0.1749219,1.917573,0.8035965,2,2,0,3,1.113976,3,2,0,0
"2303","S2",10,"24.06.2020","No","Huesca","Cadiz",1,1,11,7,4,3,21,17,4,2,0,0,2.18,2.98,3.6,2.55,1.48,1,1,0.4278809,0.3130135,0.2591056,1.596656,1.09033,0,4,1,0,0.5063257,4,2,0,0
"2304","S2",10,"24.06.2020","No","Tenerife","Mirandes",4,1,12,12,6,2,20,8,2,1,0,0,2.19,3,3.55,2.4,1.55,3,0,0.4260937,0.3110484,0.2628578,1.58933,1.099622,3,0,4,3,0.4897077,12,1,0,0
"2305","S2",10,"24.06.2020","No","Albacete","Las Palmas",0,0,13,5,4,2,14,14,3,5,0,0,2.65,2.86,2.89,2.5,1.5,1,1,0.3516758,0.3258534,0.3224708,1.380881,1.293266,0,8,2,0,0.08761472,0,-2,0,0
"2306","S2",10,"24.06.2020","No","Ponferradina","Santander",1,1,7,11,4,3,14,17,3,6,0,0,1.88,3.08,4.64,2.52,1.49,1,1,0.4961395,0.3028384,0.2010221,1.791257,0.9059046,0,-4,1,0,0.8853524,-3,-3,0,0
"2307","S2",10,"25.06.2020","No","Almeria","Alcorcon",0,1,12,11,5,3,13,22,5,2,0,0,1.84,3.2,4.61,2.3,1.59,0,3,0.5065517,0.2912672,0.2021811,1.810922,0.8978106,-1,1,2,-3,0.9131116,-9,3,0,0
"2308","S2",10,"25.06.2020","No","Vallecano","Sp Gijon",1,1,15,6,6,1,17,12,2,3,0,0,2.05,3.03,3.93,2.41,1.53,1,1,0.4549185,0.3077831,0.2372984,1.672538,1.019678,0,9,5,0,0.6528601,5,-1,0,0
"2309","S2",10,"25.06.2020","No","Oviedo","Fuenlabrada",0,0,9,7,1,0,8,18,3,3,0,0,2.25,2.89,3.53,2.66,1.44,1,1,0.4139175,0.3222541,0.2638284,1.564007,1.113739,0,2,1,0,0.4502672,-10,0,0,0
"2310","S2",10,"27.06.2020","No","La Coruna","Ponferradina",2,1,9,10,2,5,13,19,4,1,0,0,2.33,2.93,3.33,2.62,1.47,3,0,0.4008142,0.3187362,0.2804496,1.521179,1.160085,1,-1,-3,3,0.3610939,-6,3,0,0
"2311","S2",10,"27.06.2020","No","Cadiz","Tenerife",0,2,13,4,3,3,10,17,4,4,1,0,2.05,2.98,4.05,2.66,1.45,0,3,0.4557693,0.3135326,0.2306981,1.680841,1.005627,-2,9,0,-3,0.6752138,-7,0,1,0
"2312","S2",10,"27.06.2020","No","Las Palmas","Elche",1,1,17,6,8,2,13,11,3,3,0,0,2.51,2.94,2.98,2.42,1.54,1,1,0.3709167,0.3166669,0.3124164,1.429417,1.253916,0,11,6,0,0.1755008,2,0,0,0
"2313","S2",10,"27.06.2020","No","Santander","Albacete",1,2,5,10,2,7,18,19,4,4,1,0,2.64,2.85,2.91,2.59,1.47,0,3,0.3529164,0.326912,0.3201716,1.385661,1.287427,-1,-5,-5,-3,0.09823446,-1,0,1,0
"2314","S2",10,"28.06.2020","No","Mirandes","Almeria",2,2,15,10,5,6,17,17,3,4,1,0,2.92,2.89,2.6,2.36,1.56,1,1,0.3191363,0.3224491,0.3584146,1.279858,1.397693,0,5,-1,0,-0.1178349,0,-1,1,0
"2315","S2",10,"28.06.2020","No","Sp Gijon","Lugo",2,0,10,10,6,3,17,3,2,0,0,0,1.83,3.1,4.89,2.57,1.48,3,0,0.5090209,0.3004866,0.1904925,1.827549,0.8719641,2,0,3,3,0.9555853,14,2,0,0
"2316","S2",10,"28.06.2020","No","Malaga","Girona",2,0,10,5,4,1,27,21,6,2,1,1,2.94,2.84,2.63,2.53,1.5,3,0,0.31715,0.3283173,0.3545327,1.279767,1.391915,2,5,3,3,-0.1121481,6,4,0,0
"2317","S2",10,"28.06.2020","No","Numancia","Oviedo",1,0,11,11,2,3,19,13,4,1,0,1,2.4,2.87,3.25,2.5,1.5,3,0,0.388395,0.3247902,0.2868148,1.489975,1.185235,1,0,-1,3,0.3047407,6,3,-1,0
"2318","S2",10,"28.06.2020","No","Fuenlabrada","Extremadura UD",1,1,11,12,4,5,13,12,0,1,0,0,2.54,2.94,2.95,2.59,1.48,1,1,0.3669775,0.3170486,0.3159739,1.417981,1.26497,0,-1,-1,0,0.153011,1,-1,0,0
"2319","S2",10,"29.06.2020","No","Alcorcon","Vallecano",3,2,5,15,3,6,18,16,2,5,0,0,2.93,2.87,2.6,2.41,1.54,3,0,0.3176793,0.3243206,0.3580001,1.277358,1.398321,1,-10,-3,3,-0.1209625,2,-3,0,0
"2320","S2",10,"29.06.2020","No","Zaragoza","Huesca",0,1,8,12,1,4,16,10,5,3,0,0,2.24,3.08,3.3,2.11,1.69,0,3,0.4156171,0.302267,0.2821159,1.549118,1.148615,-1,-4,-3,-3,0.4005038,6,2,0,0
"2321","S2",10,"30.06.2020","No","Tenerife","La Coruna",1,1,5,15,3,5,16,7,2,1,0,0,2.12,3.08,3.72,2.44,1.54,1,1,0.4428298,0.3048049,0.2523653,1.633294,1.061901,0,-10,-2,0,0.5713932,9,1,0,0
"2322","S2",10,"30.06.2020","No","Elche","Cadiz",0,0,5,5,0,1,20,18,3,2,0,0,2.86,2.82,2.75,2.68,1.46,1,1,0.3274197,0.3320639,0.3405164,1.314323,1.353613,0,0,-1,0,-0.03929036,2,1,0,0
"2323","S2",10,"01.07.2020","No","Almeria","Sp Gijon",1,0,6,8,5,2,13,9,0,3,0,0,2.25,3.03,3.35,2.37,1.56,3,0,0.4142131,0.307584,0.2782029,1.550223,1.142193,1,-2,3,3,0.4080309,4,-3,0,0
"2324","S2",10,"01.07.2020","No","Lugo","Numancia",3,1,9,8,4,4,19,15,3,3,0,0,2.68,2.9,2.82,2.44,1.53,3,0,0.3478875,0.321496,0.3306165,1.365159,1.313345,2,1,0,3,0.05181303,4,0,0,0
"2325","S2",10,"01.07.2020","No","Oviedo","Mirandes",1,0,5,12,3,4,19,19,2,2,0,0,2.13,3.05,3.65,2.29,1.6,3,0,0.438227,0.3060405,0.2557325,1.620722,1.073238,1,-7,-1,3,0.5474836,0,0,0,0
"2326","S2",10,"01.07.2020","No","Extremadura UD","Santander",3,1,11,9,6,3,25,18,1,2,0,0,2.11,3.03,3.74,2.52,1.5,3,0,0.442372,0.3080544,0.2495735,1.635171,1.056775,2,2,3,3,0.5783955,7,-1,0,0
"2327","S2",10,"01.07.2020","No","Ponferradina","Fuenlabrada",0,3,9,7,2,4,18,15,3,3,0,0,2.24,2.88,3.59,2.8,1.41,0,3,0.416366,0.3238402,0.2597938,1.572938,1.103222,-3,2,-2,-3,0.4697165,3,0,0,0
"2328","S2",10,"02.07.2020","No","Albacete","Alcorcon",1,1,10,10,5,5,12,22,4,5,0,1,2.49,2.87,3.1,2.6,1.47,1,1,0.3744166,0.3248423,0.3007411,1.448092,1.227066,0,0,0,0,0.2210266,-10,-1,-1,0
"2329","S2",10,"02.07.2020","No","Huesca","Las Palmas",1,0,11,12,5,2,24,9,1,3,0,1,1.98,3.27,3.83,2.19,1.65,3,0,0.4711479,0.2852822,0.2435699,1.698726,1.015992,1,-1,3,3,0.6827339,15,-2,-1,0
"2330","S2",10,"02.07.2020","No","Vallecano","Malaga",0,0,14,9,2,3,20,16,3,4,0,0,2.3,3.06,3.2,2.39,1.55,1,1,0.4047954,0.304258,0.2909467,1.518644,1.177098,0,5,-1,0,0.3415461,4,-1,0,0
"2331","S2",10,"03.07.2020","No","Girona","Zaragoza",1,0,15,5,2,1,16,17,4,2,0,0,2.31,3.06,3.17,2.16,1.66,3,0,0.4026399,0.3039537,0.2934064,1.511873,1.184173,1,10,1,3,0.3277006,-1,2,0,0
"2332","S2",10,"04.07.2020","No","Numancia","Extremadura UD",1,0,11,14,3,4,11,21,6,3,0,0,2.44,2.92,3.12,2.42,1.54,3,0,0.3820195,0.3192217,0.2987588,1.46528,1.215498,1,-3,-1,3,0.249782,-10,3,0,0
"2333","S2",10,"04.07.2020","No","Santander","Elche",1,2,6,16,2,6,19,23,5,2,0,0,3.79,3.09,2.06,2.39,1.55,0,3,0.2459212,0.3016315,0.4524473,1.039395,1.658973,-1,-10,-4,-3,-0.6195782,-4,3,0,0
"2334","S2",10,"04.07.2020","No","Almeria","Tenerife",1,2,11,15,4,3,12,10,4,2,1,0,2.38,3.05,3.09,2.35,1.58,0,3,0.3920716,0.3059444,0.301984,1.482159,1.211896,-1,-4,1,-3,0.270263,2,2,1,0
"2335","S2",10,"04.07.2020","No","Cadiz","Oviedo",2,0,6,9,3,1,19,5,4,2,0,1,2.09,2.96,3.91,2.6,1.48,3,0,0.4463074,0.3151292,0.2385633,1.654052,1.030819,2,-3,2,3,0.6232324,14,2,-1,0
"2336","S2",10,"04.07.2020","No","Fuenlabrada","Mirandes",2,2,7,18,2,5,19,11,5,1,1,0,2.34,2.95,3.26,2.43,1.54,1,1,0.3982458,0.3158967,0.2858574,1.510634,1.173469,0,-11,-3,0,0.3371652,8,4,1,0
"2337","S2",10,"05.07.2020","No","La Coruna","Huesca",2,1,11,13,6,4,14,10,2,2,0,0,3.02,2.95,2.49,2.34,1.58,3,0,0.3089681,0.3162995,0.3747324,1.243204,1.440497,1,-2,2,3,-0.1972929,4,0,0,0
"2338","S2",10,"05.07.2020","No","Las Palmas","Ponferradina",3,0,7,6,6,2,10,22,2,5,0,0,2.24,2.99,3.43,2.42,1.54,3,0,0.4162807,0.3118625,0.2718568,1.560705,1.127433,3,1,4,3,0.4332718,-12,-3,0,0
"2339","S2",10,"05.07.2020","No","Malaga","Albacete",0,0,7,11,4,2,18,15,6,2,1,0,2.36,2.89,3.3,2.61,1.47,1,1,0.3949821,0.3225459,0.282472,1.507492,1.169962,0,-4,2,0,0.3375301,3,4,1,0
"2340","S2",10,"05.07.2020","No","Alcorcon","Lugo",2,2,16,6,4,2,13,13,4,4,0,0,2.08,3.01,3.84,2.51,1.51,1,1,0.4478889,0.3095046,0.2426065,1.653171,1.037324,0,10,2,0,0.6158472,0,0,0,0
"2341","S2",10,"06.07.2020","No","Sp Gijon","Girona",0,0,11,10,3,4,16,22,2,0,0,0,2.59,2.91,2.9,2.42,1.53,1,1,0.3593067,0.3197953,0.320898,1.397715,1.282489,0,1,-1,0,0.1152259,-6,2,0,0
"2342","S2",10,"06.07.2020","No","Zaragoza","Vallecano",2,4,12,13,5,6,15,20,4,4,0,0,2.42,3.09,2.96,2.14,1.68,0,3,0.3845061,0.3011342,0.3143597,1.454652,1.244213,-2,-1,-1,-3,0.2104391,-5,0,0,0
"2343","S2",10,"07.07.2020","No","Mirandes","Elche",1,0,10,6,3,0,10,16,1,2,0,0,2.37,2.96,3.23,2.27,1.62,3,0,0.3945673,0.3159204,0.2895122,1.499622,1.184457,1,4,3,3,0.3151652,-6,-1,0,0
"2344","S2",10,"07.07.2020","No","Fuenlabrada","Santander",1,0,9,7,4,1,10,11,1,2,0,0,1.56,3.61,6.47,2.26,1.62,3,0,0.5976408,0.2582603,0.1440989,2.051183,0.6905569,1,2,3,3,1.360626,-1,-1,0,0
"2345","S2",10,"07.07.2020","No","Extremadura UD","Cadiz",0,1,11,8,0,2,14,19,1,3,0,0,3.2,2.86,2.46,2.68,1.45,0,3,0.2924238,0.3271875,0.3803887,1.204459,1.468354,-1,3,-2,-3,-0.2638947,-5,-2,0,0
"2346","S2",10,"08.07.2020","No","Malaga","La Coruna",1,0,15,4,4,0,15,12,1,4,0,0,2.51,2.74,3.25,2.63,1.47,3,0,0.3719731,0.3407491,0.2872777,1.456669,1.202582,1,11,4,3,0.2540863,3,-3,0,0
"2347","S2",10,"08.07.2020","No","Oviedo","Las Palmas",2,1,13,9,6,4,15,18,2,3,0,0,2.3,2.87,3.47,2.7,1.44,3,0,0.4058083,0.3252122,0.2689795,1.542637,1.132151,1,4,2,3,0.4104862,-3,-1,0,0
"2348","S2",10,"08.07.2020","No","Huesca","Alcorcon",2,1,9,7,5,3,21,20,2,2,0,0,1.93,3.23,4.12,2.24,1.63,3,0,0.4840342,0.2892217,0.2267442,1.741324,0.9694542,1,2,2,3,0.77187,1,0,0,0
"2349","S2",10,"08.07.2020","No","Ponferradina","Lugo",0,1,14,7,4,1,19,15,2,5,0,0,2.2,2.91,3.65,2.63,1.46,0,3,0.4239527,0.3205141,0.2555332,1.592372,1.087114,-1,7,3,-3,0.5052587,4,-3,0,0
"2350","S2",10,"09.07.2020","No","Albacete","Sp Gijon",1,1,9,9,2,6,10,10,4,5,0,1,2.68,2.79,2.92,2.71,1.43,1,1,0.3474174,0.33372,0.3188626,1.375972,1.290308,0,0,-4,0,0.08566457,0,-1,-1,0
"2351","S2",10,"09.07.2020","No","Vallecano","Numancia",3,2,14,8,6,3,20,10,3,4,0,1,1.94,3.23,4.05,2.07,1.73,3,0,0.4808544,0.2888104,0.2303352,1.731374,0.979816,1,6,3,3,0.7515576,10,-1,-1,0
"2352","S2",10,"09.07.2020","No","Girona","Almeria",1,0,8,11,2,5,20,17,2,2,0,1,2.3,3.01,3.26,2.35,1.57,3,0,0.4049171,0.3094051,0.2856777,1.524157,1.166438,1,-3,-3,3,0.3577182,3,0,-1,0
"2353","S2",10,"09.07.2020","No","Tenerife","Zaragoza",1,1,8,17,3,5,13,12,3,4,1,0,2.44,3.06,2.97,2.09,1.72,1,1,0.3818347,0.3044695,0.3136958,1.449974,1.245557,0,-9,-2,0,0.2044165,1,-1,1,0
"2354","S2",10,"11.07.2020","No","Santander","Huesca",1,0,11,13,4,1,17,15,1,1,0,0,7.74,4.03,1.44,2,1.78,3,0,0.1205459,0.2315199,0.6479342,0.5931576,2.175322,1,-2,3,3,-1.582165,2,0,0,0
"2355","S2",10,"11.07.2020","No","Las Palmas","Mirandes",1,0,12,7,5,0,12,15,3,3,0,0,2.3,3.02,3.24,2.33,1.58,3,0,0.4046182,0.3081529,0.2872289,1.522007,1.16984,1,5,5,3,0.3521677,-3,0,0,0
"2356","S2",10,"11.07.2020","No","Cadiz","Fuenlabrada",0,1,12,9,4,3,16,25,2,3,0,0,1.94,2.99,4.51,2.85,1.4,0,3,0.481004,0.3120896,0.2069064,1.755102,0.9328087,-1,3,1,-3,0.8222929,-9,-1,0,0
"2357","S2",10,"12.07.2020","No","La Coruna","Extremadura UD",2,3,16,14,7,4,12,16,0,2,0,0,1.59,3.68,5.78,2.21,1.64,0,3,0.585771,0.2530913,0.1611377,2.010404,0.7365044,-1,2,3,-3,1.2739,-4,-2,0,0
"2358","S2",10,"12.07.2020","No","Lugo","Girona",2,2,10,12,3,5,12,19,3,2,0,0,3.81,3.05,2.07,2.32,1.59,1,1,0.2445131,0.305441,0.4500459,1.03898,1.655579,0,-2,-2,0,-0.6165983,-7,1,0,0
"2359","S2",10,"12.07.2020","No","Numancia","Ponferradina",1,0,11,10,4,5,18,23,3,2,0,0,2.38,2.87,3.26,2.51,1.51,3,0,0.3907273,0.3240178,0.2852549,1.4962,1.179783,1,1,-1,3,0.3164172,-5,1,0,0
"2360","S2",10,"12.07.2020","No","Zaragoza","Oviedo",2,4,12,13,5,8,17,10,4,0,0,0,2.08,3.13,3.63,2.24,1.63,0,3,0.4469195,0.2969944,0.2560861,1.637753,1.065253,-2,-1,-3,-3,0.5725002,7,4,0,0
"2361","S2",10,"13.07.2020","No","Almeria","Vallecano",3,2,9,15,4,4,13,19,2,3,0,0,2.62,3.07,2.72,2.14,1.68,3,0,0.355031,0.3029906,0.3419784,1.368084,1.328926,1,-6,0,3,0.03915783,-6,-1,0,0
"2362","S2",10,"13.07.2020","No","Sp Gijon","Malaga",2,1,10,9,4,4,17,4,2,1,0,0,2.53,2.79,3.12,2.7,1.44,3,0,0.3679572,0.3336673,0.2983755,1.437539,1.228794,1,1,0,3,0.2087449,13,1,0,0
"2363","S2",10,"13.07.2020","No","Alcorcon","Tenerife",0,0,19,6,8,3,11,17,5,2,0,0,2.73,2.87,2.79,2.58,1.47,1,1,0.3413302,0.32468,0.3339898,1.348671,1.326649,0,13,5,0,0.02202131,-6,3,0,0
"2364","S2",10,"13.07.2020","No","Elche","Albacete",2,0,11,5,3,2,13,13,3,2,0,1,2.35,2.93,3.26,2.51,1.5,3,0,0.3963682,0.3179062,0.2857255,1.507011,1.175083,2,6,1,3,0.331928,0,1,-1,0
"2365","S2",10,"17.07.2020","No","Albacete","Zaragoza",4,1,9,7,6,3,14,14,2,2,0,0,2.94,3.08,2.46,2.14,1.69,3,0,0.3174938,0.3030623,0.3794439,1.255544,1.441394,3,2,3,3,-0.1858501,0,0,0,0
"2366","S2",10,"17.07.2020","No","Extremadura UD","Sp Gijon",2,0,8,15,2,8,24,12,1,5,0,0,3.82,3.1,2.06,2.32,1.59,3,0,0.2447006,0.3015343,0.4537652,1.035636,1.66283,2,-7,-6,3,-0.6271937,12,-4,0,0
"2367","S2",10,"17.07.2020","No","Fuenlabrada","Elche",3,1,10,9,4,3,20,10,4,5,0,0,2.43,2.79,3.33,2.7,1.45,3,0,0.3845122,0.3348978,0.28059,1.488434,1.176668,2,1,1,3,0.3117667,10,-1,0,0
"2368","S2",10,"17.07.2020","No","Girona","Cadiz",2,1,3,7,2,4,18,13,4,2,1,1,1.53,3.54,7.24,2.5,1.5,3,0,0.6084467,0.2629727,0.1285806,2.088313,0.6487145,1,-4,-2,3,1.439598,5,2,0,0
"2369","S2",10,"17.07.2020","No","Huesca","Numancia",3,0,21,7,8,2,12,6,1,1,0,0,1.56,3.68,6.3,2.11,1.71,3,0,0.5982535,0.2536075,0.148139,2.048368,0.6980244,3,14,6,3,1.350344,6,0,0,0
"2370","S2",10,"17.07.2020","No","Malaga","Alcorcon",2,0,4,8,2,2,16,19,0,4,0,0,2.37,2.83,3.41,2.58,1.48,3,0,0.3948713,0.3306873,0.2744414,1.515301,1.154011,2,-4,0,3,0.3612899,-3,-4,0,0
"2371","S2",10,"17.07.2020","No","Mirandes","La Coruna",1,0,10,18,4,6,17,6,5,2,0,0,3.13,2.89,2.46,2.4,1.55,3,0,0.2980268,0.3227765,0.3791967,1.216857,1.460367,1,-8,-2,3,-0.2435097,11,3,0,0
"2372","S2",10,"17.07.2020","No","Oviedo","Santander",1,0,3,2,2,0,19,18,2,2,0,0,1.44,3.98,8,2.13,1.7,3,0,0.6485887,0.2346653,0.116746,2.180432,0.5849032,1,1,2,3,1.595528,1,0,0,0
"2373","S2",10,"17.07.2020","No","Ponferradina","Almeria",2,1,9,15,4,6,11,14,3,3,0,0,2.7,2.96,2.77,2.34,1.58,3,0,0.3463934,0.3159669,0.3376397,1.355147,1.328886,1,-6,-2,3,0.02626087,-3,0,0,0
"2374","S2",10,"17.07.2020","No","Tenerife","Lugo",1,2,11,5,5,4,15,10,1,2,0,1,1.69,3.48,5.28,2.24,1.63,0,3,0.5537994,0.2689428,0.1772578,1.930341,0.8007161,-1,6,1,-3,1.129625,5,-1,-1,0
"2375","S2",10,"17.07.2020","No","Vallecano","Las Palmas",2,2,13,9,5,5,16,13,6,3,0,0,1.58,3.61,6.27,2.11,1.71,1,1,0.5918327,0.2590293,0.1491381,2.034527,0.7064434,0,4,0,0,1.328084,3,3,0,0
"2376","S2",10,"20.07.2020","No","Las Palmas","Extremadura UD",5,1,10,6,7,1,9,18,2,1,0,0,1.96,3.22,3.98,2.07,1.74,3,0,0.475928,0.2896953,0.2343766,1.717479,0.9928252,4,4,6,3,0.7246543,-9,1,0,0
"2377","S2",10,"20.07.2020","No","Alcorcon","Girona",2,0,7,9,4,3,18,14,0,1,0,0,2.41,2.95,3.14,2.38,1.56,3,0,0.3869273,0.3160999,0.2969728,1.476882,1.207018,2,-2,1,3,0.2698633,4,-1,0,0
"2378","S2",10,"20.07.2020","No","Almeria","Malaga",0,0,7,8,3,3,14,19,1,2,0,0,2.13,3.08,3.6,2.34,1.58,1,1,0.437977,0.3028867,0.2591364,1.616818,1.080296,0,-1,0,0,0.5365218,-5,-1,0,0
"2379","S2",10,"20.07.2020","No","Cadiz","Albacete",0,1,12,10,3,7,19,17,2,1,0,0,3.67,3,2.15,2.49,1.51,0,3,0.2544329,0.3112562,0.434311,1.074555,1.614189,-1,2,-4,-3,-0.5396343,2,1,0,0
"2380","S2",10,"20.07.2020","No","Elche","Oviedo",2,1,15,4,9,1,17,16,3,4,0,0,1.5,3.9,6.81,2.16,1.67,3,0,0.6230997,0.2396537,0.1372466,2.108953,0.6513936,1,11,8,3,1.457559,1,-1,0,0
"2381","S2",10,"20.07.2020","No","Lugo","Mirandes",2,1,10,6,4,2,14,14,3,1,0,0,1.47,3.95,7.1,2.02,1.78,3,0,0.6332344,0.2356594,0.1311063,2.135362,0.6289782,1,4,2,3,1.506384,0,2,0,0
"2382","S2",10,"20.07.2020","No","Numancia","Tenerife",2,1,16,11,5,3,18,12,3,0,0,0,1.48,3.93,7.21,1.99,1.8,3,0,0.6321669,0.2380679,0.1297652,2.134569,0.6273635,1,5,2,3,1.507205,6,3,0,0
"2383","S2",10,"20.07.2020","No","Santander","Vallecano",1,2,6,19,1,6,13,14,2,4,0,0,7.56,4.31,1.41,1.76,2.04,0,3,0.123217,0.2161301,0.6606529,0.5857811,2.198089,-1,-13,-5,-3,-1.612308,-1,-2,0,0
"2384","S2",10,"20.07.2020","No","Sp Gijon","Huesca",0,1,5,15,1,6,8,7,2,2,0,0,3.22,3.1,2.27,2.12,1.7,0,3,0.2892504,0.3004472,0.4103024,1.168198,1.531354,-1,-10,-5,-3,-0.3631558,1,0,0,0
"2385","S2",10,"20.07.2020","No","Zaragoza","Ponferradina",2,1,11,6,5,3,15,15,2,0,0,0,2.11,3.28,3.41,2,1.79,3,0,0.4420747,0.2843834,0.2735418,1.610608,1.105009,1,5,2,3,0.5055987,0,2,0,0
"2386","S2",10,"07.08.2020","No","La Coruna","Fuenlabrada",2,1,25,6,8,4,13,14,2,1,0,0,2.1,3.16,3.57,2.33,1.58,3,0,0.4438936,0.2949926,0.2611139,1.626673,1.078334,1,19,4,3,0.5483391,-1,1,0,0
"2387","I1",10,"24.08.2019","Yes","Parma","Juventus",0,1,5,9,4,4,12,14,2,3,0,0,10.41,5.13,1.31,1.74,2.09,0,3,0.09110949,0.184883,0.7240075,0.4582115,2.356906,-1,-4,0,-3,-1.898694,-2,-1,0,0
"2388","I1",10,"24.08.2019","Yes","Fiorentina","Napoli",3,4,10,8,6,6,21,16,2,4,0,0,4.73,3.67,1.76,1.78,2.04,0,3,0.2009514,0.2589918,0.5400568,0.8618459,1.879162,-1,2,0,-3,-1.017316,5,-2,0,0
"2389","I1",10,"25.08.2019","Yes","Udinese","Milan",1,0,11,6,6,0,14,11,1,3,0,0,3.8,3.31,2.06,2.1,1.73,3,0,0.2504573,0.2875341,0.4620086,1.038906,1.67356,1,5,6,3,-0.634654,3,-2,0,0
"2390","I1",10,"25.08.2019","Yes","Cagliari","Brescia",0,1,9,8,5,3,10,11,2,2,0,0,1.82,3.6,4.45,1.99,1.82,0,3,0.5223175,0.2640605,0.213622,1.831013,0.9049265,-1,1,2,-3,0.9260865,-1,0,0,0
"2391","I1",10,"25.08.2019","Yes","Roma","Genoa",3,3,17,6,9,4,15,13,3,1,0,0,1.49,4.21,7.13,1.75,2.08,1,1,0.6398381,0.226451,0.1337109,2.145965,0.6275837,0,11,5,0,1.518382,2,2,0,0
"2392","I1",10,"25.08.2019","Yes","Sampdoria","Lazio",0,3,12,16,8,10,13,11,2,2,0,0,3.53,3.35,2.13,1.89,1.91,0,3,0.2694685,0.2839474,0.446584,1.092353,1.623699,-3,-4,-2,-3,-0.5313464,2,0,0,0
"2393","I1",10,"25.08.2019","Yes","Spal","Atalanta",2,3,8,18,3,14,13,16,2,1,0,0,4.89,3.61,1.76,2,1.82,0,3,0.1948186,0.2638956,0.5412858,0.8483514,1.887753,-1,-10,-11,-3,-1.039402,-3,1,0,0
"2394","I1",10,"25.08.2019","Yes","Torino","Sassuolo",2,1,7,13,4,9,21,15,4,3,0,0,1.89,3.46,4.32,1.99,1.82,3,0,0.5040976,0.2753597,0.2205427,1.787653,0.9369878,1,-6,-5,3,0.8506647,6,1,0,0
"2395","I1",10,"25.08.2019","Yes","Verona","Bologna",1,1,5,14,2,5,12,13,1,3,1,0,3.39,3.18,2.27,2.23,1.65,1,1,0.2809439,0.2994968,0.4195594,1.142328,1.558175,0,-9,-3,0,-0.4158464,-1,-2,1,0
"2396","I1",10,"26.08.2019","Yes","Inter","Lecce",4,0,16,10,7,4,14,8,1,2,0,1,1.23,6.1,13.23,1.56,2.41,3,0,0.7724335,0.155753,0.07181354,2.473053,0.3711936,4,6,3,3,2.10186,6,-1,-1,0
"2397","I1",10,"30.08.2019","Yes","Bologna","Spal",1,0,18,7,9,1,13,13,3,2,0,0,1.84,3.5,4.65,2.13,1.72,3,0,0.5204503,0.2736081,0.2059416,1.834959,0.891433,1,11,8,3,0.943526,0,1,0,0
"2398","I1",10,"31.08.2019","Yes","Milan","Brescia",1,0,11,4,6,2,14,18,3,4,0,0,1.48,4.18,7.48,1.83,1.98,3,0,0.6443598,0.2281465,0.1274937,2.161226,0.6106275,1,7,4,3,1.550598,-4,-1,0,0
"2399","I1",10,"31.08.2019","Yes","Juventus","Napoli",4,3,10,12,8,7,13,13,3,3,0,0,1.98,3.35,4.13,2.05,1.77,3,0,0.4829836,0.2854649,0.2315515,1.734416,0.9801193,1,-2,1,3,0.7542964,0,0,0,0
"2400","I1",10,"01.09.2019","Yes","Lazio","Roma",1,1,21,8,13,5,15,13,4,3,0,0,2.14,3.63,3.29,1.6,2.33,1,1,0.446431,0.2631852,0.2903837,1.602478,1.134336,0,13,8,0,0.468142,2,1,0,0
"2401","I1",10,"01.09.2019","Yes","Atalanta","Torino",2,3,19,8,12,6,13,15,2,2,0,0,1.61,4.08,5.54,1.76,2.07,0,3,0.5933938,0.2341578,0.1724484,2.014339,0.751503,-1,11,6,-3,1.262836,-2,0,0,0
"2402","I1",10,"01.09.2019","Yes","Cagliari","Inter",1,2,7,9,3,8,12,11,5,3,0,0,5.43,3.9,1.65,1.95,1.86,0,3,0.1759567,0.2449858,0.5790575,0.7728559,1.982158,-1,-2,-5,-3,-1.209302,1,2,0,0
"2403","I1",10,"01.09.2019","Yes","Genoa","Fiorentina",2,1,18,15,10,7,17,15,2,0,0,0,2.56,3.47,2.71,1.74,2.09,3,0,0.3728003,0.2750342,0.3521656,1.393435,1.331531,1,3,3,3,0.0619041,2,2,0,0
"2404","I1",10,"01.09.2019","Yes","Lecce","Verona",0,1,9,11,3,6,14,14,2,3,0,0,1.92,3.59,4.05,1.94,1.87,0,3,0.4977866,0.2662257,0.2359877,1.759585,0.9741888,-1,-2,-3,-3,0.7853966,0,-1,0,0
"2405","I1",10,"01.09.2019","Yes","Sassuolo","Sampdoria",4,1,11,8,8,5,9,10,1,3,0,1,2.27,3.49,3.12,1.73,2.11,3,0,0.4205225,0.2735204,0.3059571,1.535088,1.191392,3,3,3,3,0.3436963,-1,-2,-1,0
"2406","I1",10,"01.09.2019","Yes","Udinese","Parma",1,3,17,6,12,3,11,11,1,3,0,0,2.03,3.32,3.95,2.21,1.67,0,3,0.4705063,0.2876891,0.2418045,1.699208,1.013103,-2,11,9,-3,0.6861055,0,-2,0,0
"2407","I1",10,"14.09.2019","Yes","Fiorentina","Juventus",0,0,15,5,8,4,12,18,3,3,0,0,5,3.88,1.7,1.77,2.06,1,1,0.1912106,0.2464054,0.562384,0.8200371,1.933558,0,10,4,0,-1.11352,-6,0,0,0
"2408","I1",10,"14.09.2019","Yes","Napoli","Sampdoria",2,0,19,7,9,2,7,10,2,2,0,0,1.27,6.19,9.85,1.42,2.85,3,0,0.749567,0.1537884,0.09664467,2.402489,0.4437224,2,12,7,3,1.958767,-3,0,0,0
"2409","I1",10,"14.09.2019","Yes","Inter","Udinese",1,0,15,6,10,4,9,10,2,1,0,1,1.33,5.29,9.27,1.67,2.21,3,0,0.7169017,0.1802418,0.1028564,2.330947,0.4888112,1,9,6,3,1.842136,-1,1,-1,0
"2410","I1",10,"15.09.2019","Yes","Genoa","Atalanta",1,2,8,11,3,6,12,14,3,3,0,0,3.34,3.75,2.08,1.58,2.37,0,3,0.2860055,0.2547356,0.4592589,1.112752,1.632512,-1,-3,-3,-3,-0.51976,-2,0,0,0
"2411","I1",10,"15.09.2019","Yes","Brescia","Bologna",3,4,9,17,7,6,14,17,2,6,1,0,3.04,3.29,2.41,1.95,1.87,0,3,0.3139301,0.2900752,0.3959948,1.231865,1.478059,-1,-8,1,-3,-0.2461941,-3,-4,1,0
"2412","I1",10,"15.09.2019","Yes","Parma","Cagliari",1,3,14,6,8,4,12,16,0,5,0,0,2.28,3.25,3.3,2.15,1.71,0,3,0.417982,0.2932304,0.2887876,1.547176,1.159593,-2,8,4,-3,0.3875833,-4,-5,0,0
"2413","I1",10,"15.09.2019","Yes","Spal","Lazio",2,1,9,11,4,7,9,11,5,3,0,0,5.55,4.07,1.61,1.77,2.06,3,0,0.1720921,0.2346711,0.5932368,0.7509474,2.014381,1,-2,-3,3,-1.263434,-2,2,0,0
"2414","I1",10,"15.09.2019","Yes","Roma","Sassuolo",4,2,14,10,10,5,13,9,1,2,0,0,1.69,4.13,4.73,1.52,2.54,3,0,0.5660928,0.2316457,0.2022615,1.929924,0.8384302,2,4,5,3,1.091494,4,-1,0,0
"2415","I1",10,"15.09.2019","Yes","Verona","Milan",0,1,6,11,2,6,13,16,4,3,1,1,5.62,3.72,1.67,2.03,1.79,0,3,0.1701832,0.2571047,0.5727122,0.7676541,1.975241,-1,-5,-4,-3,-1.207587,-3,1,0,0
"2416","I1",10,"16.09.2019","Yes","Torino","Lecce",1,2,12,12,3,5,11,19,1,6,0,0,1.5,4.31,6.82,1.81,2.01,0,3,0.6377676,0.2219609,0.1402715,2.135264,0.6427753,-1,0,-2,-3,1.492488,-8,-5,0,0
"2417","I1",10,"20.09.2019","Yes","Cagliari","Genoa",3,1,8,7,4,2,12,8,1,1,0,0,2.8,3.37,2.55,1.84,1.98,3,0,0.3414251,0.2836767,0.3748982,1.307952,1.408371,2,1,2,3,-0.1004192,4,0,0,0
"2418","I1",10,"21.09.2019","Yes","Udinese","Brescia",0,1,6,5,3,3,22,16,4,4,0,0,1.89,3.58,4.16,1.88,1.93,0,3,0.5044747,0.2663288,0.2291964,1.779753,0.9539182,-1,1,0,-3,0.8258348,6,0,0,0
"2419","I1",10,"21.09.2019","Yes","Juventus","Verona",2,1,12,8,3,8,12,20,0,4,0,1,1.15,7.74,20.29,1.57,2.4,3,0,0.8296986,0.1232756,0.04702579,2.612371,0.264353,1,4,-5,3,2.348018,-8,-4,-1,0
"2420","I1",10,"21.09.2019","Yes","Milan","Inter",0,2,7,11,3,9,15,22,2,1,0,0,3.37,3.2,2.27,2.11,1.73,0,3,0.282669,0.2976858,0.4196452,1.145693,1.556621,-2,-4,-6,-3,-0.4109285,-7,1,0,0
"2421","I1",10,"22.09.2019","Yes","Sassuolo","Spal",3,0,17,8,8,3,19,14,3,2,0,0,1.97,3.55,3.88,1.79,2.04,3,0,0.4848105,0.2690357,0.2461538,1.723467,1.007497,3,9,5,3,0.7159702,5,1,0,0
"2422","I1",10,"22.09.2019","Yes","Bologna","Roma",1,2,5,14,3,7,13,16,3,6,0,1,2.81,3.57,2.42,1.6,2.33,0,3,0.3391817,0.266975,0.3938433,1.28452,1.448505,-1,-9,-4,-3,-0.1639846,-3,-3,-1,0
"2423","I1",10,"22.09.2019","Yes","Lecce","Napoli",1,4,8,12,3,10,12,9,3,3,0,0,8.81,5.18,1.35,1.56,2.42,0,3,0.1083811,0.1843316,0.7072872,0.509475,2.306193,-3,-4,-7,-3,-1.796718,3,0,0,0
"2424","I1",10,"22.09.2019","Yes","Sampdoria","Torino",1,0,10,6,6,1,19,13,2,1,0,0,2.53,3.35,2.81,1.85,1.96,3,0,0.3765656,0.2843913,0.3390431,1.414088,1.301521,1,4,5,3,0.1125677,6,1,0,0
"2425","I1",10,"22.09.2019","Yes","Atalanta","Fiorentina",2,2,15,6,5,3,14,11,2,5,0,0,2.02,3.69,3.55,1.58,2.38,1,1,0.4724916,0.258654,0.2688544,1.676129,1.065217,0,9,2,0,0.6109117,3,-3,0,0
"2426","I1",10,"22.09.2019","Yes","Lazio","Parma",2,0,22,3,15,1,7,9,1,3,0,0,1.31,5.52,9.72,1.57,2.4,3,0,0.7288138,0.1729613,0.09822491,2.359403,0.467636,2,19,14,3,1.891767,-2,-2,0,0
"2427","I1",10,"24.09.2019","Yes","Verona","Udinese",0,0,8,5,4,3,7,18,0,4,0,0,2.56,3.18,2.92,2.13,1.72,1,1,0.3728917,0.3001895,0.3269188,1.418865,1.280946,0,3,1,0,0.1379188,-11,-4,0,0
"2428","I1",10,"24.09.2019","Yes","Brescia","Juventus",1,2,13,15,3,7,11,14,1,3,0,0,6.33,4,1.57,1.89,1.94,0,3,0.1511865,0.2392526,0.6095609,0.6928121,2.067935,-1,-2,-4,-3,-1.375123,-3,-2,0,0
"2429","I1",10,"25.09.2019","Yes","Roma","Atalanta",0,2,8,11,4,4,18,11,2,1,0,0,2.25,3.72,2.98,1.44,2.76,0,3,0.4237517,0.2563015,0.3199468,1.527557,1.216142,-2,-3,0,-3,0.3114149,7,1,0,0
"2430","I1",10,"25.09.2019","Yes","Fiorentina","Sampdoria",2,1,12,7,8,4,11,16,4,5,0,1,1.7,4.04,4.73,1.68,2.19,3,0,0.5617346,0.2363735,0.2018919,1.921577,0.8420493,1,5,4,3,1.079528,-5,-1,-1,0
"2431","I1",10,"25.09.2019","Yes","Genoa","Bologna",0,0,8,14,4,2,16,11,5,4,0,0,2.37,3.52,2.91,1.68,2.2,1,1,0.4019731,0.2706467,0.3273802,1.476566,1.252787,0,-6,2,0,0.2237789,5,1,0,0
"2432","I1",10,"25.09.2019","Yes","Inter","Lazio",1,0,9,6,4,4,10,8,2,3,0,0,2.02,3.56,3.68,1.82,2,3,0,0.4725164,0.2681132,0.2593704,1.685662,1.046224,1,3,0,3,0.6394379,2,-1,0,0
"2433","I1",10,"25.09.2019","Yes","Napoli","Cagliari",0,1,17,5,8,1,9,13,1,1,1,0,1.2,7.02,13.29,1.37,3.08,0,3,0.7928745,0.1355341,0.07159138,2.514158,0.3503082,-1,12,7,-3,2.163849,-4,0,1,0
"2434","I1",10,"25.09.2019","Yes","Parma","Sassuolo",1,0,8,8,4,5,19,9,3,1,0,0,2.57,3.46,2.7,1.79,2.03,3,0,0.371109,0.2756503,0.3532407,1.388977,1.335373,1,0,-1,3,0.05360463,10,2,0,0
"2435","I1",10,"25.09.2019","Yes","Spal","Lecce",1,3,14,9,7,5,13,11,1,2,0,0,1.97,3.57,3.83,1.76,2.07,0,3,0.4839847,0.2670728,0.2489425,1.719027,1.0139,-2,5,2,-3,0.7051265,2,-1,0,0
"2436","I1",10,"26.09.2019","Yes","Torino","Milan",2,1,11,16,5,4,15,20,4,5,0,1,2.46,3.21,3.02,2.11,1.73,3,0,0.387458,0.2969305,0.3156115,1.459305,1.243765,1,-5,1,3,0.2155396,-5,-1,-1,0
"2437","I1",10,"28.09.2019","Yes","Juventus","Spal",2,0,17,4,10,1,13,9,2,2,0,0,1.24,6.03,13.13,1.66,2.23,3,0,0.7691842,0.1581739,0.07264192,2.465727,0.3760996,2,13,9,3,2.089627,4,0,0,0
"2438","I1",10,"28.09.2019","Yes","Sampdoria","Inter",1,3,15,11,2,7,11,13,2,4,0,1,5.15,3.92,1.67,1.76,2.08,0,3,0.1852673,0.2433996,0.5713332,0.7992014,1.957399,-2,4,-5,-3,-1.158198,-2,-2,-1,0
"2439","I1",10,"28.09.2019","Yes","Sassuolo","Atalanta",1,4,9,10,7,8,14,14,2,2,0,0,3.39,3.81,2.03,1.57,2.39,0,3,0.2809214,0.2499537,0.4691249,1.092718,1.657328,-3,-1,-1,-3,-0.5646105,0,0,0,0
"2440","I1",10,"29.09.2019","Yes","Napoli","Brescia",2,1,16,7,7,3,11,8,2,1,0,0,1.27,6.1,10.19,1.41,2.89,3,0,0.750284,0.1562067,0.09350938,2.407059,0.4367348,1,9,4,3,1.970324,3,1,0,0
"2441","I1",10,"29.09.2019","Yes","Lazio","Genoa",4,0,13,12,11,6,8,11,1,2,0,0,1.46,4.74,6.56,1.5,2.58,3,0,0.653348,0.2012422,0.1454098,2.161286,0.6374715,4,1,5,3,1.523815,-3,-1,0,0
"2442","I1",10,"29.09.2019","Yes","Lecce","Roma",0,1,10,13,6,6,7,19,2,4,0,0,4.34,3.98,1.76,1.48,2.64,0,3,0.2194734,0.2393252,0.5412014,0.8977454,1.862929,-1,-3,0,-3,-0.965184,-12,-2,0,0
"2443","I1",10,"29.09.2019","Yes","Udinese","Bologna",1,0,9,10,4,4,20,16,4,3,0,1,2.87,3.26,2.53,2.03,1.8,3,0,0.3317019,0.2920197,0.3762784,1.287125,1.420855,1,-1,0,3,-0.1337296,4,1,-1,0
"2444","I1",10,"29.09.2019","Yes","Cagliari","Verona",1,1,10,11,5,5,18,18,2,2,0,0,2.08,3.35,3.72,2.17,1.69,1,1,0.4587082,0.2848098,0.256482,1.660934,1.054256,0,-1,0,0,0.6066785,0,0,0,0
"2445","I1",10,"29.09.2019","Yes","Milan","Fiorentina",1,3,7,13,3,8,10,14,2,4,1,0,2.34,3.19,3.25,2.13,1.72,0,3,0.407574,0.2989728,0.2934533,1.521695,1.179333,-2,-6,-5,-3,0.3423621,-4,-2,1,0
"2446","I1",10,"30.09.2019","Yes","Parma","Torino",3,2,13,6,7,5,17,15,2,3,0,1,3.11,3.32,2.34,1.99,1.83,3,0,0.306203,0.2868348,0.4069622,1.205444,1.507721,1,7,2,3,-0.3022774,2,-1,-1,0
"2447","I1",10,"05.10.2019","Yes","Spal","Parma",1,0,12,5,7,2,9,13,5,2,1,0,2.42,3.23,3.07,2,1.81,3,0,0.3940887,0.2952615,0.3106497,1.477528,1.227211,1,7,5,3,0.2503169,-4,3,1,0
"2448","I1",10,"05.10.2019","Yes","Verona","Sampdoria",2,0,6,9,4,3,14,14,1,3,0,0,2.47,3.3,2.93,1.92,1.89,3,0,0.3858787,0.2888243,0.325297,1.44646,1.264715,2,-3,1,3,0.1817449,0,-2,0,0
"2449","I1",10,"05.10.2019","Yes","Genoa","Milan",1,2,11,9,6,7,23,14,4,4,2,2,2.96,3.26,2.47,2,1.81,0,3,0.3219206,0.292296,0.3857834,1.258058,1.449646,-1,2,-1,-3,-0.1915884,9,0,0,0
"2450","I1",10,"06.10.2019","Yes","Fiorentina","Udinese",1,0,8,5,4,1,9,11,1,2,0,0,1.56,4.1,6.11,1.87,1.94,3,0,0.6113191,0.2325995,0.1560815,2.066557,0.7008439,1,3,3,3,1.365713,-2,-1,0,0
"2451","I1",10,"06.10.2019","Yes","Atalanta","Lecce",3,1,26,5,14,2,15,14,2,3,0,0,1.28,6.09,9.64,1.42,2.86,3,0,0.7446234,0.1565054,0.09887116,2.390376,0.4531189,2,21,12,3,1.937257,1,-1,0,0
"2452","I1",10,"06.10.2019","Yes","Bologna","Lazio",2,2,17,8,10,6,13,17,5,4,1,1,3.31,3.7,2.1,1.68,2.19,1,1,0.2881193,0.2577499,0.4541308,1.122108,1.620142,0,9,4,0,-0.4980347,-4,1,0,0
"2453","I1",10,"06.10.2019","Yes","Roma","Cagliari",1,1,17,6,8,3,17,11,1,4,0,0,1.45,4.71,6.77,1.5,2.57,1,1,0.6570148,0.2022657,0.1407196,2.17331,0.6244244,0,11,5,0,1.548886,6,-3,0,0
"2454","I1",10,"06.10.2019","Yes","Torino","Napoli",0,0,11,10,6,3,11,12,1,2,0,0,4.06,3.8,1.85,1.66,2.23,1,1,0.2345757,0.2506256,0.5147986,0.9543528,1.795022,0,1,3,0,-0.8406687,-1,-1,0,0
"2455","I1",10,"06.10.2019","Yes","Inter","Juventus",1,2,6,8,4,6,22,8,2,3,0,0,2.63,3.14,2.84,2.15,1.71,0,3,0.3618422,0.3030716,0.3350862,1.388598,1.30833,-1,-2,-2,-3,0.0802678,14,-1,0,0
"2456","I1",10,"19.10.2019","Yes","Lazio","Atalanta",3,3,12,18,5,9,13,12,5,2,0,0,2.21,3.7,3.08,1.56,2.41,1,1,0.4319972,0.2580308,0.309972,1.554022,1.187947,0,-6,-4,0,0.3660756,1,3,0,0
"2457","I1",10,"19.10.2019","Yes","Napoli","Verona",2,0,13,14,7,6,12,16,3,3,0,0,1.21,6.66,14.08,1.5,2.58,3,0,0.7888805,0.1433251,0.06779441,2.509967,0.3467084,2,-1,1,3,2.163258,-4,0,0,0
"2458","I1",10,"19.10.2019","Yes","Juventus","Bologna",2,1,13,7,11,4,15,18,2,3,0,0,1.33,5.11,10.07,1.66,2.23,3,0,0.7182105,0.1869315,0.09485799,2.341563,0.4715055,1,6,7,3,1.870058,-3,-1,0,0
"2459","I1",10,"20.10.2019","Yes","Sassuolo","Inter",3,4,7,10,4,7,14,17,4,3,0,0,5.15,3.79,1.7,1.72,2.13,0,3,0.185589,0.2521856,0.5622255,0.8089525,1.938862,-1,-3,-3,-3,-1.129909,-3,1,0,0
"2460","I1",10,"20.10.2019","Yes","Cagliari","Spal",2,0,13,8,7,5,16,15,4,5,0,0,2.12,3.35,3.6,2.07,1.76,3,0,0.4501008,0.2848399,0.2650593,1.635142,1.080018,2,5,2,3,0.5551243,1,-1,0,0
"2461","I1",10,"20.10.2019","Yes","Sampdoria","Roma",0,0,7,5,2,1,14,11,3,4,0,1,3.28,3.54,2.17,1.65,2.24,1,1,0.2908605,0.2694979,0.4396417,1.142079,1.588423,0,2,1,0,-0.4463435,3,-1,-1,0
"2462","I1",10,"20.10.2019","Yes","Udinese","Torino",1,0,10,8,6,5,15,20,3,3,0,0,2.83,3.16,2.63,2.17,1.69,3,0,0.3365173,0.3013747,0.362108,1.310927,1.387699,1,2,1,3,-0.07677201,-5,0,0,0
"2463","I1",10,"20.10.2019","Yes","Parma","Genoa",5,1,15,11,7,6,9,12,1,2,0,0,2.51,3.21,2.95,2.02,1.81,3,0,0.3798268,0.2969985,0.3231747,1.436479,1.266523,4,4,1,3,0.1699564,-3,-1,0,0
"2464","I1",10,"20.10.2019","Yes","Milan","Lecce",2,2,18,11,8,7,13,12,1,2,0,0,1.4,4.82,7.9,1.74,2.1,1,1,0.6813513,0.1979029,0.1207458,2.241957,0.5601403,0,7,1,0,1.681817,1,-1,0,0
"2465","I1",10,"21.10.2019","Yes","Brescia","Fiorentina",0,0,3,10,1,6,10,16,0,3,0,0,3.7,3.57,2,1.78,2.04,1,1,0.2573066,0.2666763,0.4760172,1.038596,1.694728,0,-7,-5,0,-0.6561318,-6,-3,0,0
"2466","I1",10,"25.10.2019","Yes","Verona","Sassuolo",0,1,7,9,5,5,18,13,5,5,0,0,2.44,3.27,3.02,1.95,1.87,0,3,0.3915236,0.2921461,0.3163303,1.466717,1.241137,-1,-2,0,-3,0.2255798,5,0,0,0
"2467","I1",10,"26.10.2019","Yes","Lecce","Juventus",1,1,9,16,5,6,11,13,4,1,0,0,9.07,5.15,1.34,1.6,2.34,1,1,0.1049338,0.1848057,0.7102606,0.4996069,2.315587,0,-7,-1,0,-1.81598,-2,3,0,0
"2468","I1",10,"26.10.2019","Yes","Inter","Parma",2,2,16,10,7,5,9,11,3,2,0,0,1.27,5.74,11.41,1.56,2.41,1,1,0.7504351,0.166037,0.08352784,2.417342,0.4166205,0,6,2,0,2.000722,-2,1,0,0
"2469","I1",10,"26.10.2019","Yes","Genoa","Brescia",3,1,12,4,11,2,24,14,6,4,0,0,1.89,3.79,3.93,1.7,2.15,3,0,0.5051534,0.2519103,0.2429364,1.76737,0.9807193,2,8,9,3,0.7866511,10,2,0,0
"2470","I1",10,"27.10.2019","Yes","Bologna","Sampdoria",2,1,10,5,6,3,14,18,1,3,0,0,1.91,3.66,3.96,1.81,2.01,3,0,0.4989569,0.2603846,0.2406585,1.757255,0.9823601,1,5,3,3,0.7748952,-4,-2,0,0
"2471","I1",10,"27.10.2019","Yes","Atalanta","Udinese",7,1,23,6,16,3,10,5,2,3,0,1,1.43,4.65,7.41,1.65,2.24,3,0,0.6664404,0.2049483,0.1286113,2.204269,0.5907822,6,17,13,3,1.613487,5,-1,-1,0
"2472","I1",10,"27.10.2019","Yes","Spal","Napoli",1,1,5,9,3,4,16,14,4,1,0,0,7.28,4.71,1.43,1.6,2.34,1,1,0.1309491,0.2024011,0.6666498,0.5952483,2.202351,0,-4,-1,0,-1.607102,2,3,0,0
"2473","I1",10,"27.10.2019","Yes","Torino","Cagliari",1,1,8,10,5,5,15,11,2,3,0,0,1.81,3.7,4.42,1.93,1.88,1,1,0.5266785,0.2576454,0.215676,1.837681,0.9046736,0,-2,0,0,0.9330074,4,-1,0,0
"2474","I1",10,"27.10.2019","Yes","Roma","Milan",2,1,10,8,5,4,12,17,4,5,0,0,2.19,3.47,3.27,1.76,2.07,3,0,0.4346222,0.2743005,0.2910773,1.578167,1.147532,1,2,1,3,0.4306349,-5,-1,0,0
"2475","I1",10,"27.10.2019","Yes","Fiorentina","Lazio",1,2,9,11,3,8,12,13,5,3,1,0,2.46,3.51,2.8,1.73,2.12,0,3,0.3876831,0.2717095,0.3406073,1.434759,1.293532,-1,-2,-5,-3,0.1412274,-1,2,1,0
"2476","I1",10,"29.10.2019","Yes","Parma","Verona",0,1,15,6,7,2,13,16,1,5,0,0,2.71,3.11,2.81,2.14,1.72,0,3,0.3526347,0.3072798,0.3400855,1.365184,1.327536,-1,9,5,-3,0.03764784,-3,-4,0,0
"2477","I1",10,"29.10.2019","Yes","Brescia","Inter",1,2,6,6,5,2,14,18,4,3,0,0,6.55,4.33,1.51,1.7,2.16,0,3,0.1459758,0.2208179,0.6332063,0.6587453,2.120437,-1,0,3,-3,-1.461691,-4,1,0,0
"2478","I1",10,"30.10.2019","Yes","Napoli","Atalanta",2,2,15,12,11,6,16,14,3,3,0,0,2.03,3.74,3.46,1.51,2.56,1,1,0.4695969,0.2548882,0.2755149,1.663679,1.081433,0,3,5,0,0.5822459,2,0,0,0
"2479","I1",10,"30.10.2019","Yes","Cagliari","Bologna",3,2,12,6,5,3,15,20,2,1,0,0,2.71,3.34,2.63,1.92,1.89,3,0,0.3518902,0.2855157,0.3625941,1.341186,1.373298,1,6,2,3,-0.03211165,-5,1,0,0
"2480","I1",10,"30.10.2019","Yes","Juventus","Genoa",2,1,18,7,11,3,24,11,5,3,1,2,1.27,5.69,11.91,1.61,2.32,3,0,0.7519749,0.1678397,0.0801854,2.423764,0.4083959,1,11,8,3,2.015368,13,2,-1,0
"2481","I1",10,"30.10.2019","Yes","Lazio","Torino",4,0,16,6,8,3,11,9,2,2,0,1,1.56,4.16,5.94,1.72,2.13,3,0,0.6106399,0.22899,0.1603701,2.06091,0.7101002,4,10,5,3,1.35081,2,0,-1,0
"2482","I1",10,"30.10.2019","Yes","Sampdoria","Lecce",1,1,15,9,6,4,19,14,4,4,0,1,1.73,3.82,4.76,1.8,2.02,1,1,0.5505623,0.2493384,0.2000993,1.901025,0.8496364,0,6,2,0,1.051389,5,0,-1,0
"2483","I1",10,"30.10.2019","Yes","Sassuolo","Fiorentina",1,2,6,10,5,8,15,20,3,4,0,0,2.81,3.45,2.48,1.75,2.08,0,3,0.339264,0.2763281,0.384408,1.29412,1.429552,-1,-4,-3,-3,-0.135432,-5,-1,0,0
"2484","I1",10,"30.10.2019","Yes","Udinese","Roma",0,4,8,10,5,6,16,16,4,2,0,1,3.97,3.59,1.93,1.95,1.86,0,3,0.2402204,0.2656476,0.494132,0.9863087,1.748044,-4,-2,-1,-3,-0.761735,0,2,-1,0
"2485","I1",10,"31.10.2019","Yes","Milan","Spal",1,0,10,5,6,2,17,21,4,4,0,0,1.47,4.25,7.29,1.81,2.01,3,0,0.6461917,0.2235063,0.130302,2.162081,0.6144124,1,5,4,3,1.547669,-4,0,0,0
"2486","I1",10,"02.11.2019","Yes","Roma","Napoli",2,1,13,12,7,6,23,14,5,3,1,0,2.69,3.58,2.52,1.62,2.29,3,0,0.3547537,0.2665608,0.3786855,1.330822,1.402617,1,1,1,3,-0.0717954,9,2,1,0
"2487","I1",10,"02.11.2019","Yes","Bologna","Inter",1,2,8,11,3,9,12,24,3,4,0,0,3.61,3.54,2.04,1.81,2,0,3,0.2638953,0.2691136,0.4669912,1.060799,1.670087,-1,-3,-6,-3,-0.6092876,-12,-1,0,0
"2488","I1",10,"02.11.2019","Yes","Torino","Juventus",0,1,7,14,4,10,22,16,4,2,0,0,6.57,4.04,1.54,1.95,1.86,0,3,0.1450858,0.2359441,0.6189701,0.6712016,2.092854,-1,-7,-6,-3,-1.421653,6,2,0,0
"2489","I1",10,"03.11.2019","Yes","Atalanta","Cagliari",0,2,11,12,3,8,15,18,2,3,1,0,1.31,5.59,9.56,1.41,2.87,0,3,0.7291944,0.1708846,0.099921,2.358468,0.4706476,-2,-1,-5,-3,1.88782,-3,-1,1,0
"2490","I1",10,"03.11.2019","Yes","Genoa","Udinese",1,3,10,13,2,5,11,13,0,2,0,0,1.93,3.5,4.07,2.04,1.79,0,3,0.4936736,0.2722257,0.2341007,1.753246,0.9745279,-2,-3,-3,-3,0.7787185,-2,-2,0,0
"2491","I1",10,"03.11.2019","Yes","Lecce","Sassuolo",2,2,7,12,4,5,14,16,2,3,0,0,2.76,3.32,2.58,1.83,1.98,1,1,0.3446977,0.2865559,0.3687464,1.320649,1.392795,0,-5,-1,0,-0.07214603,-2,-1,0,0
"2492","I1",10,"03.11.2019","Yes","Verona","Brescia",2,1,11,11,6,5,17,17,1,4,0,1,2.13,3.23,3.68,2.19,1.68,3,0,0.4467782,0.2946246,0.2585972,1.634959,1.070416,1,0,1,3,0.5645431,0,-3,-1,0
"2493","I1",10,"03.11.2019","Yes","Fiorentina","Parma",1,1,15,7,4,3,15,20,2,2,0,0,1.5,4.37,6.46,1.7,2.15,1,1,0.6347403,0.2178742,0.1473855,2.122095,0.6600308,0,8,1,0,1.462064,-5,0,0,0
"2494","I1",10,"03.11.2019","Yes","Milan","Lazio",1,2,9,8,4,7,12,13,3,5,0,0,3.05,3.42,2.32,1.92,1.88,0,3,0.3118696,0.2781293,0.410001,1.213738,1.508132,-1,1,-3,-3,-0.2943942,-1,-2,0,0
"2495","I1",10,"04.11.2019","Yes","Spal","Sampdoria",0,1,7,9,2,4,12,16,3,1,0,0,2.62,3.24,2.77,2.06,1.76,0,3,0.3630436,0.2935723,0.3433842,1.382703,1.323725,-1,-2,-2,-3,0.0589782,-4,2,0,0
"2496","I1",10,"08.11.2019","Yes","Sassuolo","Bologna",3,1,13,9,8,7,16,17,2,6,0,0,2.73,3.45,2.57,1.69,2.19,3,0,0.3504393,0.2773041,0.3722565,1.328622,1.394074,2,4,1,3,-0.0654517,-1,-4,0,0
"2497","I1",10,"09.11.2019","Yes","Brescia","Torino",0,4,5,12,3,7,18,17,5,3,1,0,2.78,3.29,2.59,1.95,1.86,0,3,0.3426601,0.2895426,0.3677973,1.317523,1.392935,-4,-7,-4,-3,-0.07541168,1,2,1,0
"2498","I1",10,"09.11.2019","Yes","Inter","Verona",2,1,19,5,13,2,14,11,3,1,0,0,1.33,5.11,9.72,1.63,2.27,3,0,0.7157657,0.1862952,0.09793913,2.333592,0.4801126,1,14,11,3,1.85348,3,2,0,0
"2499","I1",10,"09.11.2019","Yes","Napoli","Genoa",0,0,13,8,8,3,15,19,1,4,0,0,1.38,5.08,7.67,1.49,2.59,1,1,0.6889067,0.187144,0.1239493,2.253864,0.5589919,0,5,5,0,1.694872,-4,-3,0,0
"2500","I1",10,"10.11.2019","Yes","Cagliari","Fiorentina",5,2,12,10,8,7,12,15,1,3,0,0,2.86,3.32,2.5,1.94,1.87,3,0,0.3327293,0.2866283,0.3806424,1.284816,1.428555,3,2,1,3,-0.1437391,-3,-2,0,0
"2501","I1",10,"10.11.2019","Yes","Lazio","Lecce",4,2,17,18,7,10,8,10,2,3,0,0,1.24,6.45,11.03,1.36,3.14,3,0,0.7664781,0.1473539,0.08616798,2.446788,0.4058579,2,-1,-3,3,2.04093,-2,-1,0,0
"2502","I1",10,"10.11.2019","Yes","Sampdoria","Atalanta",0,0,5,7,2,3,19,13,2,4,0,1,3.91,3.81,1.88,1.64,2.25,1,1,0.243544,0.2499362,0.5065197,0.9805683,1.769495,0,-2,-1,0,-0.7889272,6,-2,-1,0
"2503","I1",10,"10.11.2019","Yes","Udinese","Spal",0,0,11,10,4,4,14,14,3,5,0,0,2.12,3.23,3.72,2.08,1.75,1,1,0.449188,0.2948231,0.2559889,1.642387,1.06279,0,1,0,0,0.5795975,0,-2,0,0
"2504","I1",10,"10.11.2019","Yes","Parma","Roma",2,0,13,10,8,7,16,9,3,2,0,0,3.97,3.72,1.89,1.72,2.12,3,0,0.2399386,0.2560635,0.503998,0.9758792,1.768057,2,3,1,3,-0.7921781,7,1,0,0
"2505","I1",10,"10.11.2019","Yes","Juventus","Milan",1,0,11,10,5,7,13,10,1,5,0,0,1.4,4.67,8.01,1.8,2.01,3,0,0.678165,0.2033043,0.1185307,2.237799,0.5588964,1,1,-2,3,1.678903,3,-4,0,0
"2506","I1",10,"23.11.2019","Yes","Atalanta","Juventus",1,3,14,11,9,5,17,13,5,3,0,0,2.72,3.41,2.55,1.77,2.05,0,3,0.3491229,0.2784793,0.3723978,1.325848,1.395673,-2,3,4,-3,-0.06982459,4,2,0,0
"2507","I1",10,"23.11.2019","Yes","Milan","Napoli",1,1,11,12,4,6,19,15,3,2,0,0,3.2,3.47,2.22,1.89,1.92,1,1,0.2972977,0.274165,0.4285372,1.166058,1.559777,0,-1,-2,0,-0.3937186,4,1,0,0
"2508","I1",10,"23.11.2019","Yes","Torino","Inter",0,3,5,6,2,5,10,18,2,3,0,0,4.36,3.57,1.84,1.91,1.89,0,3,0.2178244,0.2660264,0.5161491,0.9194997,1.814474,-3,-1,-3,-3,-0.8949742,-8,-1,0,0
"2509","I1",10,"24.11.2019","Yes","Bologna","Parma",2,2,11,11,7,7,18,18,1,3,0,0,1.78,3.82,4.4,1.83,1.98,1,1,0.5346124,0.2491126,0.216275,1.85295,0.8979376,0,0,0,0,0.9550122,0,-2,0,0
"2510","I1",10,"24.11.2019","Yes","Roma","Brescia",3,0,14,5,6,2,17,10,1,1,0,0,1.34,5.21,8.88,1.49,2.59,3,0,0.7101775,0.182656,0.1071664,2.313189,0.5041553,3,9,4,3,1.809033,7,0,0,0
"2511","I1",10,"24.11.2019","Yes","Sassuolo","Lazio",1,2,5,10,2,6,14,14,1,3,0,0,4.36,4.06,1.74,1.53,2.48,0,3,0.2183578,0.2344926,0.5471495,0.8895662,1.875941,-1,-5,-4,-3,-0.986375,0,-2,0,0
"2512","I1",10,"24.11.2019","Yes","Verona","Fiorentina",1,0,13,7,8,2,18,8,3,2,0,0,3.26,3.23,2.29,2.08,1.75,3,0,0.2913016,0.2940071,0.4146913,1.167912,1.538081,1,6,6,3,-0.3701692,10,1,0,0
"2513","I1",10,"24.11.2019","Yes","Sampdoria","Udinese",2,1,19,5,13,2,8,22,2,3,0,1,2.13,3.23,3.63,2.32,1.61,3,0,0.4451925,0.2935789,0.2612286,1.629156,1.077265,1,14,11,3,0.5518915,-14,-1,-1,0
"2514","I1",10,"25.11.2019","Yes","Lecce","Cagliari",2,2,17,6,8,2,13,19,2,2,1,2,3.11,3.52,2.23,1.76,2.07,1,1,0.3050509,0.2695194,0.4254297,1.184672,1.545809,0,11,6,0,-0.3611365,-6,0,-1,0
"2515","I1",10,"25.11.2019","Yes","Spal","Genoa",1,1,13,13,7,6,12,13,2,1,0,0,2.55,3.21,2.86,2.1,1.73,1,1,0.3723007,0.2957529,0.3319464,1.412655,1.291592,0,0,1,0,0.1210628,-1,1,0,0
"2516","I1",10,"30.11.2019","Yes","Brescia","Atalanta",0,3,9,19,5,12,15,15,1,3,0,0,6.47,4.66,1.47,1.49,2.6,0,3,0.1472803,0.2044858,0.6482339,0.6463268,2.149187,-3,-10,-7,-3,-1.502861,0,-2,0,0
"2517","I1",10,"30.11.2019","Yes","Genoa","Torino",0,1,5,10,3,3,15,18,2,3,0,1,2.42,3.3,2.98,1.99,1.82,0,3,0.3928634,0.2880998,0.3190367,1.46669,1.24521,-1,-5,0,-3,0.22148,-3,-1,-1,0
"2518","I1",10,"30.11.2019","Yes","Fiorentina","Lecce",0,1,13,6,6,6,13,21,1,3,0,0,1.42,4.74,7.26,1.5,2.56,0,3,0.6688201,0.2003638,0.1308161,2.206824,0.592812,-1,7,0,-3,1.614012,-8,-2,0,0
"2519","I1",10,"01.12.2019","Yes","Juventus","Sassuolo",2,2,17,8,9,4,11,13,1,5,0,0,1.23,6.3,12.33,1.51,2.54,1,1,0.7722039,0.1507636,0.0770325,2.467375,0.3818611,0,9,5,0,2.085514,-2,-4,0,0
"2520","I1",10,"01.12.2019","Yes","Inter","Spal",2,1,16,8,10,3,15,17,1,4,0,0,1.26,5.77,11.86,1.61,2.3,3,0,0.754939,0.1648567,0.08020431,2.429674,0.4054696,1,8,7,3,2.024204,-2,-3,0,0
"2521","I1",10,"01.12.2019","Yes","Lazio","Udinese",3,0,15,4,6,0,9,12,0,1,0,0,1.3,5.42,10,1.51,2.52,3,0,0.7300057,0.1750936,0.09490074,2.365111,0.4597958,3,11,6,3,1.905315,-3,-1,0,0
"2522","I1",10,"01.12.2019","Yes","Parma","Milan",0,1,6,19,0,8,13,15,1,3,0,0,3.55,3.33,2.13,1.99,1.82,0,3,0.2679002,0.2855994,0.4465004,1.0893,1.625101,-1,-13,-8,-3,-0.5358005,-2,-2,0,0
"2523","I1",10,"01.12.2019","Yes","Napoli","Bologna",1,2,20,9,5,6,12,10,1,5,0,0,1.48,4.5,6.56,1.56,2.41,0,3,0.6432942,0.2115723,0.1451335,2.141455,0.6469727,-1,11,-1,-3,1.494482,2,-4,0,0
"2524","I1",10,"01.12.2019","Yes","Verona","Roma",1,3,7,12,3,5,11,14,3,3,0,0,4.28,3.57,1.86,1.89,1.92,0,3,0.2222245,0.2664204,0.5113552,0.9330937,1.800486,-2,-5,-2,-3,-0.8673922,-3,0,0,0
"2525","I1",10,"02.12.2019","Yes","Cagliari","Sampdoria",4,3,12,9,8,5,15,12,3,1,0,0,2.17,3.28,3.47,2.04,1.77,3,0,0.4372644,0.2892878,0.2734478,1.601081,1.109631,1,3,3,3,0.49145,3,2,0,0
"2526","I1",10,"06.12.2019","Yes","Inter","Roma",0,0,9,6,2,2,12,11,3,1,0,0,1.89,3.78,3.97,1.64,2.28,1,1,0.5060548,0.2530274,0.2409178,1.771192,0.9757808,0,3,0,0,0.7954111,1,2,0,0
"2527","I1",10,"07.12.2019","Yes","Atalanta","Verona",3,2,21,7,10,2,14,16,1,5,0,1,1.33,5.19,9.39,1.56,2.41,3,0,0.7153577,0.183319,0.1013233,2.329392,0.4872889,1,14,8,3,1.842103,-2,-4,-1,0
"2528","I1",10,"07.12.2019","Yes","Udinese","Napoli",1,1,5,12,1,3,20,15,3,4,0,1,5.24,3.78,1.68,1.9,1.91,1,1,0.1816434,0.251802,0.5665545,0.7967323,1.951466,0,-7,-2,0,-1.154733,5,-1,-1,0
"2529","I1",10,"07.12.2019","Yes","Lazio","Juventus",3,1,12,8,8,5,14,10,4,3,0,1,2.84,3.44,2.44,1.8,2.01,3,0,0.3345023,0.2761589,0.3893388,1.279666,1.444175,2,4,3,3,-0.1645093,4,1,-1,0
"2530","I1",10,"08.12.2019","Yes","Lecce","Genoa",2,2,22,14,5,4,17,18,5,6,0,2,2.66,3.49,2.55,1.75,2.08,1,1,0.3564662,0.2716906,0.3718432,1.341089,1.38722,0,8,1,0,-0.04613092,-1,-1,-2,0
"2531","I1",10,"08.12.2019","Yes","Sassuolo","Cagliari",2,2,9,4,3,3,10,19,3,4,0,0,2.4,3.48,2.87,1.7,2.15,1,1,0.3958997,0.2730343,0.331066,1.460733,1.266232,0,5,0,0,0.1945013,-9,-1,0,0
"2532","I1",10,"08.12.2019","Yes","Spal","Brescia",0,1,18,12,4,7,17,18,3,3,0,0,2.05,3.37,3.75,2.15,1.7,0,3,0.4640424,0.282281,0.2536765,1.674408,1.043311,-1,6,-3,-3,0.6310977,-1,0,0,0
"2533","I1",10,"08.12.2019","Yes","Torino","Fiorentina",2,1,10,15,5,5,19,17,4,3,0,0,2.46,3.2,3,2.08,1.74,3,0,0.3862868,0.296958,0.3167552,1.455818,1.247224,1,-5,0,3,0.2085949,2,1,0,0
"2534","I1",10,"08.12.2019","Yes","Sampdoria","Parma",0,1,18,10,6,2,15,12,3,2,0,0,2.02,3.39,3.83,2.08,1.75,0,3,0.4709683,0.280636,0.2483958,1.693541,1.025823,-1,8,4,-3,0.6677174,3,1,0,0
"2535","I1",10,"08.12.2019","Yes","Bologna","Milan",2,3,11,11,4,7,17,19,4,2,0,0,2.94,3.37,2.41,1.86,1.94,0,3,0.3233817,0.2821194,0.3944989,1.252265,1.465616,-1,0,-3,-3,-0.2133514,-2,2,0,0
"2536","I1",10,"14.12.2019","Yes","Brescia","Lecce",3,0,13,11,9,4,17,26,4,6,0,0,2.02,3.72,3.52,1.69,2.16,3,0,0.4723946,0.2565153,0.2710901,1.673699,1.069786,3,2,5,3,0.6039135,-9,-2,0,0
"2537","I1",10,"14.12.2019","Yes","Napoli","Parma",1,2,22,7,9,5,9,12,2,2,0,0,1.31,5.5,9.72,1.51,2.51,0,3,0.7283557,0.1734811,0.09816317,2.358548,0.4679706,-1,15,4,-3,1.890578,-3,0,0,0
"2538","I1",10,"14.12.2019","Yes","Genoa","Sampdoria",0,1,5,2,1,1,16,26,5,3,0,0,2.67,3.18,2.77,2.02,1.79,0,3,0.3566942,0.2994886,0.3438172,1.369571,1.33094,-1,3,0,-3,0.03863115,-10,2,0,0
"2539","I1",10,"15.12.2019","Yes","Verona","Torino",3,3,12,12,8,8,20,19,3,1,0,0,2.76,3.13,2.71,2.21,1.66,1,1,0.3447991,0.3040401,0.3511607,1.338438,1.357522,0,0,0,0,-0.01908482,1,2,0,0
"2540","I1",10,"15.12.2019","Yes","Bologna","Atalanta",2,1,8,15,5,7,14,18,5,1,1,0,3.69,3.89,1.91,1.55,2.42,3,0,0.2576972,0.244448,0.4978548,1.01754,1.738012,1,-7,-2,3,-0.7204728,-4,4,1,0
"2541","I1",10,"15.12.2019","Yes","Juventus","Udinese",3,1,14,9,12,7,10,4,2,1,0,0,1.22,6.25,14.04,1.61,2.3,3,0,0.7799737,0.1522509,0.06777549,2.492172,0.3555773,2,5,5,3,2.136594,6,1,0,0
"2542","I1",10,"15.12.2019","Yes","Milan","Sassuolo",0,0,17,10,12,6,14,16,5,4,0,0,1.55,4.45,5.55,1.6,2.32,1,1,0.6144039,0.2140058,0.1715903,2.057217,0.7287767,0,7,6,0,1.328441,-2,1,0,0
"2543","I1",10,"15.12.2019","Yes","Roma","Spal",3,1,18,5,13,3,10,17,1,3,0,0,1.29,5.42,10.89,1.58,2.35,3,0,0.7372105,0.1754615,0.08732797,2.387093,0.4374454,2,13,10,3,1.949648,-7,-2,0,0
"2544","I1",10,"15.12.2019","Yes","Fiorentina","Inter",1,1,10,7,5,5,15,17,3,4,0,0,3.6,3.49,2.05,1.86,1.94,1,1,0.2640183,0.2723398,0.4636419,1.064395,1.663265,0,3,0,0,-0.5988708,-2,-1,0,0
"2545","I1",10,"16.12.2019","Yes","Cagliari","Lazio",1,2,9,13,4,7,11,11,4,3,0,0,3.92,4.01,1.82,1.56,2.4,0,3,0.2420486,0.2366161,0.5213354,0.9627618,1.800622,-1,-4,-3,-3,-0.8378604,0,1,0,0
"2546","I1",10,"18.12.2019","Yes","Sampdoria","Juventus",1,2,13,10,4,4,7,17,5,2,1,0,6.15,4.32,1.53,1.87,1.93,0,3,0.1552019,0.2209472,0.6238509,0.686553,2.0925,-1,3,0,-3,-1.405947,-10,3,1,0
"2547","I1",10,"18.12.2019","Yes","Brescia","Sassuolo",0,2,15,11,6,6,16,17,2,3,0,0,2.37,3.6,2.86,1.64,2.25,0,3,0.4020901,0.2647093,0.3332006,1.47098,1.264311,-2,4,0,-3,0.2066687,-1,-1,0,0
"2548","I1",10,"20.12.2019","Yes","Fiorentina","Roma",1,4,7,8,4,6,20,16,4,3,0,0,3.09,3.48,2.3,1.77,2.05,0,3,0.3094625,0.2747814,0.4157561,1.203169,1.52205,-3,-1,-2,-3,-0.3188809,4,1,0,0
"2549","I1",10,"21.12.2019","Yes","Udinese","Cagliari",2,1,9,13,2,2,13,14,3,4,0,1,2.53,3.3,2.84,1.92,1.88,3,0,0.3762918,0.2884904,0.3352177,1.417366,1.294144,1,-4,0,3,0.1232223,-1,-1,-1,0
"2550","I1",10,"21.12.2019","Yes","Inter","Genoa",4,0,12,7,9,4,11,12,1,4,0,0,1.35,4.94,9.17,1.64,2.24,3,0,0.7039782,0.1923827,0.1036391,2.304317,0.5033,4,5,5,3,1.801017,-1,-3,0,0
"2551","I1",10,"21.12.2019","Yes","Torino","Spal",1,2,7,7,6,4,24,16,5,5,1,0,1.7,3.68,5.26,2,1.8,0,3,0.5601769,0.2587774,0.1810458,1.939308,0.8019146,-1,0,2,-3,1.137393,8,0,1,0
"2552","I1",10,"22.12.2019","Yes","Atalanta","Milan",5,0,14,4,12,1,7,12,2,4,0,0,1.8,3.79,4.32,1.66,2.22,3,0,0.5286528,0.2510752,0.220272,1.837034,0.9118912,5,10,11,3,0.9251424,-5,-2,0,0
"2553","I1",10,"22.12.2019","Yes","Lecce","Bologna",2,3,7,19,3,16,17,18,3,3,0,0,3.21,3.65,2.15,1.58,2.36,0,3,0.2965181,0.2607735,0.4427084,1.150328,1.588899,-1,-12,-13,-3,-0.438571,-1,0,0,0
"2554","I1",10,"22.12.2019","Yes","Parma","Brescia",1,1,13,11,6,4,16,10,3,2,0,0,2.08,3.36,3.67,1.96,1.84,1,1,0.4574973,0.2832126,0.25929,1.655705,1.061083,0,2,2,0,0.5946219,6,1,0,0
"2555","I1",10,"22.12.2019","Yes","Sassuolo","Napoli",1,2,12,14,5,11,16,13,2,2,0,0,4.65,4.27,1.66,1.49,2.57,0,3,0.2044907,0.2226889,0.5728204,0.8361611,1.94115,-1,-2,-6,-3,-1.104989,3,0,0,0
"2556","I1",10,"05.01.2020","Yes","Brescia","Lazio",1,2,4,15,3,7,12,24,5,4,1,0,5.52,4.34,1.56,1.53,2.48,0,3,0.1721066,0.2189006,0.6089927,0.7352205,2.045879,-1,-11,-4,-3,-1.310658,-12,1,1,0
"2557","I1",10,"05.01.2020","Yes","Spal","Verona",0,2,12,14,2,9,8,15,1,1,1,0,2.45,3.19,3.02,2.1,1.73,0,3,0.3877046,0.2977668,0.3145286,1.460881,1.241353,-2,-2,-7,-3,0.2195281,-7,0,1,0
"2558","I1",10,"05.01.2020","Yes","Genoa","Sassuolo",2,1,10,6,7,3,23,14,4,6,0,0,2.26,3.53,3.05,1.75,2.07,3,0,0.4199545,0.2688661,0.3111794,1.52873,1.202404,1,4,4,3,0.3263253,9,-2,0,0
"2559","I1",10,"05.01.2020","Yes","Roma","Torino",0,2,25,9,11,6,10,21,5,2,0,0,1.49,4.47,6.34,1.6,2.3,0,3,0.6376131,0.2125377,0.1498491,2.125377,0.6620851,-2,16,5,-3,1.463292,-11,3,0,0
"2560","I1",10,"06.01.2020","Yes","Bologna","Fiorentina",1,1,12,7,7,4,14,23,2,4,0,0,2.38,3.42,2.94,1.78,2.03,1,1,0.399133,0.2777593,0.3231077,1.475158,1.247082,0,5,3,0,0.228076,-9,-2,0,0
"2561","I1",10,"06.01.2020","Yes","Atalanta","Parma",5,0,18,3,11,1,12,13,2,4,0,0,1.29,5.77,9.4,1.45,2.71,3,0,0.7348596,0.1642927,0.1008477,2.368871,0.4668359,5,15,10,3,1.902035,-1,-2,0,0
"2562","I1",10,"06.01.2020","Yes","Juventus","Cagliari",4,0,15,5,11,3,9,15,1,1,0,0,1.26,6.01,10.9,1.48,2.61,3,0,0.7545764,0.1581974,0.08722626,2.421926,0.4198762,4,10,8,3,2.00205,-6,0,0,0
"2563","I1",10,"06.01.2020","Yes","Milan","Sampdoria",0,0,14,6,12,4,12,20,1,5,0,0,1.56,3.98,6.19,1.83,1.97,1,1,0.6082802,0.2384214,0.1532984,2.063262,0.6983166,0,8,8,0,1.364945,-8,-4,0,0
"2564","I1",10,"06.01.2020","Yes","Lecce","Udinese",0,1,10,7,6,4,17,11,1,1,0,0,2.69,3.48,2.52,1.71,2.13,0,3,0.352057,0.272136,0.3758069,1.328307,1.399557,-1,3,2,-3,-0.07124964,6,0,0,0
"2565","I1",10,"06.01.2020","Yes","Napoli","Inter",1,3,18,9,8,8,10,22,0,6,0,0,2.53,3.44,2.71,1.74,2.08,0,3,0.3746659,0.2755537,0.3497804,1.399551,1.324895,-2,9,0,-3,0.07465668,-12,-6,0,0
"2566","I1",10,"11.01.2020","Yes","Cagliari","Milan",0,2,6,8,2,4,14,13,3,1,0,0,3.09,3.46,2.28,1.85,1.96,0,3,0.3078508,0.2749303,0.4172189,1.198483,1.526587,-2,-2,-2,-3,-0.3281041,1,2,0,0
"2567","I1",10,"11.01.2020","Yes","Lazio","Napoli",1,0,7,11,6,7,9,7,2,2,0,0,2.07,3.79,3.3,1.55,2.44,3,0,0.4600987,0.251294,0.2886073,1.63159,1.117116,1,-4,-1,3,0.514474,2,0,0,0
"2568","I1",10,"11.01.2020","Yes","Inter","Atalanta",1,1,8,12,5,7,21,13,3,4,0,0,2.13,3.62,3.28,1.63,2.26,1,1,0.4468698,0.2629372,0.2901929,1.603547,1.133516,0,-4,-2,0,0.4700308,8,-1,0,0
"2569","I1",10,"12.01.2020","Yes","Udinese","Sassuolo",3,0,13,10,9,5,13,13,0,0,0,0,2.21,3.42,3.26,1.9,1.9,3,0,0.4302717,0.2780411,0.2916872,1.568856,1.153103,3,3,4,3,0.4157533,0,0,0,0
"2570","I1",10,"12.01.2020","Yes","Fiorentina","Spal",1,0,11,9,5,3,18,10,1,1,0,0,1.46,4.45,6.93,1.83,1.97,3,0,0.6498705,0.2132159,0.1369136,2.162827,0.6239566,1,2,2,3,1.538871,8,0,0,0
"2571","I1",10,"12.01.2020","Yes","Sampdoria","Brescia",5,1,22,9,11,5,14,7,2,3,0,0,1.99,3.35,3.98,2.05,1.77,3,0,0.4775481,0.2836778,0.2387741,1.716322,1,4,13,6,3,0.7163222,7,-1,0,0
"2572","I1",10,"12.01.2020","Yes","Torino","Bologna",1,0,4,10,3,7,16,14,6,3,0,0,2.27,3.41,3.16,1.86,1.94,3,0,0.4194554,0.2792269,0.3013177,1.537593,1.18318,1,-6,-4,3,0.3544133,2,3,0,0
"2573","I1",10,"12.01.2020","Yes","Verona","Genoa",2,1,11,3,9,3,14,22,3,6,0,0,2.19,3.32,3.39,2.05,1.76,3,0,0.433716,0.2860958,0.2801882,1.587244,1.12666,1,8,6,3,0.4605834,-8,-3,0,0
"2574","I1",10,"12.01.2020","Yes","Roma","Juventus",1,2,16,5,9,4,12,13,6,3,0,0,3.1,3.56,2.23,1.73,2.1,0,3,0.3066618,0.267037,0.4263012,1.187022,1.545941,-1,11,5,-3,-0.3589181,-1,3,0,0
"2575","I1",10,"13.01.2020","Yes","Parma","Lecce",2,0,9,11,5,6,19,10,4,2,0,0,1.88,3.81,3.88,1.68,2.18,3,0,0.5055677,0.2494665,0.2449658,1.76617,0.9843639,2,-2,-1,3,0.7818057,9,2,0,0
"2576","I1",10,"18.01.2020","Yes","Lazio","Sampdoria",5,1,16,6,12,4,12,13,1,2,0,1,1.39,4.78,7.95,1.57,2.38,3,0,0.6822968,0.1984085,0.1192947,2.245299,0.5562925,4,10,8,3,1.689007,-1,-1,-1,0
"2577","I1",10,"18.01.2020","Yes","Sassuolo","Torino",2,1,7,7,6,3,13,15,2,4,0,0,2.61,3.33,2.72,1.88,1.93,3,0,0.3645188,0.2857039,0.3497772,1.37926,1.335036,1,0,3,3,0.04422471,-2,-2,0,0
"2578","I1",10,"18.01.2020","Yes","Napoli","Fiorentina",0,2,10,9,5,5,7,10,2,2,0,0,1.62,4.09,5.33,1.67,2.2,0,3,0.5882256,0.2329891,0.1787853,1.997666,0.7693449,-2,1,0,-3,1.228321,-3,0,0,0
"2579","I1",10,"19.01.2020","Yes","Milan","Udinese",3,2,19,10,10,7,17,8,5,1,0,0,1.54,3.95,6.77,1.97,1.83,3,0,0.6182963,0.2410573,0.1406464,2.095946,0.6629966,1,9,3,3,1.43295,9,4,0,0
"2580","I1",10,"19.01.2020","Yes","Bologna","Verona",1,1,5,11,3,8,20,16,6,2,1,0,1.94,3.48,4.02,1.83,1.97,1,1,0.4901821,0.2732624,0.2365555,1.743809,0.982929,0,-6,-5,0,0.7608796,4,4,1,0
"2581","I1",10,"19.01.2020","Yes","Brescia","Cagliari",2,2,9,18,6,10,10,18,4,4,1,0,2.47,3.51,2.76,1.75,2.07,1,1,0.384818,0.2707978,0.3443842,1.425252,1.30395,0,-9,-4,0,0.1213013,-8,0,1,0
"2582","I1",10,"19.01.2020","Yes","Lecce","Inter",1,1,8,16,3,10,11,9,2,2,0,0,9.73,5.58,1.3,1.51,2.52,1,1,0.09776755,0.17048,0.7317525,0.4637826,2.365737,0,-8,-7,0,-1.901955,2,0,0,0
"2583","I1",10,"19.01.2020","Yes","Genoa","Roma",1,3,9,14,8,7,12,13,2,3,0,0,4.06,3.49,1.93,1.84,1.96,0,3,0.2343594,0.2726359,0.4930047,0.9757141,1.75165,-2,-5,1,-3,-0.775936,-1,-1,0,0
"2584","I1",10,"19.01.2020","Yes","Juventus","Parma",2,1,14,8,6,7,12,10,0,1,0,0,1.22,6.46,13.18,1.47,2.63,3,0,0.7803849,0.1473792,0.07223593,2.488534,0.364087,1,6,-1,3,2.124447,2,-1,0,0
"2585","I1",10,"20.01.2020","Yes","Atalanta","Spal",1,2,14,13,8,7,15,17,2,3,0,0,1.19,7.07,13.82,1.39,2.94,0,3,0.7971787,0.1341786,0.06864274,2.525715,0.3401068,-1,1,1,-3,2.185608,-2,-1,0,0
"2586","I1",10,"24.01.2020","Yes","Brescia","Milan",0,1,13,10,7,5,12,15,2,4,0,0,5.03,4.02,1.66,1.71,2.14,0,3,0.189345,0.2369168,0.5737382,0.8049518,1.958131,-1,3,2,-3,-1.15318,-3,-2,0,0
"2587","I1",10,"25.01.2020","Yes","Spal","Bologna",1,3,9,12,5,6,16,15,4,3,0,0,3,3.35,2.39,1.84,1.97,0,3,0.3173845,0.2842249,0.3983906,1.236378,1.479397,-2,-3,-1,-3,-0.2430183,1,1,0,0
"2588","I1",10,"25.01.2020","Yes","Fiorentina","Genoa",0,0,15,8,6,6,18,21,4,3,0,0,1.73,3.79,4.81,1.85,1.95,1,1,0.5506208,0.2513388,0.1980403,1.903201,0.8454598,0,7,0,0,1.057742,-3,1,0,0
"2589","I1",10,"25.01.2020","Yes","Torino","Atalanta",0,7,6,17,4,15,17,12,3,2,2,0,4.55,4.06,1.71,1.61,2.32,0,3,0.209139,0.2343799,0.556481,0.861797,1.903823,-7,-11,-11,-3,-1.042026,5,1,2,0
"2590","I1",10,"26.01.2020","Yes","Inter","Cagliari",1,1,14,8,5,3,10,10,4,1,2,0,1.32,5.25,9.56,1.56,2.41,1,1,0.7196813,0.1809484,0.09937023,2.339992,0.4790591,0,6,2,0,1.860933,0,3,2,0
"2591","I1",10,"26.01.2020","Yes","Parma","Udinese",2,0,10,15,5,5,12,9,2,3,0,0,2.38,3.19,3.15,2.12,1.72,3,0,0.3997382,0.2982373,0.3020244,1.497452,1.204311,2,-5,0,3,0.2931414,3,-1,0,0
"2592","I1",10,"26.01.2020","Yes","Sampdoria","Sassuolo",0,0,15,6,5,2,16,9,4,1,0,1,2.26,3.32,3.25,1.87,1.93,1,1,0.4208564,0.2864866,0.2926571,1.549056,1.164458,0,9,3,0,0.384598,7,3,-1,0
"2593","I1",10,"26.01.2020","Yes","Verona","Lecce",3,0,9,3,5,1,16,11,2,3,0,1,1.62,4.08,5.29,1.76,2.06,3,0,0.5870967,0.2331119,0.1797914,1.994402,0.7724862,3,6,4,3,1.221916,5,-1,-1,0
"2594","I1",10,"26.01.2020","Yes","Roma","Lazio",1,1,16,3,7,2,11,12,3,4,0,0,2.73,3.61,2.44,1.58,2.38,1,1,0.3478158,0.2630297,0.3891545,1.306477,1.430493,0,13,5,0,-0.1240163,-1,-1,0,0
"2595","I1",10,"26.01.2020","Yes","Napoli","Juventus",2,1,11,7,4,5,14,14,2,5,0,0,3.44,3.61,2.07,1.64,2.25,3,0,0.2766447,0.2636171,0.4597381,1.093551,1.642831,1,4,-1,3,-0.5492801,0,-3,0,0
"2596","I1",10,"01.02.2020","Yes","Bologna","Brescia",2,1,17,3,7,1,17,14,3,2,0,0,1.69,4.01,4.79,1.7,2.15,3,0,0.5636137,0.237533,0.1988533,1.928374,0.8340928,1,14,6,3,1.094281,3,1,0,0
"2597","I1",10,"01.02.2020","Yes","Cagliari","Parma",2,2,21,17,11,5,12,15,3,2,0,0,1.91,3.7,3.91,1.82,1.99,1,1,0.4988259,0.257502,0.243672,1.75398,0.9885181,0,4,6,0,0.7654618,-3,1,0,0
"2598","I1",10,"01.02.2020","Yes","Sassuolo","Roma",4,2,16,19,9,9,6,19,1,7,0,1,4,3.93,1.83,1.56,2.4,3,0,0.2378911,0.2421283,0.5199806,0.9558017,1.80207,2,-3,0,3,-0.8462683,-13,-6,-1,0
"2599","I1",10,"02.02.2020","Yes","Juventus","Fiorentina",3,0,8,7,8,5,9,13,1,4,0,0,1.34,5.11,9.36,1.62,2.29,3,0,0.7115446,0.186589,0.1018664,2.321223,0.4921883,3,1,3,3,1.829034,-4,-3,0,0
"2600","I1",10,"02.02.2020","Yes","Atalanta","Genoa",2,2,17,9,10,5,19,19,2,6,0,1,1.24,6.15,11.58,1.45,2.68,1,1,0.7641129,0.154065,0.0818221,2.446404,0.3995313,0,8,5,0,2.046872,0,-4,-1,0
"2601","I1",10,"02.02.2020","Yes","Lazio","Spal",5,1,12,10,10,5,9,7,1,2,0,0,1.22,6.39,12.96,1.48,2.63,3,0,0.7781743,0.1485716,0.07325406,2.483095,0.3683338,4,2,5,3,2.114761,2,-1,0,0
"2602","I1",10,"02.02.2020","Yes","Milan","Verona",1,1,17,8,6,6,11,12,1,4,0,1,1.64,3.72,5.85,1.9,1.9,1,1,0.5809893,0.2561351,0.1628756,1.999103,0.744762,0,9,0,0,1.254341,-1,-3,-1,0
"2603","I1",10,"02.02.2020","Yes","Lecce","Torino",4,0,14,11,11,4,14,23,3,3,0,0,3.24,3.47,2.2,1.75,2.07,3,0,0.2935612,0.2741032,0.4323356,1.154787,1.57111,4,3,7,3,-0.4163231,-9,0,0,0
"2604","I1",10,"02.02.2020","Yes","Udinese","Inter",0,2,11,14,4,10,10,16,2,2,0,0,5.07,3.72,1.71,1.9,1.89,0,3,0.1876942,0.255809,0.5564968,0.8188916,1.925299,-2,-3,-6,-3,-1.106408,-6,0,0,0
"2605","I1",10,"03.02.2020","Yes","Sampdoria","Napoli",2,4,12,12,10,10,17,6,4,3,0,0,4.42,3.75,1.79,1.79,2.01,0,3,0.2151491,0.253589,0.5312619,0.8990362,1.847375,-2,0,0,-3,-0.9483386,11,1,0,0
"2606","I1",10,"05.02.2020","Yes","Lazio","Verona",0,0,12,12,6,6,12,15,3,2,0,0,1.38,4.93,8.3,1.56,2.39,1,1,0.691475,0.1935569,0.1149681,2.267982,0.5384613,0,0,0,0,1.729521,-3,1,0,0
"2607","I1",10,"07.02.2020","Yes","Roma","Bologna",2,3,14,12,10,8,11,16,2,4,1,0,1.63,4.19,5.02,1.54,2.46,0,3,0.583525,0.2270038,0.1894713,1.977579,0.7954175,-1,2,2,-3,1.182161,-5,-2,1,0
"2608","I1",10,"08.02.2020","Yes","Fiorentina","Atalanta",1,2,5,13,3,7,20,13,2,2,0,0,4.06,3.75,1.86,1.66,2.21,0,3,0.2344412,0.2538216,0.5117372,0.9571452,1.789033,-1,-8,-4,-3,-0.831888,7,0,0,0
"2609","I1",10,"08.02.2020","Yes","Torino","Sampdoria",1,3,2,8,2,6,16,19,3,5,1,0,2.21,3.23,3.44,2.08,1.74,0,3,0.4298021,0.2940751,0.2761228,1.583481,1.122444,-2,-6,-4,-3,0.4610377,-3,-2,1,0
"2610","I1",10,"08.02.2020","Yes","Verona","Juventus",2,1,9,10,5,5,11,18,2,3,0,0,7.08,4.01,1.51,1.89,1.9,3,0,0.1341503,0.2368538,0.6289959,0.6393046,2.123842,1,-1,0,3,-1.484537,-7,-1,0,0
"2611","I1",10,"09.02.2020","Yes","Spal","Sassuolo",1,2,10,16,5,9,16,16,2,4,0,0,2.74,3.41,2.54,1.83,1.97,0,3,0.3469501,0.278781,0.374269,1.319631,1.401588,-1,-6,-4,-3,-0.08195671,0,-2,0,0
"2612","I1",10,"09.02.2020","Yes","Brescia","Udinese",1,1,9,16,7,8,8,17,0,3,0,0,2.7,3.29,2.65,1.9,1.89,1,1,0.3521701,0.289015,0.3588149,1.345525,1.36546,0,-7,-1,0,-0.01993416,-9,-3,0,0
"2613","I1",10,"09.02.2020","Yes","Genoa","Cagliari",1,0,8,8,5,6,15,15,3,6,0,0,2.38,3.4,2.96,1.9,1.9,3,0,0.3993524,0.2795467,0.3211009,1.477604,1.242849,1,0,-1,3,0.2347545,0,-3,0,0
"2614","I1",10,"09.02.2020","Yes","Napoli","Lecce",2,3,19,13,9,10,14,10,5,3,0,0,1.21,6.67,13.34,1.38,3,0,3,0.7860931,0.1426046,0.0713023,2.500884,0.3565115,-1,6,-1,-3,2.144372,4,2,0,0
"2615","I1",10,"09.02.2020","Yes","Parma","Lazio",0,1,16,17,6,6,13,10,4,3,0,0,4.51,3.94,1.74,1.64,2.24,0,3,0.2111208,0.2416637,0.5472155,0.8750262,1.88331,-1,-1,0,-3,-1.008284,3,1,0,0
"2616","I1",10,"09.02.2020","Yes","Inter","Milan",4,2,14,8,11,5,6,13,4,2,0,0,1.95,3.42,4.05,1.96,1.83,3,0,0.4874109,0.2779097,0.2346793,1.740143,0.9819477,2,6,6,3,0.7581948,-7,2,0,0
"2617","I1",10,"15.02.2020","Yes","Lecce","Spal",2,1,8,13,4,5,13,23,5,3,0,0,2.19,3.52,3.22,1.76,2.06,3,0,0.4343514,0.2702357,0.2954129,1.57329,1.156474,1,-5,-1,3,0.4168155,-10,2,0,0
"2618","I1",10,"15.02.2020","Yes","Bologna","Genoa",0,3,11,5,6,5,19,13,3,5,2,0,1.84,3.62,4.34,1.79,2.02,0,3,0.5175313,0.2630546,0.2194142,1.815648,0.9212971,-3,6,1,-3,0.8943513,6,-2,2,0
"2619","I1",10,"15.02.2020","Yes","Atalanta","Roma",2,1,11,5,7,1,11,15,1,5,0,0,1.8,4.22,3.88,1.41,2.89,3,0,0.5289724,0.225628,0.2453996,1.812545,0.9618267,1,6,6,3,0.8507185,-4,-4,0,0
"2620","I1",10,"16.02.2020","Yes","Udinese","Verona",0,0,10,9,6,6,13,17,1,2,0,0,2.56,3.21,2.85,2.18,1.68,1,1,0.3709538,0.2958386,0.3332076,1.4087,1.295461,0,1,0,0,0.1132385,-4,-1,0,0
"2621","I1",10,"16.02.2020","Yes","Juventus","Brescia",2,0,20,5,11,2,12,8,3,2,0,1,1.18,7.26,15.95,1.44,2.75,3,0,0.8087241,0.1314455,0.05983037,2.557618,0.3109366,2,15,9,3,2.246681,4,1,-1,0
"2622","I1",10,"16.02.2020","Yes","Sampdoria","Fiorentina",1,5,13,12,8,9,13,13,5,4,1,1,2.77,3.11,2.7,2.12,1.72,0,3,0.3428648,0.3053812,0.3517539,1.333976,1.360643,-4,1,-1,-3,-0.02666727,0,1,0,0
"2623","I1",10,"16.02.2020","Yes","Sassuolo","Parma",0,1,10,6,5,6,14,19,5,4,0,0,2.01,3.53,3.69,1.75,2.08,0,3,0.4730099,0.2693343,0.2576558,1.688364,1.042302,-1,4,-1,-3,0.6460623,-5,1,0,0
"2624","I1",10,"16.02.2020","Yes","Cagliari","Napoli",0,1,10,12,4,4,14,11,3,1,0,0,3.87,3.75,1.9,1.61,2.29,0,3,0.2457702,0.2536348,0.500595,0.9909453,1.75542,-1,-2,0,-3,-0.7644746,3,2,0,0
"2625","I1",10,"16.02.2020","Yes","Lazio","Inter",2,1,11,9,6,6,13,15,5,2,0,0,2.35,3.49,2.94,1.73,2.1,3,0,0.4044208,0.2723177,0.3232615,1.48558,1.242102,1,2,0,3,0.2434778,-2,3,0,0
"2626","I1",10,"17.02.2020","Yes","Milan","Torino",1,0,9,6,3,1,16,11,3,3,0,0,1.61,3.94,5.57,1.79,2.02,3,0,0.5890399,0.240699,0.1702611,2.007819,0.7514823,1,3,2,3,1.256336,5,0,0,0
"2627","I1",10,"21.02.2020","Yes","Brescia","Napoli",1,2,8,7,1,5,16,14,3,3,0,0,6.06,4.35,1.53,1.66,2.22,0,3,0.157384,0.2192521,0.6233639,0.691404,2.089344,-1,1,-4,-3,-1.39794,2,0,0,0
"2628","I1",10,"22.02.2020","Yes","Bologna","Udinese",1,1,12,4,3,3,13,12,1,2,0,0,2.06,3.42,3.66,1.84,1.97,1,1,0.4618552,0.2781935,0.2599513,1.663759,1.058047,0,8,0,0,0.6057118,1,-1,0,0
"2629","I1",10,"22.02.2020","Yes","Spal","Juventus",1,2,10,17,5,9,25,15,4,2,0,0,7.78,4.94,1.39,1.64,2.25,0,3,0.1223687,0.1927184,0.6849129,0.5598246,2.247457,-1,-7,-4,-3,-1.687632,10,2,0,0
"2630","I1",10,"22.02.2020","Yes","Fiorentina","Milan",1,1,11,5,7,3,11,15,1,3,1,0,2.68,3.31,2.66,1.94,1.86,1,1,0.3549641,0.2874029,0.357633,1.352295,1.360302,0,6,4,0,-0.008006709,-4,-2,1,0
"2631","I1",10,"23.02.2020","Yes","Genoa","Lazio",2,3,11,11,9,8,12,13,2,2,0,0,4.89,3.83,1.71,1.76,2.05,0,3,0.1946885,0.2485709,0.5567407,0.8326362,1.918793,-1,0,1,-3,-1.086157,-1,0,0,0
"2632","I1",10,"23.02.2020","Yes","Roma","Lecce",4,0,19,9,11,4,9,6,1,0,0,0,1.31,5.74,8.54,1.36,3.1,3,0,0.7237887,0.1651852,0.1110261,2.336551,0.4982636,4,10,7,3,1.838288,3,1,0,0
"2633","I1",10,"29.02.2020","Yes","Lazio","Bologna",2,0,12,11,5,4,9,12,1,4,0,0,1.54,4.26,5.98,1.59,2.35,3,0,0.6176548,0.2232836,0.1590616,2.076248,0.7004684,2,1,1,3,1.375779,-3,-3,0,0
"2634","I1",10,"29.02.2020","Yes","Napoli","Torino",2,1,16,5,10,3,12,13,1,3,0,0,1.47,4.42,6.85,1.71,2.13,3,0,0.6463382,0.2149586,0.1387032,2.153973,0.6310683,1,11,7,3,1.522905,-1,-2,0,0
"2635","I1",10,"01.03.2020","Yes","Lecce","Atalanta",2,7,5,17,3,11,9,12,2,2,0,0,7.67,5.34,1.36,1.37,3.04,0,3,0.1238231,0.1778508,0.698326,0.5493202,2.272829,-5,-12,-8,-3,-1.723509,-3,0,0,0
"2636","I1",10,"01.03.2020","Yes","Cagliari","Roma",3,4,7,18,7,14,14,13,4,5,0,0,3.63,3.61,2,1.72,2.11,0,3,0.2617431,0.2631932,0.4750637,1.048422,1.688384,-1,-11,-7,-3,-0.6399619,1,-1,0,0
"2637","I1",10,"08.03.2020","No","Parma","Spal",0,1,11,6,2,2,19,22,2,2,0,0,2.05,3.4,3.74,1.99,1.8,0,3,0.464885,0.2802983,0.2548167,1.674953,1.044748,-1,5,0,-3,0.6302051,-3,0,0,0
"2638","I1",10,"08.03.2020","No","Milan","Genoa",1,2,13,6,4,3,14,12,0,0,0,1,1.68,3.83,5.17,1.88,1.91,0,3,0.5670239,0.2487207,0.1842554,1.949793,0.8014868,-1,7,1,-3,1.148306,2,0,-1,0
"2639","I1",10,"08.03.2020","No","Sampdoria","Verona",2,1,8,3,7,2,14,23,4,3,0,0,2.67,3.18,2.77,2.19,1.67,3,0,0.3566942,0.2994886,0.3438172,1.369571,1.33094,1,5,5,3,0.03863115,-9,1,0,0
"2640","I1",10,"08.03.2020","No","Udinese","Fiorentina",0,0,11,7,2,5,8,5,2,0,0,0,2.91,3.14,2.56,2.25,1.63,1,1,0.3264272,0.3025169,0.3710559,1.281798,1.415685,0,4,-3,0,-0.1338862,3,2,0,0
"2641","I1",10,"08.03.2020","No","Juventus","Inter",2,0,12,8,6,2,8,18,1,3,0,1,2.27,3.28,3.26,2.01,1.79,3,0,0.4186917,0.2897653,0.291543,1.54584,1.164394,2,4,4,3,0.3814461,-10,-2,-1,0
"2642","I1",10,"09.03.2020","No","Sassuolo","Brescia",3,0,13,6,10,4,15,9,3,3,0,0,1.78,3.82,4.39,1.65,2.21,3,0,0.5343492,0.2489899,0.2166609,1.852037,0.8989727,3,7,6,3,0.9530647,6,0,0,0
"2643","I1",10,"20.06.2020","No","Torino","Parma",1,1,14,6,9,5,16,17,1,2,0,0,2.19,3.27,3.47,2.05,1.78,1,1,0.4346222,0.2910773,0.2743005,1.594944,1.113979,0,8,4,0,0.4809652,-1,-1,0,0
"2644","I1",10,"20.06.2020","No","Verona","Cagliari",2,1,8,13,6,4,4,19,1,6,1,1,2.03,3.37,3.83,2.06,1.77,3,0,0.4689552,0.2824863,0.2485585,1.689352,1.028162,1,-5,2,3,0.6611901,-15,-5,0,0
"2645","I1",10,"21.06.2020","No","Atalanta","Sassuolo",4,1,12,10,5,6,24,6,4,3,0,0,1.35,5.4,8.17,1.4,2.9,3,0,0.7065946,0.1766486,0.1167568,2.296432,0.5269189,3,2,-1,3,1.769514,18,1,0,0
"2646","I1",10,"21.06.2020","No","Inter","Sampdoria",2,1,11,7,5,3,17,21,3,3,0,0,1.36,5.03,8.78,1.66,2.22,3,0,0.7016189,0.1897021,0.108679,2.294559,0.5157391,1,4,2,3,1.77882,-4,0,0,0
"2647","I1",10,"22.06.2020","No","Fiorentina","Brescia",1,1,15,5,8,3,21,21,5,4,1,0,1.52,4.3,6.31,1.82,1.98,1,1,0.6272047,0.2217096,0.1510858,2.103324,0.6749668,0,10,5,0,1.428357,0,1,1,0
"2648","I1",10,"22.06.2020","No","Lecce","Milan",1,4,6,12,1,11,8,13,1,1,0,0,5.33,4.14,1.61,1.68,2.18,0,3,0.1786353,0.2299821,0.5913826,0.7658879,2.00413,-3,-6,-10,-3,-1.238242,-5,0,0,0
"2649","I1",10,"22.06.2020","No","Bologna","Juventus",0,2,6,12,1,5,16,16,1,4,0,1,5.72,4.16,1.57,1.7,2.15,0,3,0.1661595,0.2284694,0.6053711,0.726948,2.044583,-2,-6,-4,-3,-1.317635,0,-3,-1,0
"2650","I1",10,"23.06.2020","No","Spal","Cagliari",0,1,6,9,2,4,21,12,3,3,0,0,2.72,3.24,2.7,2.07,1.77,0,3,0.3512576,0.2948829,0.3538595,1.348656,1.356461,-1,-3,-2,-3,-0.007805724,9,0,0,0
"2651","I1",10,"23.06.2020","No","Verona","Napoli",0,2,10,10,6,8,16,7,1,1,0,0,4.2,3.45,1.93,2.03,1.8,0,3,0.227606,0.2770856,0.4953084,0.9599036,1.763011,-2,0,-2,-3,-0.8031072,9,0,0,0
"2652","I1",10,"23.06.2020","No","Genoa","Parma",1,4,9,11,3,8,15,15,1,2,0,0,2.21,3.29,3.45,2.07,1.77,0,3,0.4324675,0.2905025,0.2770299,1.587905,1.121592,-3,-2,-5,-3,0.4663128,0,-1,0,0
"2653","I1",10,"23.06.2020","No","Torino","Udinese",1,0,4,7,3,5,11,11,0,0,0,0,2.5,3.1,3.09,2.26,1.65,3,0,0.3823342,0.308334,0.3093318,1.455336,1.23633,1,-3,-2,3,0.2190069,0,0,0,0
"2654","I1",10,"24.06.2020","No","Inter","Sassuolo",3,3,14,8,10,4,18,20,3,1,1,0,1.38,5,7.84,1.56,2.42,1,1,0.6886956,0.19008,0.1212245,2.256167,0.5537534,0,6,6,0,1.702413,-2,2,1,0
"2655","I1",10,"24.06.2020","No","Atalanta","Lazio",3,2,13,5,9,3,13,15,2,2,0,0,2.12,3.73,3.23,1.55,2.44,3,0,0.4494965,0.2554779,0.2950256,1.603967,1.140555,1,8,6,3,0.4634128,-2,0,0,0
"2656","I1",10,"24.06.2020","No","Roma","Sampdoria",2,1,16,13,10,9,10,14,0,0,0,0,1.47,4.56,6.64,1.64,2.27,3,0,0.6477716,0.2088211,0.1434073,2.152136,0.6390429,1,3,1,3,1.513093,-4,0,0,0
"2657","I1",10,"26.06.2020","No","Juventus","Lecce",4,0,23,7,12,2,15,7,1,0,0,1,1.15,8.49,18.05,1.38,3.05,3,0,0.8339133,0.1129565,0.05313021,2.614696,0.2723471,4,16,10,3,2.342349,8,1,-1,0
"2658","I1",10,"27.06.2020","No","Brescia","Genoa",2,2,6,11,4,8,16,16,4,2,0,0,3,3.42,2.35,1.86,1.95,1,1,0.3170789,0.2781394,0.4047816,1.229376,1.492484,0,-5,-4,0,-0.2631081,0,2,0,0
"2659","I1",10,"27.06.2020","No","Cagliari","Torino",4,2,9,11,5,6,15,12,3,0,0,0,2.41,3.26,3.05,2.03,1.79,3,0,0.3953463,0.2922652,0.3123884,1.478304,1.22943,2,-2,-1,3,0.2488738,3,3,0,0
"2660","I1",10,"27.06.2020","No","Lazio","Fiorentina",2,1,12,9,4,5,13,13,5,2,0,1,1.62,4.06,5.42,1.64,2.26,3,0,0.5889601,0.2350038,0.1760361,2.001884,0.763112,1,3,-1,3,1.238772,0,3,-1,0
"2661","I1",10,"28.06.2020","No","Milan","Roma",2,0,11,3,7,2,10,16,2,2,0,0,2.71,3.42,2.56,1.79,2.03,3,0,0.3507552,0.2779376,0.3713072,1.330203,1.391859,2,8,5,3,-0.06165618,-6,0,0,0
"2662","I1",10,"28.06.2020","No","Napoli","Spal",3,1,17,5,11,3,14,14,0,3,0,0,1.28,5.64,10.67,1.64,2.26,3,0,0.7424385,0.1684967,0.08906479,2.395812,0.4356911,2,12,8,3,1.960121,0,-3,0,0
"2663","I1",10,"28.06.2020","No","Sampdoria","Bologna",1,2,13,9,7,4,17,15,3,1,0,0,2.38,3.33,3.04,1.89,1.92,0,3,0.4003829,0.2861595,0.3134576,1.487308,1.226532,-1,4,3,-3,0.2607757,2,2,0,0
"2664","I1",10,"28.06.2020","No","Sassuolo","Verona",3,3,13,6,9,4,17,13,2,2,0,0,2.53,3.36,2.8,1.87,1.94,1,1,0.3764284,0.2834416,0.34013,1.412727,1.303832,0,7,5,0,0.1088954,4,0,0,0
"2665","I1",10,"28.06.2020","No","Udinese","Atalanta",2,3,9,13,4,13,14,9,2,2,0,0,6.78,4.57,1.46,1.65,2.25,0,3,0.1403031,0.2081521,0.6515447,0.6290616,2.162786,-1,-4,-9,-3,-1.533725,5,0,0,0
"2666","I1",10,"28.06.2020","No","Parma","Inter",1,2,9,14,2,6,9,13,3,4,1,1,6.07,3.88,1.6,1.86,1.94,0,3,0.1572776,0.2460503,0.596672,0.7178832,2.036066,-1,-5,-4,-3,-1.318183,-4,-1,0,0
"2667","I1",10,"30.06.2020","No","Torino","Lazio",1,2,2,12,1,6,15,16,1,3,0,0,4.54,3.73,1.79,1.79,2.04,0,3,0.2103726,0.2560567,0.5335707,0.8871745,1.856769,-1,-10,-5,-3,-0.9695943,-1,-2,0,0
"2668","I1",10,"30.06.2020","No","Genoa","Juventus",1,3,2,11,2,9,21,10,5,1,0,0,9.31,4.7,1.38,1.8,2.03,0,3,0.1028042,0.2036398,0.693556,0.5120525,2.284308,-2,-9,-7,-3,-1.772255,11,4,0,0
"2669","I1",10,"01.07.2020","No","Bologna","Cagliari",1,1,16,6,7,4,20,17,3,2,0,0,2.07,3.51,3.54,1.86,1.95,1,1,0.4598781,0.2712102,0.2689118,1.650844,1.077945,0,10,3,0,0.572899,3,1,0,0
"2670","I1",10,"01.07.2020","No","Inter","Brescia",6,0,20,3,12,1,13,10,2,2,0,0,1.17,7.35,16.98,1.48,2.63,3,0,0.8142737,0.1296191,0.0561072,2.57244,0.2979407,6,17,11,3,2.2745,3,0,0,0
"2671","I1",10,"01.07.2020","No","Fiorentina","Sassuolo",1,3,11,8,7,8,20,12,4,2,0,0,2.05,3.6,3.51,1.72,2.14,0,3,0.4643625,0.2644286,0.2712089,1.657516,1.078055,-2,3,-1,-3,0.5794609,8,2,0,0
"2672","I1",10,"01.07.2020","No","Lecce","Sampdoria",1,2,12,8,6,5,13,14,2,3,0,0,3.44,3.54,2.1,1.72,2.13,0,3,0.2770201,0.2691947,0.4537853,1.100255,1.63055,-1,4,1,-3,-0.5302956,-1,-1,0,0
"2673","I1",10,"01.07.2020","No","Spal","Milan",2,2,4,25,3,12,9,12,3,0,1,0,5.79,4,1.6,1.84,1.97,1,1,0.1648465,0.2386153,0.5965382,0.7331547,2.02823,0,-21,-9,0,-1.295075,-3,3,1,0
"2674","I1",10,"01.07.2020","No","Verona","Parma",3,2,6,13,5,5,14,10,2,3,0,0,1.99,3.33,4.07,2.1,1.74,3,0,0.4792621,0.2864059,0.2343321,1.724192,0.9894021,1,-7,0,3,0.73479,4,-1,0,0
"2675","I1",10,"02.07.2020","No","Atalanta","Napoli",2,0,6,15,4,8,17,14,1,1,0,0,2.11,3.65,3.31,1.56,2.39,3,0,0.4513563,0.2609211,0.2877226,1.61499,1.124089,2,-9,-4,3,0.4909011,3,0,0,0
"2676","I1",10,"02.07.2020","No","Roma","Udinese",0,2,9,8,6,3,10,11,3,2,1,0,1.59,4.02,5.84,1.83,1.98,0,3,0.5995985,0.2371546,0.1632469,2.03595,0.7268952,-2,1,3,-3,1.309055,-1,1,1,0
"2677","I1",10,"04.07.2020","No","Juventus","Torino",4,1,15,12,7,6,11,8,4,2,0,0,1.26,5.78,11.65,1.71,2.15,3,0,0.7540639,0.1643807,0.08155541,2.426572,0.4090469,3,3,1,3,2.017525,3,2,0,0
"2678","I1",10,"04.07.2020","No","Sassuolo","Lecce",4,2,7,5,7,3,15,21,3,4,0,0,1.5,4.61,5.97,1.49,2.6,3,0,0.6342619,0.2063759,0.1593623,2.109161,0.6844627,2,2,4,3,1.424699,-6,-1,0,0
"2679","I1",10,"04.07.2020","No","Lazio","Milan",0,3,8,7,2,5,14,12,1,1,0,0,2.35,3.3,3.13,1.98,1.83,0,3,0.4060221,0.289137,0.3048409,1.507203,1.20366,-3,1,-3,-3,0.3035437,2,0,0,0
"2680","I1",10,"05.07.2020","No","Inter","Bologna",1,2,15,11,9,8,16,12,3,3,1,1,1.48,4.45,6.8,1.65,2.24,0,3,0.645065,0.2145385,0.1403965,2.149734,0.635728,-1,4,1,-3,1.514006,4,0,0,0
"2681","I1",10,"05.07.2020","No","Brescia","Verona",2,0,7,14,6,9,11,13,3,1,0,0,5.34,3.96,1.64,1.88,1.93,3,0,0.1784254,0.240604,0.5809706,0.7758803,1.983516,2,-7,-3,3,-1.207636,-2,2,0,0
"2682","I1",10,"05.07.2020","No","Cagliari","Atalanta",0,1,6,22,1,12,15,14,3,2,1,0,5.49,4.55,1.54,1.47,2.66,0,3,0.1732643,0.2090596,0.6176761,0.7288526,2.062088,-1,-16,-11,-3,-1.333235,1,1,1,0
"2683","I1",10,"05.07.2020","No","Parma","Fiorentina",1,2,7,9,2,6,17,14,4,6,0,0,3,3.38,2.38,1.86,1.95,0,3,0.3176541,0.2819415,0.4004044,1.234904,1.483155,-1,-2,-4,-3,-0.2482507,3,-2,0,0
"2684","I1",10,"05.07.2020","No","Sampdoria","Spal",3,0,9,8,5,3,18,12,1,1,0,0,1.91,3.54,4.11,1.92,1.88,3,0,0.4989352,0.2691995,0.2318653,1.766005,0.9647953,3,1,2,3,0.8012098,6,0,0,0
"2685","I1",10,"05.07.2020","No","Udinese","Genoa",2,2,9,6,6,4,13,14,3,2,0,0,2.26,3.25,3.32,2.1,1.74,1,1,0.4208564,0.2926571,0.2864866,1.555226,1.152117,0,3,2,0,0.4031094,-1,1,0,0
"2686","I1",10,"05.07.2020","No","Napoli","Roma",2,1,18,5,12,4,10,16,2,4,0,0,2.08,3.59,3.43,1.71,2.14,3,0,0.4574982,0.2650686,0.2774333,1.637563,1.097368,1,13,8,3,0.5401946,-6,-2,0,0
"2687","I1",10,"07.07.2020","No","Lecce","Lazio",2,1,7,14,3,10,8,11,3,3,0,1,7.64,5.36,1.37,1.39,3.01,3,0,0.1249685,0.1781268,0.6969047,0.5530323,2.268841,1,-7,-7,3,-1.715809,-3,0,-1,0
"2688","I1",10,"07.07.2020","No","Milan","Juventus",4,2,9,9,9,4,14,16,4,1,0,0,3.39,3.35,2.21,1.92,1.89,3,0,0.2820177,0.2853851,0.4325973,1.131438,1.583177,2,0,5,3,-0.4517387,-2,3,0,0
"2689","I1",10,"08.07.2020","No","Fiorentina","Cagliari",0,0,11,11,7,7,11,10,2,2,0,0,1.94,3.53,4.02,1.81,2.01,1,1,0.4920867,0.2704386,0.2374747,1.746699,0.9828627,0,0,0,0,0.7638361,1,0,0,0
"2690","I1",10,"08.07.2020","No","Genoa","Napoli",1,2,7,16,3,11,13,6,1,0,0,0,6.15,4.01,1.57,1.8,2.02,0,3,0.155018,0.2377458,0.6072362,0.7027999,2.059454,-1,-9,-8,-3,-1.356654,7,1,0,0
"2691","I1",10,"08.07.2020","No","Atalanta","Sampdoria",2,0,11,9,6,3,12,19,2,3,0,0,1.36,5.44,7.83,1.39,2.97,3,0,0.7023996,0.1755999,0.1220004,2.282799,0.5416013,2,2,3,3,1.741198,-7,-1,0,0
"2692","I1",10,"08.07.2020","No","Bologna","Sassuolo",1,2,8,11,6,5,17,16,3,4,0,0,2.26,3.58,3.04,1.56,2.43,0,3,0.4211048,0.2658371,0.3130581,1.529151,1.205012,-1,-3,1,-3,0.3241399,1,-1,0,0
"2693","I1",10,"08.07.2020","No","Roma","Parma",2,1,15,4,7,2,17,10,5,1,0,0,1.51,4.38,6.29,1.64,2.27,3,0,0.6309895,0.2175329,0.1514776,2.110501,0.6719657,1,11,5,3,1.438536,7,4,0,0
"2694","I1",10,"08.07.2020","No","Torino","Brescia",3,1,14,13,10,6,24,19,1,3,0,0,1.62,3.9,5.69,1.85,1.96,3,0,0.5882026,0.2443303,0.1674672,2.008938,0.7467318,2,1,4,3,1.262206,5,-2,0,0
"2695","I1",10,"09.07.2020","No","Spal","Udinese",0,3,11,7,3,4,11,9,0,0,0,0,3.31,3.37,2.21,2.06,1.77,0,3,0.2873618,0.2822456,0.4303926,1.144331,1.573423,-3,4,-1,-3,-0.4290923,2,0,0,0
"2696","I1",10,"09.07.2020","No","Verona","Inter",2,2,10,13,4,7,19,11,3,2,0,0,4.59,3.79,1.76,1.81,2,1,1,0.2075104,0.251312,0.5411776,0.8738431,1.874845,0,-3,-3,0,-1.001002,8,1,0,0
"2697","I1",10,"11.07.2020","No","Lazio","Sassuolo",1,2,7,11,1,4,13,7,4,2,0,0,1.61,4.3,5.17,1.41,2.88,0,3,0.5931794,0.2220974,0.1847232,2.001636,0.776267,-1,-4,-3,-3,1.225369,6,2,0,0
"2698","I1",10,"11.07.2020","No","Brescia","Roma",0,3,8,16,4,9,19,16,1,2,0,0,6.55,4.68,1.46,1.53,2.52,0,3,0.1452248,0.2032527,0.6515224,0.6389273,2.15782,-3,-8,-5,-3,-1.518893,3,-1,0,0
"2699","I1",10,"11.07.2020","No","Juventus","Atalanta",2,2,6,9,5,4,11,16,3,2,0,0,2.1,3.65,3.35,1.56,2.39,1,1,0.4540897,0.2612571,0.2846532,1.623526,1.115217,0,-3,1,0,0.5083093,-5,1,0,0
"2700","I1",10,"12.07.2020","No","Genoa","Spal",2,0,12,3,9,0,15,19,1,2,0,0,1.67,3.87,5.15,1.95,1.86,3,0,0.5695421,0.2457714,0.1846865,1.954398,0.7998308,2,9,9,3,1.154567,-4,-1,0,0
"2701","I1",10,"12.07.2020","No","Cagliari","Lecce",0,0,12,15,6,10,10,7,1,1,0,0,1.74,3.96,4.47,1.54,2.47,1,1,0.5468498,0.2402825,0.2128677,1.880832,0.8788856,0,-3,-4,0,1.001946,3,0,0,0
"2702","I1",10,"12.07.2020","No","Fiorentina","Verona",1,1,10,5,3,4,15,14,3,2,0,0,2.06,3.5,3.58,1.96,1.85,1,1,0.4621093,0.2719843,0.2659064,1.658312,1.069704,0,5,-1,0,0.5886084,1,1,0,0
"2703","I1",10,"12.07.2020","No","Parma","Bologna",2,2,13,9,5,6,17,24,1,1,0,0,2.69,3.32,2.65,1.9,1.91,1,1,0.3539403,0.2867769,0.3592828,1.348598,1.364625,0,4,-1,0,-0.01602748,-7,0,0,0
"2704","I1",10,"12.07.2020","No","Udinese","Sampdoria",1,3,7,9,4,6,16,10,1,4,0,0,2.39,3.09,3.25,2.19,1.68,0,3,0.3985894,0.3082941,0.2931165,1.504062,1.187644,-2,-2,-2,-3,0.3164187,6,-3,0,0
"2705","I1",10,"12.07.2020","No","Napoli","Milan",2,2,14,4,9,4,9,18,2,4,0,1,2.12,3.43,3.46,1.77,2.05,1,1,0.4482712,0.2770656,0.2746633,1.621879,1.101055,0,10,5,0,0.5208237,-9,-2,-1,0
"2706","I1",10,"13.07.2020","No","Inter","Torino",3,1,20,6,11,4,21,18,5,3,0,0,1.45,4.62,6.85,1.62,2.31,3,0,0.6555092,0.2057334,0.1387574,2.172261,0.6220057,2,14,7,3,1.550255,3,2,0,0
"2707","I1",10,"14.07.2020","No","Atalanta","Brescia",6,2,13,6,7,5,12,10,0,0,0,0,1.14,8.7,17.89,1.26,3.75,3,0,0.8369901,0.1096746,0.05333531,2.620645,0.2696805,4,7,2,3,2.350964,2,0,0,0
"2708","I1",10,"15.07.2020","No","Bologna","Napoli",1,1,11,9,2,4,20,9,1,1,0,0,4.3,3.89,1.79,1.65,2.26,1,1,0.2218459,0.2452281,0.5329259,0.9107659,1.844006,0,2,-2,0,-0.9332401,11,0,0,0
"2709","I1",10,"15.07.2020","No","Milan","Parma",3,1,21,9,7,5,9,10,1,2,0,0,1.44,4.66,7.06,1.6,2.35,3,0,0.6609478,0.2042414,0.1348109,2.187085,0.608674,2,12,2,3,1.578411,-1,-1,0,0
"2710","I1",10,"15.07.2020","No","Sampdoria","Cagliari",3,0,9,15,4,3,13,15,0,2,0,0,1.96,3.55,3.88,1.87,1.94,3,0,0.4860817,0.2683719,0.2455464,1.726617,1.005011,3,-6,1,3,0.7216058,-2,-2,0,0
"2711","I1",10,"15.07.2020","No","Lecce","Fiorentina",1,3,10,12,3,7,15,7,3,2,0,0,3.59,3.69,2,1.62,2.3,0,3,0.2653998,0.2582074,0.4763927,1.054407,1.687386,-2,-2,-4,-3,-0.6329786,8,1,0,0
"2712","I1",10,"15.07.2020","No","Roma","Verona",2,1,20,9,6,3,14,6,4,3,0,0,1.62,4.15,5.21,1.6,2.33,3,0,0.5877851,0.2294487,0.1827662,1.992804,0.7777473,1,11,3,3,1.215057,8,1,0,0
"2713","I1",10,"15.07.2020","No","Sassuolo","Juventus",3,3,16,13,12,6,14,13,4,4,0,0,5.13,4.2,1.62,1.51,2.53,1,1,0.1855943,0.2266902,0.5877154,0.7834733,1.989837,0,3,6,0,-1.206363,1,0,0,0
"2714","I1",10,"15.07.2020","No","Udinese","Lazio",0,0,15,15,7,3,12,11,2,3,0,0,3.66,3.51,2.03,1.84,1.97,1,1,0.2600313,0.2711438,0.4688249,1.051238,1.677619,0,0,4,0,-0.6263808,1,-1,0,0
"2715","I1",10,"16.07.2020","No","Torino","Genoa",3,0,8,10,4,4,20,18,2,2,0,0,2.17,3.36,3.4,1.9,1.91,3,0,0.4378152,0.2827557,0.2794291,1.596201,1.121043,3,-2,0,3,0.4751583,2,0,0,0
"2716","I1",10,"16.07.2020","No","Spal","Inter",0,4,8,13,1,8,10,9,2,3,0,0,8.98,5.37,1.33,1.55,2.46,0,3,0.1061106,0.1774437,0.7164457,0.4957754,2.326781,-4,-5,-7,-3,-1.831005,1,-1,0,0
"2717","I1",10,"18.07.2020","No","Verona","Atalanta",1,1,11,17,8,7,15,15,2,2,0,0,6.81,5.12,1.41,1.39,2.96,1,1,0.1396674,0.1857686,0.674564,0.6047709,2.209461,0,-6,1,0,-1.60469,0,0,0,0
"2718","I1",10,"18.07.2020","No","Cagliari","Sassuolo",1,1,2,5,1,2,14,15,4,2,1,0,3.17,3.75,2.13,1.51,2.54,1,1,0.2999763,0.25358,0.4464437,1.153509,1.592911,0,-3,-1,0,-0.439402,-1,2,1,0
"2719","I1",10,"18.07.2020","No","Milan","Bologna",5,1,17,8,14,3,19,14,2,1,0,0,1.53,4.44,5.9,1.52,2.53,3,0,0.6234738,0.2148457,0.1616805,2.085267,0.6998872,4,9,11,3,1.38538,5,1,0,0
"2720","I1",10,"19.07.2020","No","Parma","Sampdoria",2,3,13,12,7,5,13,11,0,1,0,0,3,2.93,2.63,2.01,1.8,0,3,0.3159982,0.3235476,0.3604542,1.271542,1.40491,-1,1,2,-3,-0.1333681,2,-1,0,0
"2721","I1",10,"19.07.2020","No","Brescia","Spal",2,1,15,13,6,7,10,14,2,2,0,0,2.33,3.5,2.96,1.79,2.02,3,0,0.4076846,0.2714015,0.3209139,1.494455,1.234143,1,2,-1,3,0.2603121,-4,0,0,0
"2722","I1",10,"19.07.2020","No","Fiorentina","Torino",2,0,12,5,4,1,7,11,1,2,0,0,1.98,3.39,4.01,1.81,2,3,0,0.4812698,0.2810957,0.2376345,1.724905,0.9939991,2,7,3,3,0.7309061,-4,-1,0,0
"2723","I1",10,"19.07.2020","No","Genoa","Lecce",2,1,8,17,5,2,12,10,2,3,0,0,1.9,3.78,3.85,1.61,2.31,3,0,0.5009639,0.2518072,0.2472289,1.754699,0.993494,1,-9,3,3,0.7612048,2,-1,0,0
"2724","I1",10,"19.07.2020","No","Napoli","Udinese",2,1,17,3,10,3,13,17,3,2,0,0,1.49,4.36,6.56,1.75,2.08,3,0,0.6373985,0.2178265,0.144775,2.130022,0.6521514,1,14,7,3,1.477871,-4,1,0,0
"2725","I1",10,"19.07.2020","No","Roma","Inter",2,2,6,4,3,3,18,13,1,1,0,0,3.01,3.61,2.26,1.57,2.4,1,1,0.3158905,0.263388,0.4207215,1.21106,1.525552,0,2,0,0,-0.3144928,5,0,0,0
"2726","I1",10,"20.07.2020","No","Juventus","Lazio",2,1,13,6,10,5,18,15,3,1,0,0,1.67,4.03,4.86,1.67,2.2,3,0,0.5688239,0.2357161,0.1954601,1.942188,0.8220962,1,7,5,3,1.120091,3,2,0,0
"2727","I1",10,"21.07.2020","No","Atalanta","Bologna",1,0,13,9,7,2,19,14,4,2,0,0,1.28,6.05,9.79,1.31,3.37,3,0,0.7449811,0.1576158,0.09740305,2.392559,0.449825,1,4,5,3,1.942734,5,2,0,0
"2728","I1",10,"21.07.2020","No","Sassuolo","Milan",1,2,6,12,3,8,12,24,3,4,1,0,3.44,3.87,1.99,1.44,2.73,0,3,0.2764315,0.2457169,0.4778515,1.075012,1.679271,-1,-6,-5,-3,-0.6042599,-12,-1,1,0
"2729","I1",10,"22.07.2020","No","Parma","Napoli",2,1,6,12,3,4,8,12,3,1,0,0,5.78,4.28,1.55,1.62,2.28,3,0,0.1644872,0.2221346,0.6133782,0.7155963,2.062269,1,-6,-1,3,-1.346673,-4,2,0,0
"2730","I1",10,"22.07.2020","No","Inter","Fiorentina",0,0,12,6,9,4,13,13,1,3,0,0,1.46,4.67,6.5,1.52,2.49,1,1,0.6505126,0.2033723,0.1461151,2.15491,0.6417177,0,6,5,0,1.513192,0,-2,0,0
"2731","I1",10,"22.07.2020","No","Lecce","Brescia",3,1,13,10,10,3,11,11,2,1,0,0,1.79,3.97,4.12,1.52,2.5,3,0,0.5304062,0.2391504,0.2304435,1.830369,0.9304807,2,3,7,3,0.8998881,0,1,0,0
"2732","I1",10,"22.07.2020","No","Sampdoria","Genoa",1,2,11,7,7,5,14,13,4,2,0,0,2.5,3.26,2.87,1.9,1.9,0,3,0.3790821,0.2907071,0.3302108,1.427953,1.28134,-1,4,2,-3,0.1466136,1,2,0,0
"2733","I1",10,"22.07.2020","No","Spal","Roma",1,6,9,13,4,9,10,11,1,0,0,0,8.15,5.29,1.35,1.43,2.76,0,3,0.1165816,0.1796107,0.7038077,0.5293556,2.291034,-5,-4,-5,-3,-1.761678,-1,1,0,0
"2734","I1",10,"22.07.2020","No","Torino","Verona",1,1,6,8,4,6,18,16,4,2,0,0,2.37,3.3,3.04,1.9,1.89,1,1,0.4003544,0.2875272,0.3121184,1.48859,1.223882,0,-2,-2,0,0.264708,2,2,0,0
"2735","I1",10,"23.07.2020","No","Udinese","Juventus",2,1,9,14,4,6,9,8,2,2,0,0,5.2,3.91,1.65,1.73,2.09,3,0,0.1824339,0.242623,0.5749431,0.7899246,1.967452,1,-5,-2,3,-1.177528,1,0,0,0
"2736","I1",10,"23.07.2020","No","Lazio","Cagliari",2,1,16,8,12,4,14,11,3,1,0,0,1.47,4.57,6.51,1.53,2.45,3,0,0.6462163,0.2078639,0.1459198,2.146513,0.6456233,1,8,8,3,1.500889,3,2,0,0
"2737","I1",10,"24.07.2020","No","Milan","Atalanta",1,1,6,9,3,4,17,12,1,1,0,0,2.86,3.81,2.3,1.48,2.65,1,1,0.3339863,0.2507089,0.4153048,1.252668,1.496623,0,-3,-1,0,-0.2439552,5,0,0,0
"2738","I1",10,"25.07.2020","No","Brescia","Parma",1,2,10,12,7,6,15,13,4,0,0,0,3.4,3.72,2.05,1.58,2.36,0,3,0.2799148,0.2558361,0.464249,1.095581,1.648583,-1,-2,1,-3,-0.5530025,2,4,0,0
"2739","I1",10,"25.07.2020","No","Genoa","Inter",0,3,7,8,2,4,12,15,2,3,0,0,5.07,4.16,1.63,1.56,2.42,0,3,0.1876461,0.2286937,0.5836601,0.7916322,1.979674,-3,-1,-2,-3,-1.188042,-3,-1,0,0
"2740","I1",10,"25.07.2020","No","Napoli","Sassuolo",2,0,16,4,9,1,4,10,1,3,0,0,1.57,4.43,5.33,1.49,2.58,3,0,0.6064425,0.2149243,0.1786332,2.034252,0.7508238,2,12,8,3,1.283428,-6,-2,0,0
"2741","I1",10,"26.07.2020","No","Bologna","Lecce",3,2,18,19,12,10,16,8,1,1,0,0,2.39,3.62,2.79,1.53,2.48,3,0,0.3973218,0.2623202,0.3403581,1.454285,1.283394,1,-1,2,3,0.1708911,8,0,0,0
"2742","I1",10,"26.07.2020","No","Cagliari","Udinese",0,1,14,10,8,6,10,17,2,1,0,0,3.66,3.44,2.04,1.88,1.91,0,3,0.2591969,0.2757734,0.4650297,1.053364,1.670863,-1,4,2,-3,-0.6174984,-7,1,0,0
"2743","I1",10,"26.07.2020","No","Roma","Fiorentina",2,1,12,4,7,2,13,14,1,4,0,0,1.62,4.26,4.98,1.51,2.54,3,0,0.5863098,0.2229629,0.1907273,1.981892,0.7951448,1,8,5,3,1.186748,-1,-3,0,0
"2744","I1",10,"26.07.2020","No","Spal","Torino",1,1,3,14,2,7,11,17,2,3,0,0,5.68,4.24,1.56,1.64,2.25,1,1,0.167206,0.2239929,0.6088012,0.7256107,2.050396,0,-11,-5,0,-1.324786,-6,-1,0,0
"2745","I1",10,"26.07.2020","No","Verona","Lazio",1,5,9,12,6,7,16,7,2,2,0,0,3.43,3.54,2.09,1.66,2.21,0,3,0.2770026,0.2683951,0.4546023,1.099403,1.632202,-4,-3,-1,-3,-0.5327992,9,0,0,0
"2746","I1",10,"26.07.2020","No","Juventus","Sampdoria",2,0,14,13,8,8,17,13,4,5,0,1,1.26,5.87,11.13,1.51,2.53,3,0,0.7530924,0.1616519,0.08525574,2.420929,0.4174191,2,1,0,3,2.00351,4,-1,-1,0
"2747","I1",10,"28.07.2020","No","Parma","Atalanta",1,2,8,11,6,5,17,16,2,1,0,0,7.88,5.43,1.35,1.38,2.98,0,3,0.120653,0.1750912,0.7042558,0.5370501,2.287859,-1,-3,1,-3,-1.750809,1,1,0,0
"2748","I1",10,"28.07.2020","No","Inter","Napoli",2,0,6,8,5,2,16,8,4,1,0,0,2.04,3.67,3.47,1.69,2.17,3,0,0.4664713,0.259292,0.2742367,1.658706,1.082002,2,-2,3,3,0.5767037,8,3,0,0
"2749","I1",10,"29.07.2020","No","Lazio","Brescia",2,0,25,8,15,3,11,10,1,2,0,0,1.18,7.47,14.04,1.33,3.27,3,0,0.805146,0.127185,0.06766897,2.542623,0.3301919,2,17,12,3,2.212431,1,-1,0,0
"2750","I1",10,"29.07.2020","No","Sampdoria","Milan",1,4,16,18,5,11,5,6,1,1,0,0,4.85,3.98,1.68,1.68,2.17,0,3,0.1958673,0.2386825,0.5654502,0.8262844,1.935033,-3,-2,-6,-3,-1.108749,-1,0,0,0
"2751","I1",10,"29.07.2020","No","Sassuolo","Genoa",5,0,15,10,9,3,11,6,1,1,0,0,2.35,3.54,2.9,1.6,2.33,3,0,0.4041732,0.2683071,0.3275197,1.480827,1.250866,5,5,6,3,0.2299606,5,0,0,0
"2752","I1",10,"29.07.2020","No","Udinese","Lecce",1,2,8,10,3,6,12,11,1,4,0,0,2.32,3.57,2.92,1.68,2.17,0,3,0.4091016,0.2658588,0.3250396,1.493164,1.240978,-1,-2,-3,-3,0.2521859,1,-3,0,0
"2753","I1",10,"29.07.2020","No","Verona","Spal",3,0,14,12,9,5,15,13,1,1,0,0,1.56,4.27,5.74,1.7,2.13,3,0,0.61083,0.2231604,0.1660096,2.055651,0.7211891,3,2,4,3,1.334461,2,0,0,0
"2754","I1",10,"29.07.2020","No","Cagliari","Juventus",2,0,9,20,5,10,13,12,2,1,0,0,6.08,4.25,1.53,1.63,2.25,3,0,0.1561416,0.2233743,0.6204841,0.691799,2.084827,2,-11,-5,3,-1.393028,1,1,0,0
"2755","I1",10,"29.07.2020","No","Fiorentina","Bologna",4,0,15,8,9,3,14,11,2,1,0,0,2.02,3.55,3.65,1.79,2.02,3,0,0.4711561,0.2680945,0.2607494,1.681563,1.050343,4,7,6,3,0.6312201,3,1,0,0
"2756","I1",10,"29.07.2020","No","Torino","Roma",2,3,5,12,5,7,8,18,2,3,0,0,4.6,3.98,1.71,1.6,2.33,0,3,0.2063627,0.2385096,0.5551277,0.8575977,1.903893,-1,-7,-2,-3,-1.046295,-10,-1,0,0
"2757","I1",10,"01.08.2020","No","Brescia","Sampdoria",1,1,11,11,6,5,9,17,1,4,0,1,6.4,4.75,1.46,1.36,3.08,1,1,0.1485679,0.2001757,0.6512565,0.6458793,2.153945,0,0,1,0,-1.508066,-8,-3,-1,0
"2758","I1",10,"01.08.2020","No","Atalanta","Inter",0,2,8,7,3,4,10,12,2,3,0,0,2.33,3.72,2.83,1.47,2.63,0,3,0.408219,0.2556855,0.3360955,1.480342,1.263972,-2,1,-1,-3,0.2163705,-2,-1,0,0
"2759","I1",10,"01.08.2020","No","Juventus","Roma",1,3,9,9,4,7,10,12,1,4,0,0,2.8,3.96,2.26,1.45,2.75,0,3,0.3394423,0.2400097,0.420548,1.258337,1.501654,-2,0,-3,-3,-0.243317,-2,-3,0,0
"2760","I1",10,"01.08.2020","No","Milan","Cagliari",3,0,12,4,7,3,16,7,1,3,0,0,1.33,5.71,8.06,1.32,3.34,3,0,0.7153398,0.1666203,0.1180399,2.31264,0.5207401,3,8,4,3,1.791899,9,-2,0,0
"2761","I1",10,"01.08.2020","No","Napoli","Lazio",3,1,11,8,6,4,10,11,3,2,0,0,2.84,3.78,2.3,1.48,2.65,3,0,0.3348844,0.2516062,0.4135094,1.256259,1.492134,2,3,2,3,-0.2358751,-1,1,0,0
"2762","I1",10,"02.08.2020","No","Spal","Fiorentina",1,3,7,20,5,11,6,14,1,1,0,0,6.27,4.85,1.46,1.39,2.96,0,3,0.1518072,0.1962538,0.651939,0.6516753,2.152071,-2,-13,-6,-3,-1.500396,-8,0,0,0
"2763","I1",10,"02.08.2020","No","Bologna","Torino",1,1,13,13,5,11,15,17,3,3,0,0,2.15,4.02,2.96,1.37,3.02,1,1,0.4422475,0.2365254,0.3212271,1.563268,1.200207,0,0,-6,0,0.3630613,-2,0,0,0
"2764","I1",10,"02.08.2020","No","Genoa","Verona",3,0,4,13,4,3,8,13,4,0,2,1,1.54,4.46,5.66,1.52,2.5,3,0,0.6182853,0.2134887,0.168226,2.068345,0.7181668,3,-9,1,3,1.350178,-5,4,1,0
"2765","I1",10,"02.08.2020","No","Lecce","Parma",3,4,12,18,8,11,3,7,0,2,0,0,1.53,4.64,5.48,1.37,3.03,0,3,0.6215278,0.2049434,0.1735288,2.069527,0.7255297,-1,-6,-3,-3,1.343997,-4,-2,0,0
"2766","I1",10,"02.08.2020","No","Sassuolo","Udinese",0,1,18,7,14,3,9,11,1,1,0,0,1.93,4.04,3.5,1.4,2.88,0,3,0.4928169,0.2354298,0.2717533,1.71388,1.05069,-1,11,11,-3,0.6631907,-2,0,0,0
"2767","I2",10,"23.08.2019","Yes","Pisa","Benevento",0,0,8,13,0,4,15,18,4,1,0,0,3.85,3.19,2.01,2.03,1.77,1,1,0.2425819,0.2927712,0.4646469,1.020517,1.686712,0,-5,-4,0,-0.666195,-3,3,0,0
"2768","I2",10,"24.08.2019","Yes","Crotone","Cosenza",0,0,15,7,3,5,13,19,1,3,0,1,2.03,3.09,3.91,2.21,1.64,1,1,0.4595294,0.3018915,0.2385792,1.68048,1.017629,0,8,-2,0,0.6628505,-6,-2,-1,0
"2769","I2",10,"24.08.2019","Yes","Salernitana","Pescara",3,1,20,10,11,2,11,12,2,2,0,0,2.39,3.09,3.03,2.13,1.7,3,0,0.3902832,0.3018696,0.3078472,1.472719,1.225411,2,10,9,3,0.2473082,-1,0,0,0
"2770","I2",10,"24.08.2019","Yes","Ascoli","Trapani",3,1,9,12,6,3,14,20,0,5,1,1,1.93,3.22,4.15,2.18,1.66,3,0,0.4843931,0.290335,0.225272,1.743514,0.9661508,2,-3,3,3,0.7773633,-6,-5,0,0
"2771","I2",10,"24.08.2019","Yes","Cittadella","Spezia",0,3,10,9,3,3,14,21,2,1,0,0,2.4,3.04,3.07,2.1,1.72,0,3,0.3889185,0.3070409,0.3040405,1.473797,1.219163,-3,1,0,-3,0.254634,-7,1,0,0
"2772","I2",10,"24.08.2019","Yes","Venezia","Cremonese",1,2,12,11,1,5,7,19,2,3,0,0,2.9,2.98,2.56,2.34,1.57,0,3,0.3219609,0.3133177,0.3647214,1.2792,1.407482,-1,1,-4,-3,-0.1282813,-12,-1,0,0
"2773","I2",10,"24.08.2019","Yes","Virtus Entella","Livorno",1,0,6,5,3,2,18,18,2,3,0,0,2.17,3.01,3.59,2.24,1.63,3,0,0.4300359,0.3100259,0.2599382,1.600134,1.08984,1,1,1,3,0.5102933,0,-1,0,0
"2774","I2",10,"25.08.2019","Yes","Empoli","Juve Stabia",2,1,15,4,4,3,14,11,1,1,0,0,1.55,3.73,6.24,1.91,1.88,3,0,0.6009807,0.2497373,0.1492821,2.052679,0.6975834,1,11,1,3,1.355096,3,0,0,0
"2775","I2",10,"25.08.2019","Yes","Perugia","Chievo",2,1,16,10,4,6,16,10,3,2,0,0,2.3,3.07,3.23,2.18,1.67,3,0,0.406296,0.3043911,0.2893129,1.523279,1.17233,1,6,-2,3,0.3509491,6,1,0,0
"2776","I2",10,"26.08.2019","Yes","Pordenone","Frosinone",3,0,18,16,5,5,14,24,1,3,0,0,3.54,3.1,2.14,2.07,1.73,3,0,0.2634254,0.3008148,0.4357598,1.091091,1.608094,3,2,0,3,-0.5170031,-10,-2,0,0
"2777","I2",10,"30.08.2019","Yes","Chievo","Empoli",1,1,14,13,5,6,12,15,0,0,0,0,2.55,3.06,2.85,2.1,1.72,1,1,0.3665595,0.3054662,0.3279743,1.405145,1.289389,0,1,-1,0,0.1157556,-3,0,0,0
"2778","I2",10,"31.08.2019","Yes","Benevento","Cittadella",4,1,17,9,7,7,16,15,1,1,0,0,1.82,3.25,4.68,2.11,1.71,3,0,0.5131129,0.2873432,0.1995439,1.826682,0.8859749,3,8,0,3,0.940707,1,0,0,0
"2779","I2",10,"31.08.2019","Yes","Spezia","Crotone",1,2,8,6,6,3,8,17,0,3,0,0,2.01,3.19,3.86,2.14,1.69,0,3,0.4649391,0.2929553,0.2421056,1.687773,1.019272,-1,2,3,-3,0.6685005,-9,-3,0,0
"2780","I2",10,"31.08.2019","Yes","Cosenza","Salernitana",0,1,8,6,3,3,20,16,3,4,0,0,2.35,2.95,3.27,2.23,1.63,0,3,0.3975725,0.3167103,0.2857172,1.509428,1.173862,-1,2,0,-3,0.3355658,4,-1,0,0
"2781","I2",10,"31.08.2019","Yes","Cremonese","Virtus Entella",0,1,15,11,5,4,10,8,1,2,0,0,1.77,3.3,5.03,2.1,1.71,0,3,0.5295902,0.2840529,0.1863568,1.872824,0.8431234,-1,4,1,-3,1.0297,2,-1,0,0
"2782","I2",10,"31.08.2019","Yes","Livorno","Perugia",0,1,12,6,3,1,17,13,1,4,0,1,2.95,2.97,2.53,2.21,1.64,0,3,0.3165284,0.3143969,0.3690746,1.263982,1.421621,-1,6,2,-3,-0.1576387,4,-3,-1,0
"2783","I2",10,"31.08.2019","Yes","Trapani","Venezia",0,1,11,13,4,4,19,16,2,2,0,0,2.31,2.98,3.31,2.26,1.61,0,3,0.4043585,0.3134457,0.2821958,1.526521,1.160033,-1,-2,0,-3,0.3664881,3,0,0,0
"2784","I2",10,"01.09.2019","Yes","Juve Stabia","Pisa",0,2,14,11,1,3,23,14,4,2,0,1,2.14,2.97,3.76,2.44,1.53,0,3,0.4367408,0.3146887,0.2485706,1.624911,1.0604,-2,3,-2,-3,0.5645107,9,2,-1,0
"2785","I2",10,"01.09.2019","Yes","Pescara","Pordenone",4,2,19,11,4,2,17,18,3,2,0,0,2.04,3.16,3.82,2.06,1.75,3,0,0.4587996,0.2961871,0.2450134,1.672586,1.031227,2,8,2,3,0.6413586,-1,1,0,0
"2786","I2",10,"01.09.2019","Yes","Frosinone","Ascoli",2,1,20,11,8,5,19,28,5,4,1,0,1.77,3.37,4.8,1.94,1.85,3,0,0.5279908,0.2773127,0.1946966,1.861285,0.8614024,1,9,3,3,0.9998825,-9,1,1,0
"2787","I2",10,"13.09.2019","Yes","Pordenone","Spezia",1,0,12,11,5,1,18,24,1,3,0,0,2.67,2.99,2.78,2.15,1.69,3,0,0.3504581,0.3129509,0.336591,1.364325,1.322724,1,1,4,3,0.04160114,-6,-2,0,0
"2788","I2",10,"14.09.2019","Yes","Ascoli","Livorno",2,0,11,9,4,4,16,19,4,3,0,0,2.15,3.02,3.67,2.31,1.59,3,0,0.4352081,0.3098335,0.2549584,1.615458,1.074709,2,2,0,3,0.540749,-3,1,0,0
"2789","I2",10,"14.09.2019","Yes","Cittadella","Trapani",2,0,13,8,6,4,24,16,3,3,0,0,1.82,3.29,4.63,2.07,1.74,3,0,0.5138007,0.2842302,0.2019692,1.825632,0.8901377,2,5,2,3,0.9354945,8,0,0,0
"2790","I2",10,"14.09.2019","Yes","Perugia","Juve Stabia",0,0,11,12,4,5,13,24,0,4,0,1,1.68,3.5,5.31,2.03,1.77,1,1,0.5566738,0.2672034,0.1761228,1.937225,0.7955718,0,-1,-1,0,1.141653,-11,-4,-1,0
"2791","I2",10,"14.09.2019","Yes","Virtus Entella","Frosinone",1,0,8,17,3,8,15,13,3,3,0,0,3.05,3.04,2.43,2.05,1.75,3,0,0.3068959,0.3079055,0.3851986,1.228593,1.463501,1,-9,-5,3,-0.234908,2,0,0,0
"2792","I2",10,"14.09.2019","Yes","Venezia","Chievo",0,2,5,8,2,4,13,16,2,3,1,0,2.73,2.95,2.74,2.29,1.6,0,3,0.3422578,0.3167335,0.3410087,1.343507,1.33976,-2,-3,-2,-3,0.003747348,-3,-1,1,0
"2793","I2",10,"15.09.2019","Yes","Cosenza","Pescara",1,2,13,6,5,1,15,14,1,2,0,0,2.39,2.98,3.17,2.24,1.63,0,3,0.3912429,0.3137821,0.294975,1.487511,1.198707,-1,7,4,-3,0.2888039,1,-1,0,0
"2794","I2",10,"15.09.2019","Yes","Crotone","Empoli",0,0,19,10,6,1,12,17,1,1,0,0,2.61,3.03,2.81,2.05,1.76,1,1,0.3583957,0.3087171,0.3328871,1.383904,1.307379,0,9,5,0,0.07652578,-5,0,0,0
"2795","I2",10,"15.09.2019","Yes","Pisa","Cremonese",4,1,15,21,8,5,9,15,2,3,0,0,2.79,2.92,2.7,2.44,1.53,3,0,0.334581,0.3196853,0.3457337,1.323428,1.356886,3,-6,3,3,-0.0334581,-6,-1,0,0
"2796","I2",10,"16.09.2019","Yes","Salernitana","Benevento",0,2,10,14,0,4,18,14,3,0,0,0,2.77,2.97,2.68,2.14,1.69,0,3,0.3371269,0.3144248,0.3484483,1.325805,1.35977,-2,-4,-4,-3,-0.03396428,4,3,0,0
"2797","I2",10,"20.09.2019","Yes","Frosinone","Venezia",1,1,10,10,4,4,17,24,2,4,0,0,1.64,3.55,5.62,2,1.8,1,1,0.5701947,0.2634139,0.1663913,1.973998,0.762588,0,0,0,0,1.21141,-7,-2,0,0
"2798","I2",10,"21.09.2019","Yes","Benevento","Cosenza",1,0,14,10,3,5,14,18,1,5,0,0,1.6,3.62,6.03,2.09,1.73,3,0,0.5857102,0.2588774,0.1554123,2.016008,0.7251144,1,4,-2,3,1.290894,-4,-4,0,0
"2799","I2",10,"21.09.2019","Yes","Cremonese","Crotone",2,1,15,18,7,6,15,17,2,2,0,0,2.2,3.09,3.42,2.23,1.63,3,0,0.4245836,0.3022925,0.2731239,1.576043,1.121664,1,-3,1,3,0.4543789,-2,0,0,0
"2800","I2",10,"21.09.2019","Yes","Empoli","Cittadella",1,0,10,16,3,2,17,21,1,4,0,0,1.72,3.43,5.11,1.98,1.82,3,0,0.5440541,0.2728201,0.1831258,1.904982,0.8221976,1,-6,1,3,1.082785,-4,-3,0,0
"2801","I2",10,"21.09.2019","Yes","Juve Stabia","Ascoli",1,5,20,19,9,9,18,12,4,3,1,0,2.31,3.05,3.24,2.17,1.67,0,3,0.4048026,0.3065882,0.2886092,1.520996,1.172416,-4,1,0,-3,0.34858,6,1,1,0
"2802","I2",10,"21.09.2019","Yes","Livorno","Pordenone",2,1,10,11,4,4,16,24,1,3,0,0,2.1,3.07,3.76,2.31,1.59,3,0,0.445921,0.3050274,0.2490516,1.64279,1.052182,1,-1,0,3,0.5906081,-8,-2,0,0
"2803","I2",10,"21.09.2019","Yes","Pescara","Virtus Entella",1,1,11,5,5,3,10,12,2,3,1,0,2.49,3.13,2.87,2.09,1.73,1,1,0.375499,0.2987196,0.3257814,1.425217,1.276064,0,6,2,0,0.1491529,-2,-1,1,0
"2804","I2",10,"21.09.2019","Yes","Spezia","Perugia",2,2,13,11,5,5,19,14,1,4,0,0,2.38,3.05,3.11,2.16,1.68,1,1,0.3928345,0.3065397,0.3006258,1.485043,1.208417,0,2,0,0,0.2766262,5,-3,0,0
"2805","I2",10,"21.09.2019","Yes","Chievo","Pisa",2,2,18,14,8,4,12,10,1,2,0,0,2.07,3.09,3.82,2.22,1.64,1,1,0.452123,0.3028785,0.2449986,1.659247,1.037874,0,4,4,0,0.6213732,2,-1,0,0
"2806","I2",10,"22.09.2019","Yes","Trapani","Salernitana",0,1,12,4,5,1,20,18,5,2,0,0,2.64,3.01,2.8,2.2,1.65,0,3,0.3546183,0.3110273,0.3343544,1.374882,1.31409,-1,8,4,-3,0.06079171,2,3,0,0
"2807","I2",10,"24.09.2019","Yes","Ascoli","Spezia",3,0,8,15,4,1,11,16,3,4,0,1,2.45,3.07,2.99,2.06,1.75,3,0,0.3820522,0.3048951,0.3130528,1.451052,1.244053,3,-7,3,3,0.2069982,-5,-1,-1,0
"2808","I2",10,"24.09.2019","Yes","Cittadella","Pescara",2,1,15,11,6,2,14,9,5,2,0,0,2.08,3.28,3.53,1.88,1.91,3,0,0.4497654,0.2852171,0.2650176,1.634513,1.08027,1,4,4,3,0.5542435,5,3,0,0
"2809","I2",10,"24.09.2019","Yes","Cosenza","Livorno",1,1,9,12,5,4,19,20,2,1,0,0,2.39,2.87,3.32,2.59,1.48,1,1,0.3917525,0.3262329,0.2820146,1.50149,1.172277,0,-3,1,0,0.3292137,-1,1,0,0
"2810","I2",10,"24.09.2019","Yes","Crotone","Juve Stabia",2,0,26,5,9,0,13,12,3,3,0,0,1.82,3.31,4.62,2.12,1.7,3,0,0.5144593,0.2828749,0.2026658,1.826253,0.8908723,2,21,9,3,0.9353806,1,0,0,0
"2811","I2",10,"24.09.2019","Yes","Perugia","Frosinone",3,1,19,5,7,2,20,14,1,3,0,0,2.35,3.05,3.18,2.14,1.69,3,0,0.3984881,0.3070318,0.2944802,1.502496,1.190472,2,14,5,3,0.3120237,6,-2,0,0
"2812","I2",10,"24.09.2019","Yes","Pisa","Empoli",2,3,9,15,6,5,12,15,2,4,0,0,2.61,3.04,2.8,2.17,1.68,0,3,0.3583336,0.3076483,0.3340181,1.382649,1.309703,-1,-6,1,-3,0.07294649,-3,-2,0,0
"2813","I2",10,"24.09.2019","Yes","Pordenone","Benevento",1,1,14,12,4,6,21,24,4,2,0,0,3.07,3.05,2.41,2.08,1.73,1,1,0.3048394,0.3068383,0.3883223,1.221356,1.471805,0,2,-2,0,-0.2504489,-3,2,0,0
"2814","I2",10,"24.09.2019","Yes","Virtus Entella","Venezia",0,2,15,11,1,8,15,20,2,2,0,1,1.88,3.26,4.39,2.06,1.74,0,3,0.4987698,0.2876341,0.2135962,1.783943,0.9284226,-2,4,-7,-3,0.8555208,-5,0,-1,0
"2815","I2",10,"25.09.2019","Yes","Trapani","Cremonese",0,0,16,3,4,3,9,14,0,3,0,0,2.69,3.05,2.68,2.12,1.7,1,1,0.3465365,0.3056339,0.3478296,1.345243,1.349123,0,13,1,0,-0.00387914,-5,-3,0,0
"2816","I2",10,"25.09.2019","Yes","Salernitana","Chievo",1,1,3,4,3,4,20,15,6,5,1,1,2.45,3.08,2.94,2.13,1.69,1,1,0.3804035,0.3025937,0.3170029,1.443804,1.253602,0,-1,-1,0,0.1902017,5,1,0,0
"2817","I2",10,"27.09.2019","Yes","Pescara","Crotone",0,3,13,17,3,9,12,10,2,1,0,0,2.73,3.08,2.64,2.02,1.78,0,3,0.3424125,0.3035019,0.3540856,1.330739,1.365759,-3,-4,-6,-3,-0.03501946,2,1,0,0
"2818","I2",10,"28.09.2019","Yes","Frosinone","Cosenza",1,1,7,12,0,4,13,12,4,3,1,0,1.72,3.46,5.03,2.11,1.71,1,1,0.5437566,0.2703067,0.1859367,1.901577,0.8281167,0,-5,-4,0,1.07346,1,1,1,0
"2819","I2",10,"28.09.2019","Yes","Juve Stabia","Cittadella",0,1,7,10,2,2,19,22,4,5,1,0,2.69,3.02,2.73,2.1,1.71,0,3,0.3476959,0.3097026,0.3426015,1.35279,1.337507,-1,-3,0,-3,0.01528334,-3,-1,1,0
"2820","I2",10,"28.09.2019","Yes","Venezia","Pisa",1,1,11,11,3,3,12,16,4,4,0,1,2.46,2.97,3.06,2.31,1.59,1,1,0.3799097,0.3146727,0.3054176,1.454402,1.230926,0,0,0,0,0.2234763,-4,0,-1,0
"2821","I2",10,"28.09.2019","Yes","Empoli","Perugia",3,0,15,18,7,3,10,19,0,2,0,0,1.95,3.3,3.95,2,1.8,3,0,0.4797129,0.2834667,0.2368203,1.722606,0.9939277,3,-3,4,3,0.7286779,-9,-2,0,0
"2822","I2",10,"29.09.2019","Yes","Benevento","Virtus Entella",1,1,21,7,5,3,10,19,4,3,0,0,1.64,3.55,5.6,2.04,1.76,1,1,0.5698561,0.2632575,0.1668864,1.972826,0.7639168,0,14,2,0,1.208909,-9,1,0,0
"2823","I2",10,"29.09.2019","Yes","Chievo","Pordenone",1,1,20,6,8,2,14,17,3,5,0,2,2.08,3.14,3.7,2.11,1.71,1,1,0.4495225,0.2977729,0.2527046,1.646341,1.055887,0,14,6,0,0.5904539,-3,-2,-2,0
"2824","I2",10,"29.09.2019","Yes","Spezia","Trapani",2,4,11,8,3,8,13,16,0,1,0,0,1.76,3.38,4.9,2.06,1.74,0,3,0.531945,0.2769891,0.1910659,1.872824,0.8501869,-2,3,-5,-3,1.022637,-3,-1,0,0
"2825","I2",10,"29.09.2019","Yes","Livorno","Salernitana",2,3,20,8,7,3,18,14,2,3,0,0,2.32,2.97,3.31,2.29,1.6,0,3,0.4028926,0.3147174,0.28239,1.523395,1.161887,-1,12,4,-3,0.3615079,4,-1,0,0
"2826","I2",10,"30.09.2019","Yes","Cremonese","Ascoli",1,0,17,4,8,1,17,13,2,2,0,0,2.23,3.18,3.25,2.02,1.76,3,0,0.4188637,0.2937314,0.2874049,1.550322,1.155946,1,13,7,3,0.3943762,4,0,0,0
"2827","I2",10,"04.10.2019","Yes","Perugia","Pisa",1,0,3,3,3,3,19,9,2,0,0,0,1.96,3.19,4.12,2.19,1.66,3,0,0.478435,0.29396,0.227605,1.729265,0.976775,1,0,0,3,0.75249,10,2,0,0
"2828","I2",10,"05.10.2019","Yes","Cosenza","Venezia",1,1,15,9,3,2,16,12,1,3,0,0,2.13,3.11,3.6,2.23,1.63,1,1,0.4392604,0.3008439,0.2598957,1.618625,1.080531,0,6,1,0,0.5380939,4,-2,0,0
"2829","I2",10,"05.10.2019","Yes","Crotone","Virtus Entella",3,1,18,8,7,4,8,6,2,2,0,0,1.77,3.36,4.85,2.24,1.63,3,0,0.5286155,0.2784671,0.1929174,1.864314,0.8572193,2,10,3,3,1.007094,2,0,0,0
"2830","I2",10,"05.10.2019","Yes","Livorno","Chievo",3,4,13,15,5,5,18,12,2,5,1,1,2.53,2.99,2.93,2.25,1.62,0,3,0.3690534,0.3122759,0.3186707,1.419436,1.268288,-1,-2,0,-3,0.1511481,6,-3,0,0
"2831","I2",10,"05.10.2019","Yes","Pordenone","Empoli",2,0,21,9,5,2,13,9,3,0,0,1,3.01,3.16,2.37,2.05,1.75,3,0,0.310311,0.295581,0.394108,1.226514,1.477905,2,12,3,3,-0.2513912,4,3,-1,0
"2832","I2",10,"05.10.2019","Yes","Spezia","Benevento",0,1,8,5,2,2,9,7,3,2,0,1,2.85,3.15,2.49,2.01,1.8,0,3,0.3279398,0.2967074,0.3753528,1.280527,1.422766,-1,3,0,-3,-0.1422389,2,1,-1,0
"2833","I2",10,"05.10.2019","Yes","Trapani","Juve Stabia",1,2,10,12,3,7,24,9,2,3,0,0,2.11,3.1,3.67,2.21,1.65,0,3,0.4433455,0.301761,0.2548935,1.631798,1.066441,-1,-2,-4,-3,0.5653562,15,-1,0,0
"2834","I2",10,"06.10.2019","Yes","Cremonese","Cittadella",0,2,7,22,1,5,9,15,4,3,1,0,2.15,3.18,3.46,2.03,1.77,0,3,0.435258,0.2942782,0.2704638,1.600052,1.10567,-2,-15,-4,-3,0.4943826,-6,1,1,0
"2835","I2",10,"06.10.2019","Yes","Salernitana","Frosinone",1,1,7,16,2,6,16,13,3,3,0,1,2.79,3.02,2.63,2.15,1.68,1,1,0.3350446,0.3095279,0.3554275,1.314662,1.37581,0,-9,-4,0,-0.06114882,3,0,-1,0
"2836","I2",10,"06.10.2019","Yes","Ascoli","Pescara",0,2,10,13,2,2,18,18,1,3,0,0,2.1,3.2,3.56,1.93,1.86,0,3,0.4452087,0.2921682,0.2626231,1.627794,1.080038,-2,-3,0,-3,0.5477568,0,-2,0,0
"2837","I2",10,"18.10.2019","Yes","Cittadella","Cosenza",1,3,9,14,3,5,24,16,4,2,0,0,1.85,3.3,4.43,1.98,1.81,0,3,0.5055067,0.2833901,0.2111032,1.79991,0.9166998,-2,-5,-2,-3,0.8832103,8,2,0,0
"2838","I2",10,"19.10.2019","Yes","Juve Stabia","Pordenone",4,2,12,17,8,6,17,18,2,3,0,0,2.6,2.93,2.91,2.21,1.64,3,0,0.3596032,0.3191018,0.321295,1.397911,1.282987,2,-5,2,3,0.1149247,-1,-1,0,0
"2839","I2",10,"19.10.2019","Yes","Pescara","Spezia",1,2,8,10,2,2,9,21,4,3,0,0,2.23,3.13,3.31,1.97,1.82,0,3,0.4190806,0.2985782,0.2823413,1.55582,1.145602,-1,-2,0,-3,0.4102178,-12,1,0,0
"2840","I2",10,"19.10.2019","Yes","Venezia","Salernitana",1,0,11,4,3,1,23,24,5,4,0,0,2.39,3.02,3.12,2.19,1.66,3,0,0.3910196,0.3094493,0.2995311,1.482508,1.208042,1,7,2,3,0.2744657,-1,1,0,0
"2841","I2",10,"19.10.2019","Yes","Virtus Entella","Trapani",1,1,18,11,7,1,14,16,2,4,0,0,2.09,3.13,3.71,2.08,1.73,1,1,0.4482146,0.2992871,0.2524983,1.643931,1.056782,0,7,6,0,0.5871491,-2,-2,0,0
"2842","I2",10,"19.10.2019","Yes","Benevento","Perugia",1,0,17,14,7,4,14,21,5,2,1,1,1.72,3.47,5,1.96,1.83,3,0,0.5435736,0.2694371,0.1869893,1.900158,0.830405,1,3,3,3,1.069753,-7,3,0,0
"2843","I2",10,"20.10.2019","Yes","Chievo","Ascoli",2,0,24,7,8,4,8,16,0,3,0,1,2.03,3.14,3.86,1.99,1.8,3,0,0.4603196,0.2975952,0.2420852,1.678554,1.023851,2,17,4,3,0.6547033,-8,-3,-1,0
"2844","I2",10,"20.10.2019","Yes","Pisa","Crotone",1,1,8,20,3,5,14,16,7,4,0,1,2.77,2.99,2.66,2.23,1.63,1,1,0.3369528,0.3121603,0.3508869,1.323019,1.364821,0,-12,-2,0,-0.04180241,-2,3,-1,0
"2845","I2",10,"20.10.2019","Yes","Empoli","Cremonese",1,1,17,20,4,8,10,10,0,3,0,1,1.9,3.36,4.07,1.88,1.91,1,1,0.4920517,0.2782435,0.2297047,1.754399,0.9673577,0,-3,-4,0,0.787041,0,-3,-1,0
"2846","I2",10,"21.10.2019","Yes","Frosinone","Livorno",1,0,25,9,6,4,15,17,3,3,0,0,1.72,3.4,5.17,2.14,1.68,3,0,0.5439007,0.2751498,0.1809496,1.906852,0.8179984,1,16,2,3,1.088853,-2,0,0,0
"2847","I2",10,"25.10.2019","Yes","Ascoli","Virtus Entella",2,1,10,15,4,3,12,12,4,8,1,1,2.03,3.19,3.83,2.05,1.76,3,0,0.4615975,0.2937438,0.2446587,1.678536,1.02772,1,-5,1,3,0.6508163,0,-4,0,0
"2848","I2",10,"26.10.2019","Yes","Cosenza","Chievo",1,1,13,5,2,1,19,16,2,3,0,0,2.61,3,2.84,2.18,1.66,1,1,0.3585496,0.3119382,0.3295122,1.387587,1.300475,0,8,1,0,0.08711241,3,-1,0,0
"2849","I2",10,"26.10.2019","Yes","Crotone","Venezia",3,2,21,9,6,3,14,18,1,4,0,0,1.57,3.64,6.38,2.04,1.77,3,0,0.5961607,0.2571352,0.1467041,2.045617,0.6972476,1,12,3,3,1.34837,-4,-3,0,0
"2850","I2",10,"26.10.2019","Yes","Pescara","Benevento",4,0,13,10,5,2,14,14,3,2,0,0,3.47,3.14,2.16,2.02,1.79,3,0,0.2694273,0.2977429,0.4328299,1.106025,1.596233,4,3,3,3,-0.4902079,0,1,0,0
"2851","I2",10,"26.10.2019","Yes","Pordenone","Cittadella",0,0,9,11,4,4,16,18,3,3,0,0,2.55,2.99,2.93,2.07,1.75,1,1,0.3672218,0.3131825,0.3195958,1.414848,1.27197,0,-2,0,0,0.1428781,-2,0,0,0
"2852","I2",10,"26.10.2019","Yes","Salernitana","Perugia",1,1,8,10,3,4,21,21,1,1,0,0,2.47,3,3.02,2.22,1.64,1,1,0.3786138,0.3117253,0.3096609,1.447567,1.240708,0,-2,-1,0,0.2068585,0,0,0,0
"2853","I2",10,"26.10.2019","Yes","Spezia","Juve Stabia",2,0,17,4,5,1,14,16,3,4,0,1,1.82,3.31,4.63,2.08,1.74,3,0,0.5146846,0.2829988,0.2023166,1.827053,0.8899487,2,13,4,3,0.9371039,-2,-1,-1,0
"2854","I2",10,"26.10.2019","Yes","Trapani","Empoli",2,2,21,20,9,9,15,17,2,1,0,0,3.15,3.1,2.34,2.12,1.71,1,1,0.297417,0.302214,0.400369,1.194465,1.503321,0,1,0,0,-0.3088561,-2,1,0,0
"2855","I2",10,"26.10.2019","Yes","Livorno","Pisa",1,0,10,21,2,2,22,16,5,2,1,1,2.33,2.98,3.29,2.19,1.66,3,0,0.4015926,0.3139969,0.2844105,1.518775,1.167229,1,-11,0,3,0.3515461,6,3,0,0
"2856","I2",10,"27.10.2019","Yes","Cremonese","Frosinone",1,1,16,11,6,4,14,10,0,1,0,0,2.47,2.98,3.04,2.24,1.63,1,1,0.378593,0.3138002,0.3076068,1.449579,1.236621,0,5,2,0,0.2129586,4,-1,0,0
"2857","I2",10,"29.10.2019","Yes","Chievo","Crotone",2,1,13,13,1,6,26,18,3,3,0,1,2.43,3.1,2.99,2.06,1.75,3,0,0.385122,0.3018859,0.3129921,1.457252,1.240862,1,0,-5,3,0.2163896,8,0,-1,0
"2858","I2",10,"29.10.2019","Yes","Cittadella","Livorno",1,0,11,14,4,7,21,14,4,3,1,0,1.94,3.22,4.12,2.03,1.78,3,0,0.4823093,0.2905839,0.2271068,1.737512,0.9719043,1,-3,-3,3,0.7656075,7,1,1,0
"2859","I2",10,"29.10.2019","Yes","Empoli","Spezia",1,1,16,13,4,4,14,18,2,5,0,0,1.92,3.24,4.2,1.98,1.82,1,1,0.4878678,0.2891069,0.2230253,1.75271,0.9581828,0,3,0,0,0.7945276,-4,-3,0,0
"2860","I2",10,"29.10.2019","Yes","Juve Stabia","Pescara",2,1,11,12,4,6,23,25,7,4,1,1,2.35,3.09,3.14,2.12,1.71,3,0,0.398577,0.3031249,0.2982981,1.498856,1.198019,1,-1,-2,3,0.3008368,-2,3,0,0
"2861","I2",10,"29.10.2019","Yes","Perugia","Ascoli",1,1,12,14,2,7,17,17,4,0,0,0,1.85,3.25,4.51,2.01,1.78,1,1,0.5051959,0.287573,0.2072311,1.803161,0.9092664,0,-2,-5,0,0.8938942,0,4,0,0
"2862","I2",10,"29.10.2019","Yes","Pisa","Salernitana",2,1,5,10,3,6,21,26,3,3,0,0,2.28,3.04,3.33,2.19,1.66,3,0,0.4107308,0.3080481,0.2812211,1.540241,1.151711,1,-5,-3,3,0.3885291,-5,0,0,0
"2863","I2",10,"29.10.2019","Yes","Venezia","Pordenone",1,2,17,14,3,5,9,16,2,3,0,0,2.27,3.05,3.34,2.11,1.71,0,3,0.4125578,0.3070512,0.2803911,1.544724,1.148224,-1,3,-2,-3,0.3965001,-7,-1,0,0
"2864","I2",10,"29.10.2019","Yes","Virtus Entella","Cosenza",1,0,18,11,8,3,17,11,2,3,0,0,2.55,2.97,2.93,2.28,1.6,3,0,0.366449,0.3146279,0.3189232,1.413975,1.271397,1,7,5,3,0.1425774,6,-1,0,0
"2865","I2",10,"30.10.2019","Yes","Benevento","Cremonese",2,0,17,12,10,3,19,16,1,1,0,0,1.71,3.37,5.28,2.06,1.74,3,0,0.5460655,0.2770837,0.1768508,1.91528,0.807636,2,5,7,3,1.107644,3,0,0,0
"2866","I2",10,"30.10.2019","Yes","Frosinone","Trapani",3,0,18,20,8,6,9,18,2,4,0,0,1.71,3.4,5.21,2.06,1.75,3,0,0.5461031,0.2746577,0.1792392,1.912967,0.8123753,3,-2,2,3,1.100592,-9,-2,0,0
"2867","I2",10,"01.11.2019","Yes","Spezia","Chievo",0,0,5,20,0,7,19,20,3,1,0,0,2.42,3.03,3.05,2.24,1.63,1,1,0.3857842,0.3081181,0.3060977,1.465471,1.226411,0,-15,-7,0,0.2390597,-1,2,0,0
"2868","I2",10,"02.11.2019","Yes","Ascoli","Venezia",1,1,7,13,3,2,19,18,2,4,0,0,2.04,3.1,3.9,2.13,1.69,1,1,0.4584755,0.3017065,0.239818,1.677133,1.02116,0,-6,1,0,0.6559727,1,-2,0,0
"2869","I2",10,"02.11.2019","Yes","Crotone","Perugia",2,3,14,5,6,4,11,14,0,0,0,0,1.99,3.14,4.05,2.05,1.76,0,3,0.4705626,0.2982228,0.2312147,1.70991,0.9918668,-1,9,2,-3,0.7180436,-3,0,0,0
"2870","I2",10,"02.11.2019","Yes","Livorno","Juve Stabia",2,1,25,11,8,1,15,20,2,3,0,0,2.01,3.13,3.97,2.15,1.69,3,0,0.4654476,0.2988976,0.2356548,1.69524,1.005862,1,14,7,3,0.6893782,-5,-1,0,0
"2871","I2",10,"02.11.2019","Yes","Pescara","Pisa",3,0,13,8,5,3,17,13,1,2,0,0,2.23,3.03,3.44,2.02,1.78,3,0,0.4194227,0.3086841,0.2718932,1.566952,1.124364,3,5,2,3,0.4425885,4,-1,0,0
"2872","I2",10,"02.11.2019","Yes","Salernitana","Virtus Entella",2,1,20,5,8,4,11,16,2,3,0,0,1.86,3.19,4.59,2.17,1.67,3,0,0.502942,0.2932514,0.2038066,1.802077,0.9046711,1,15,4,3,0.8974063,-5,-1,0,0
"2873","I2",10,"03.11.2019","Yes","Cittadella","Frosinone",0,0,9,9,1,3,22,13,3,1,0,0,2.47,3.02,2.98,2.13,1.69,1,1,0.3778233,0.3090144,0.3131623,1.442484,1.248501,0,0,-2,0,0.1939831,9,2,0,0
"2874","I2",10,"03.11.2019","Yes","Pordenone","Trapani",2,1,19,14,5,3,12,8,0,4,0,1,2,3.13,3.97,2.1,1.72,3,0,0.4666887,0.2982036,0.2351077,1.69827,1.003527,1,5,2,3,0.6947431,4,-4,-1,0
"2875","I2",10,"03.11.2019","Yes","Benevento","Empoli",2,0,11,11,5,4,11,13,1,0,0,0,2.02,3.21,3.79,2.01,1.78,3,0,0.462478,0.2910298,0.2464922,1.678464,1.030506,2,0,1,3,0.6479573,-2,1,0,0
"2876","I2",10,"04.11.2019","Yes","Cosenza","Cremonese",2,0,13,11,4,3,18,13,3,2,0,0,2.45,2.85,3.22,2.47,1.52,3,0,0.3816038,0.3280454,0.2903507,1.472857,1.199098,2,2,1,3,0.2737593,5,1,0,0
"2877","I2",10,"08.11.2019","Yes","Crotone","Ascoli",3,1,24,7,7,5,16,17,1,3,0,0,1.51,3.94,6.59,1.83,1.97,3,0,0.6201997,0.2376908,0.1421095,2.09829,0.6640193,2,17,2,3,1.434271,-1,-2,0,0
"2878","I2",10,"09.11.2019","Yes","Juve Stabia","Benevento",1,1,8,10,3,4,13,21,3,4,0,1,4.25,3.24,1.91,2.07,1.74,1,1,0.2204168,0.289127,0.4904562,0.9503774,1.760496,0,-2,-1,0,-0.8101183,-8,-1,-1,0
"2879","I2",10,"09.11.2019","Yes","Perugia","Cittadella",0,2,15,19,5,10,16,12,2,3,0,0,1.96,3.16,4.16,2.13,1.71,0,3,0.478147,0.2965722,0.2252808,1.731013,0.9724146,-2,-4,-5,-3,0.7585986,4,-1,0,0
"2880","I2",10,"09.11.2019","Yes","Pisa","Spezia",3,2,11,13,5,7,20,22,5,1,1,0,2.57,3.02,2.87,2.19,1.67,3,0,0.3641046,0.3098506,0.3260449,1.402164,1.287985,1,-2,-2,3,0.1141791,-2,4,1,0
"2881","I2",10,"09.11.2019","Yes","Venezia","Livorno",1,0,9,11,4,4,18,21,6,3,1,0,2.06,3.19,3.7,2.16,1.68,3,0,0.4540244,0.2931944,0.2527812,1.655268,1.051538,1,-2,0,3,0.6037297,-3,3,1,0
"2882","I2",10,"09.11.2019","Yes","Virtus Entella","Pordenone",1,1,8,11,2,4,10,17,1,4,0,1,2.28,3.08,3.29,2.13,1.7,1,1,0.4109698,0.3042244,0.2848058,1.537134,1.158642,0,-3,-2,0,0.3784919,-7,-3,-1,0
"2883","I2",10,"09.11.2019","Yes","Empoli","Pescara",1,2,21,9,2,4,25,14,2,0,0,0,1.77,3.47,4.64,1.85,1.94,0,3,0.5286664,0.2696656,0.201668,1.855665,0.8746696,-1,12,-2,-3,0.9809952,11,2,0,0
"2884","I2",10,"10.11.2019","Yes","Cremonese","Salernitana",1,0,20,12,10,5,23,14,4,2,0,0,2.08,3.13,3.73,2.19,1.66,3,0,0.4500091,0.2990476,0.2509434,1.649075,1.051878,1,8,5,3,0.597197,9,2,0,0
"2885","I2",10,"10.11.2019","Yes","Trapani","Cosenza",2,2,10,11,5,5,7,12,6,3,1,1,2.19,3.05,3.52,2.24,1.63,1,1,0.4273154,0.3068265,0.2658582,1.588773,1.104401,0,-1,0,0,0.4843717,-5,3,0,0
"2886","I2",10,"10.11.2019","Yes","Frosinone","Chievo",2,0,11,8,4,3,13,23,0,3,0,0,1.99,3.11,4.06,2.23,1.64,3,0,0.4694793,0.3004064,0.2301143,1.708844,0.9907492,2,3,1,3,0.7180953,-10,-3,0,0
"2887","I2",10,"22.11.2019","Yes","Pescara","Cremonese",1,1,14,11,6,3,10,21,3,3,0,0,2.31,3.03,3.28,2.03,1.77,1,1,0.405409,0.3090742,0.2855167,1.525301,1.165624,0,3,3,0,0.3596769,-11,0,0,0
"2888","I2",10,"23.11.2019","Yes","Benevento","Crotone",2,0,11,17,3,4,18,15,3,2,0,0,2.3,3.18,3.12,1.91,1.88,3,0,0.4064297,0.2939586,0.2996117,1.513248,1.192794,2,-6,-1,3,0.3204542,3,1,0,0
"2889","I2",10,"23.11.2019","Yes","Juve Stabia","Salernitana",2,0,8,10,4,5,16,28,2,5,0,1,2.54,2.98,2.93,2.26,1.62,3,0,0.3677494,0.3134508,0.3187998,1.416699,1.26985,2,-2,-1,3,0.1468487,-12,-3,-1,0
"2890","I2",10,"23.11.2019","Yes","Livorno","Trapani",1,2,17,10,6,6,16,18,2,3,0,0,1.95,3.22,4.05,2.11,1.72,0,3,0.4791403,0.2901626,0.2306972,1.727583,0.9822541,-1,7,0,-3,0.7453293,-2,-1,0,0
"2891","I2",10,"23.11.2019","Yes","Pordenone","Perugia",3,0,22,12,10,2,16,10,2,2,0,0,2.48,2.99,3,2.18,1.66,3,0,0.3764921,0.3122744,0.3112335,1.441751,1.245975,3,10,8,3,0.1957759,6,0,0,0
"2892","I2",10,"23.11.2019","Yes","Empoli","Venezia",1,1,8,16,2,4,13,9,2,1,0,0,1.77,3.38,4.8,2.08,1.74,1,1,0.5284243,0.2767192,0.1948565,1.861992,0.8612886,0,-8,-2,0,1.000704,4,1,0,0
"2893","I2",10,"24.11.2019","Yes","Ascoli","Cosenza",3,2,14,6,6,1,11,13,5,3,0,0,2.19,3.03,3.53,2.38,1.57,3,0,0.4267725,0.3084593,0.2647682,1.588777,1.102764,1,8,5,3,0.4860129,-2,2,0,0
"2894","I2",10,"24.11.2019","Yes","Cittadella","Pisa",1,1,19,10,4,4,23,16,2,3,0,0,1.88,3.3,4.23,2.15,1.68,1,1,0.4964895,0.2828485,0.220662,1.772317,0.9448345,0,9,0,0,0.8274824,7,-1,0,0
"2895","I2",10,"24.11.2019","Yes","Spezia","Frosinone",2,0,15,13,7,1,14,15,2,4,0,0,2.83,2.99,2.61,2.27,1.61,3,0,0.3299481,0.312292,0.3577598,1.302136,1.385572,2,2,6,3,-0.08343516,-1,-2,0,0
"2896","I2",10,"25.11.2019","Yes","Chievo","Virtus Entella",2,1,9,12,4,2,19,20,1,1,0,0,1.77,3.28,4.95,2.27,1.61,3,0,0.5270898,0.2844357,0.1884745,1.865705,0.8498593,1,-3,2,3,1.015846,-1,0,0,0
"2897","I2",10,"29.11.2019","Yes","Cosenza","Spezia",1,1,14,14,6,2,11,11,3,4,0,1,2.47,2.91,3.13,2.37,1.57,1,1,0.3790845,0.3217658,0.2991497,1.459019,1.219215,0,0,4,0,0.2398042,0,-1,-1,0
"2898","I2",10,"30.11.2019","Yes","Cremonese","Livorno",0,0,12,11,2,3,16,14,3,3,0,0,1.88,3.19,4.48,2.28,1.61,1,1,0.4977639,0.293353,0.2088831,1.786645,0.9200022,0,1,-1,0,0.8666425,2,0,0,0
"2899","I2",10,"30.11.2019","Yes","Crotone","Cittadella",1,1,17,9,5,4,12,18,3,3,1,0,1.79,3.46,4.52,1.93,1.86,1,1,0.5226411,0.2703837,0.2069751,1.838307,0.8913091,0,8,1,0,0.946998,-6,0,1,0
"2900","I2",10,"30.11.2019","Yes","Frosinone","Empoli",4,0,14,7,9,2,14,13,3,1,0,0,2.02,3.17,3.86,2.06,1.75,3,0,0.4628472,0.2949374,0.2422154,1.683479,1.021584,4,7,7,3,0.6618955,1,2,0,0
"2901","I2",10,"30.11.2019","Yes","Venezia","Benevento",0,2,9,20,2,7,13,16,1,3,0,0,3.45,3.1,2.19,2.09,1.73,0,3,0.2711316,0.3017432,0.4271251,1.115138,1.583119,-2,-11,-5,-3,-0.4679806,-3,-2,0,0
"2902","I2",10,"30.11.2019","Yes","Salernitana","Ascoli",1,1,16,16,6,6,18,16,0,3,0,0,2.09,3.13,3.69,2.06,1.75,1,1,0.4476021,0.2988781,0.2535199,1.641684,1.059438,0,0,0,0,0.5822466,2,-3,0,0
"2903","I2",10,"01.12.2019","Yes","Trapani","Chievo",1,0,15,10,8,2,11,16,1,1,0,0,3.33,3.03,2.26,2.13,1.7,3,0,0.2799191,0.3076338,0.4124471,1.147391,1.544975,1,5,6,3,-0.3975842,-5,0,0,0
"2904","I2",10,"01.12.2019","Yes","Virtus Entella","Juve Stabia",2,0,22,2,9,1,20,12,3,2,0,0,2.21,3.06,3.43,2.1,1.72,3,0,0.4225583,0.305181,0.2722606,1.572856,1.121963,2,20,8,3,0.4508932,8,1,0,0
"2905","I2",10,"01.12.2019","Yes","Perugia","Pescara",3,1,11,13,4,2,17,20,2,2,0,0,2.03,3.18,3.76,1.99,1.8,3,0,0.4590824,0.293062,0.2478556,1.670309,1.036629,2,-2,2,3,0.6336802,-3,0,0,0
"2906","I2",10,"02.12.2019","Yes","Pisa","Pordenone",2,0,9,9,3,3,21,19,3,4,1,0,2.44,3.05,2.97,2.04,1.76,3,0,0.3814539,0.3051631,0.313383,1.449525,1.245312,2,0,0,3,0.2042127,2,-1,1,0
"2907","I2",10,"06.12.2019","Yes","Benevento","Trapani",5,0,21,7,10,3,12,10,1,2,0,0,1.38,4.33,8.9,1.8,2,3,0,0.6785352,0.2162537,0.1052111,2.251859,0.5318869,5,14,7,3,1.719972,2,-1,0,0
"2908","I2",10,"07.12.2019","Yes","Cittadella","Salernitana",4,3,20,10,8,7,12,20,2,4,0,0,1.91,3.24,4.22,2.13,1.7,3,0,0.4896889,0.2886746,0.2216365,1.757741,0.953584,1,10,1,3,0.8041574,-8,-2,0,0
"2909","I2",10,"07.12.2019","Yes","Empoli","Ascoli",2,1,19,11,6,6,13,14,2,2,0,0,1.92,3.37,3.97,1.83,1.96,3,0,0.4870066,0.2774637,0.2355297,1.738484,0.9840527,1,8,0,3,0.7544309,-1,0,0,0
"2910","I2",10,"07.12.2019","Yes","Pescara","Venezia",2,2,7,17,3,2,15,13,1,1,0,0,2.02,3.21,3.81,1.99,1.8,1,1,0.4630772,0.2914068,0.245516,1.680638,1.027955,0,-10,1,0,0.6526836,2,0,0,0
"2911","I2",10,"07.12.2019","Yes","Spezia","Livorno",2,0,16,21,5,6,13,14,3,2,0,0,2.07,3.08,3.83,2.1,1.72,3,0,0.4519676,0.3037575,0.2442749,1.65966,1.036582,2,-5,-1,3,0.6230781,-1,1,0,0
"2912","I2",10,"07.12.2019","Yes","Chievo","Cremonese",1,0,16,11,7,6,11,12,2,5,0,1,1.94,3.19,4.15,2.14,1.69,3,0,0.4817837,0.292997,0.2252194,1.738348,0.968655,1,5,1,3,0.769693,-1,-3,-1,0
"2913","I2",10,"08.12.2019","Yes","Juve Stabia","Frosinone",0,2,7,18,3,6,16,23,4,3,0,0,3.45,3.03,2.21,2.1,1.72,0,3,0.2702922,0.3077584,0.4219494,1.118635,1.573607,-2,-11,-3,-3,-0.4549715,-7,1,0,0
"2914","I2",10,"08.12.2019","Yes","Pisa","Virtus Entella",0,2,19,14,5,5,8,28,2,7,0,1,2.35,2.97,3.25,2.2,1.66,0,3,0.3977214,0.3146954,0.2875832,1.50786,1.177445,-2,5,0,-3,0.3304147,-20,-5,-1,0
"2915","I2",10,"08.12.2019","Yes","Pordenone","Crotone",1,0,9,16,1,3,16,8,2,1,0,0,2.84,3.04,2.57,1.95,1.83,3,0,0.3290265,0.30738,0.3635935,1.29446,1.39816,1,-7,-2,3,-0.103701,8,1,0,0
"2916","I2",10,"09.12.2019","Yes","Perugia","Cosenza",2,2,15,7,4,5,16,12,2,3,1,0,2.02,3.06,4.04,2.26,1.61,1,1,0.4629349,0.3055976,0.2314675,1.694402,1,0,8,-1,0,0.6944024,4,-1,1,0
"2917","I2",10,"13.12.2019","Yes","Chievo","Juve Stabia",2,3,8,9,3,5,16,22,3,5,0,0,1.48,3.84,7.37,2.08,1.73,0,3,0.6304253,0.2429764,0.1265983,2.134252,0.6227713,-1,-1,-2,-3,1.511481,-6,-2,0,0
"2918","I2",10,"14.12.2019","Yes","Ascoli","Cittadella",1,0,9,15,2,4,12,14,2,3,0,0,2.68,3.08,2.68,1.92,1.87,3,0,0.3484163,0.3031674,0.3484163,1.348416,1.348416,1,-6,-2,3,0,-2,-1,0,0
"2919","I2",10,"14.12.2019","Yes","Frosinone","Pescara",2,0,13,7,3,1,15,14,0,1,0,0,1.7,3.48,5.14,1.92,1.86,3,0,0.5496786,0.2685211,0.1818003,1.917557,0.813922,2,6,2,3,1.103635,1,-1,0,0
"2920","I2",10,"14.12.2019","Yes","Venezia","Spezia",0,0,14,5,7,2,6,19,1,5,0,1,2.44,2.98,3.06,2.19,1.66,1,1,0.3822371,0.3129726,0.3047903,1.459684,1.227344,0,9,5,0,0.2323402,-13,-4,-1,0
"2921","I2",10,"14.12.2019","Yes","Virtus Entella","Empoli",2,0,9,13,7,3,17,10,1,1,0,1,2.39,3.11,3.01,2,1.8,3,0,0.3902426,0.299897,0.3098604,1.470625,1.229478,2,-4,4,3,0.2411466,7,0,-1,0
"2922","I2",10,"14.12.2019","Yes","Livorno","Benevento",0,2,6,12,1,6,18,8,2,4,0,0,3.11,3.12,2.33,2.06,1.74,0,3,0.3001598,0.2991977,0.4006425,1.199677,1.501125,-2,-6,-5,-3,-0.301448,10,-2,0,0
"2923","I2",10,"15.12.2019","Yes","Cosenza","Pordenone",1,2,17,15,7,9,8,15,1,1,0,1,2.29,3.06,3.25,2.17,1.67,0,3,0.4076672,0.3050843,0.2872486,1.528086,1.16683,-1,2,-2,-3,0.3612558,-7,0,-1,0
"2924","I2",10,"15.12.2019","Yes","Cremonese","Perugia",2,1,19,17,9,6,19,12,4,1,0,0,2.22,2.94,3.57,2.37,1.56,3,0,0.4207071,0.3176768,0.2616162,1.579798,1.102525,1,2,3,3,0.4772727,7,3,0,0
"2925","I2",10,"15.12.2019","Yes","Salernitana","Crotone",3,2,16,12,6,3,26,15,3,3,0,1,2.99,3.05,2.43,2.01,1.78,3,0,0.3114507,0.3053238,0.3832254,1.239676,1.455,1,4,3,3,-0.215324,11,0,-1,0
"2926","I2",10,"16.12.2019","Yes","Trapani","Pisa",1,3,26,13,9,6,14,18,3,5,0,0,2.35,3,3.18,2.19,1.65,0,3,0.3964593,0.3105598,0.2929809,1.499938,1.189503,-2,13,3,-3,0.3104351,-4,-2,0,0
"2927","I2",10,"21.12.2019","Yes","Cittadella","Chievo",1,1,19,5,7,1,22,15,2,3,0,0,2.19,3.01,3.55,2.21,1.65,1,1,0.4265345,0.3103357,0.2631297,1.589939,1.099725,0,14,6,0,0.4902143,7,-1,0,0
"2928","I2",10,"21.12.2019","Yes","Crotone","Livorno",2,1,16,7,7,3,18,14,5,3,0,0,1.6,3.57,6.06,1.96,1.83,3,0,0.584042,0.2617555,0.1542025,2.013881,0.724363,1,9,4,3,1.289518,4,2,0,0
"2929","I2",10,"21.12.2019","Yes","Empoli","Salernitana",1,1,10,14,3,6,18,23,4,4,0,0,1.96,3.19,4.05,2,1.79,1,1,0.4765602,0.2928082,0.2306316,1.722489,0.984703,0,-4,-3,0,0.7377858,-5,0,0,0
"2930","I2",10,"21.12.2019","Yes","Juve Stabia","Venezia",2,0,10,14,3,5,19,11,3,0,0,0,2.48,3,2.97,2.11,1.71,3,0,0.3757021,0.3105804,0.3137176,1.437687,1.251733,2,-4,-2,3,0.1859535,8,3,0,0
"2931","I2",10,"21.12.2019","Yes","Perugia","Virtus Entella",2,0,17,18,8,3,10,14,4,2,0,1,1.98,3.17,4.01,2.07,1.74,3,0,0.4720608,0.2948518,0.2330874,1.711034,0.994114,2,-1,5,3,0.7169202,-4,2,-1,0
"2932","I2",10,"21.12.2019","Yes","Benevento","Frosinone",1,0,14,10,2,0,10,20,0,6,0,0,2,3.02,4.16,2.21,1.64,3,0,0.466631,0.3090272,0.2243418,1.70892,0.9820527,1,4,2,3,0.7268675,-10,-6,0,0
"2933","I2",10,"22.12.2019","Yes","Pescara","Trapani",1,1,13,3,4,1,20,18,2,2,0,0,1.83,3.4,4.32,1.83,1.95,1,1,0.5097239,0.2743514,0.2159247,1.803523,0.9221255,0,10,3,0,0.8813976,2,0,0,0
"2934","I2",10,"22.12.2019","Yes","Pisa","Cosenza",1,3,10,12,3,9,12,18,5,3,1,0,2.32,3,3.26,2.2,1.65,0,3,0.4024161,0.3112018,0.286382,1.51845,1.170348,-2,-2,-6,-3,0.3481023,-6,2,1,0
"2935","I2",10,"22.12.2019","Yes","Pordenone","Ascoli",2,1,12,8,7,2,19,11,3,3,0,1,2.01,3.23,3.79,1.95,1.83,3,0,0.4645471,0.2890835,0.2463693,1.682725,1.028192,1,4,5,3,0.6545334,8,0,-1,0
"2936","I2",10,"26.12.2019","Yes","Cosenza","Empoli",1,0,12,13,5,5,17,12,3,4,0,1,2.37,3.03,3.13,2.13,1.69,3,0,0.393799,0.308021,0.2981801,1.489418,1.202561,1,-1,0,3,0.2868568,5,-1,-1,0
"2937","I2",10,"26.12.2019","Yes","Chievo","Benevento",1,2,11,12,6,3,17,20,3,4,0,0,2.84,2.96,2.61,2.19,1.66,0,3,0.328129,0.3148265,0.3570446,1.299213,1.38596,-1,-1,3,-3,-0.08674674,-3,-1,0,0
"2938","I2",10,"26.12.2019","Yes","Cremonese","Juve Stabia",1,1,14,9,5,4,14,8,1,2,0,0,1.79,3.18,5.02,2.37,1.57,1,1,0.520978,0.2932549,0.1857671,1.856189,0.8505561,0,5,1,0,1.005633,6,-1,0,0
"2939","I2",10,"26.12.2019","Yes","Frosinone","Crotone",1,2,13,10,6,6,14,14,2,1,0,0,2,3.16,3.94,2.04,1.76,0,3,0.467175,0.2956804,0.2371447,1.697205,1.007114,-1,3,0,-3,0.690091,0,1,0,0
"2940","I2",10,"26.12.2019","Yes","Livorno","Pescara",0,2,11,12,5,6,14,18,2,5,0,0,2.22,3.24,3.18,1.94,1.84,0,3,0.4195866,0.2874945,0.2929189,1.546254,1.166251,-2,-1,-1,-3,0.3800029,-4,-3,0,0
"2941","I2",10,"26.12.2019","Yes","Salernitana","Pordenone",4,0,12,7,5,3,12,21,2,3,0,0,2.44,3.07,2.95,2.05,1.75,3,0,0.3814018,0.3031337,0.3154645,1.447339,1.249527,4,5,2,3,0.1978118,-9,-1,0,0
"2942","I2",10,"26.12.2019","Yes","Trapani","Perugia",2,2,11,12,4,4,11,14,4,1,1,1,2.51,3.03,2.89,2.07,1.73,1,1,0.3707968,0.3071617,0.3220415,1.419552,1.273286,0,-1,0,0,0.1462659,-3,3,0,0
"2943","I2",10,"26.12.2019","Yes","Venezia","Cittadella",1,2,12,15,3,5,18,21,4,6,1,0,2.78,2.98,2.64,2.16,1.67,0,3,0.3349056,0.3124287,0.3526657,1.317145,1.370426,-1,-3,-2,-3,-0.05328043,-3,-2,1,0
"2944","I2",10,"26.12.2019","Yes","Ascoli","Pisa",1,0,14,6,5,1,13,14,3,3,0,0,1.86,3.41,4.14,1.96,1.83,3,0,0.501321,0.2734478,0.2252312,1.777411,0.9491413,1,8,4,3,0.8282695,-1,0,0,0
"2945","I2",10,"26.12.2019","Yes","Virtus Entella","Spezia",0,0,10,7,3,1,19,14,2,2,0,1,2.46,3.1,2.91,2.11,1.71,1,1,0.3789445,0.3007108,0.3203448,1.437544,1.261745,0,3,2,0,0.175799,5,0,-1,0
"2946","I2",10,"29.12.2019","Yes","Pescara","Chievo",0,0,16,8,2,3,8,18,2,4,0,0,2.46,3.03,2.97,2.12,1.7,1,1,0.3787643,0.3075116,0.313724,1.443805,1.248684,0,8,-1,0,0.195121,-10,-2,0,0
"2947","I2",10,"29.12.2019","Yes","Cittadella","Virtus Entella",1,3,14,10,4,4,16,16,3,4,0,0,1.88,3.28,4.28,2.04,1.76,0,3,0.4969134,0.2848162,0.2182704,1.775556,0.9396273,-2,4,0,-3,0.8359291,0,-1,0,0
"2948","I2",10,"29.12.2019","Yes","Crotone","Trapani",3,0,24,4,7,1,18,8,2,2,0,0,1.45,4.16,7.02,1.68,2.15,3,0,0.6430412,0.2241369,0.1328219,2.15326,0.6226026,3,20,6,3,1.530658,10,0,0,0
"2949","I2",10,"29.12.2019","Yes","Juve Stabia","Cosenza",1,0,9,8,3,2,12,20,2,5,0,0,2.68,2.97,2.76,2.21,1.64,3,0,0.3480232,0.3140412,0.3379356,1.358111,1.327848,1,1,1,3,0.03026289,-8,-3,0,0
"2950","I2",10,"29.12.2019","Yes","Perugia","Venezia",0,1,10,9,2,3,22,25,3,5,2,0,2,3.04,4.11,2.2,1.65,0,3,0.4663064,0.3067805,0.2269131,1.7057,0.9875198,-1,1,-1,-3,0.7181799,-3,-2,2,0
"2951","I2",10,"29.12.2019","Yes","Pisa","Frosinone",0,0,9,10,2,5,17,15,3,1,0,0,3.67,3.06,2.12,2.2,1.65,1,1,0.254422,0.3051401,0.440438,1.068406,1.626454,0,-1,-3,0,-0.5580481,2,2,0,0
"2952","I2",10,"29.12.2019","Yes","Pordenone","Cremonese",1,0,10,15,1,7,20,18,2,3,0,0,2.2,3.01,3.51,2.16,1.68,3,0,0.4241462,0.3100072,0.2658466,1.582446,1.107547,1,-5,-6,3,0.4748987,2,-1,0,0
"2953","I2",10,"29.12.2019","Yes","Spezia","Salernitana",2,1,11,9,5,4,18,21,3,4,0,0,1.87,3.29,4.3,2.05,1.76,3,0,0.4991831,0.2837302,0.2170866,1.78128,0.9349901,1,2,1,3,0.8462896,-3,-1,0,0
"2954","I2",10,"29.12.2019","Yes","Benevento","Ascoli",4,0,24,12,11,2,12,14,2,5,0,1,1.54,3.82,6.22,1.8,1.98,3,0,0.6057927,0.2442201,0.1499873,2.061598,0.6941818,4,12,9,3,1.367416,-2,-3,-1,0
"2955","I2",10,"29.12.2019","Yes","Empoli","Livorno",1,1,15,11,5,3,19,24,4,3,0,0,1.82,3.46,4.26,1.88,1.9,1,1,0.5119694,0.2693018,0.2187287,1.80521,0.925488,0,4,2,0,0.8797221,-5,1,0,0
"2956","I2",10,"17.01.2020","Yes","Frosinone","Pordenone",2,2,9,15,5,6,15,24,5,1,0,0,1.77,3.3,4.92,2.02,1.78,1,1,0.5273929,0.2828743,0.1897328,1.865053,0.8520727,0,-6,-1,0,1.01298,-9,4,0,0
"2957","I2",10,"18.01.2020","Yes","Cremonese","Venezia",0,0,8,19,3,5,13,9,3,2,1,0,2.12,2.87,3.96,2.51,1.51,1,1,0.439748,0.3248313,0.2354207,1.644075,1.031093,0,-11,-2,0,0.6129821,4,1,1,0
"2958","I2",10,"18.01.2020","Yes","Juve Stabia","Empoli",1,0,13,11,3,5,11,19,1,3,0,0,3.24,2.99,2.33,2.07,1.74,3,0,0.2878385,0.3119053,0.4002562,1.175421,1.512674,1,2,-2,3,-0.3372529,-8,-2,0,0
"2959","I2",10,"18.01.2020","Yes","Livorno","Virtus Entella",4,4,17,17,8,7,9,12,3,3,1,1,2.37,3.12,3.02,2.04,1.76,1,1,0.3930225,0.2985459,0.3084316,1.477613,1.223841,0,0,1,0,0.2537728,-3,0,0,0
"2960","I2",10,"18.01.2020","Yes","Trapani","Ascoli",3,1,16,11,8,3,9,6,4,3,1,1,2.39,3.09,3.02,1.94,1.84,3,0,0.3898858,0.3015622,0.308552,1.47122,1.227218,2,5,5,3,0.2440014,3,1,0,0
"2961","I2",10,"18.01.2020","Yes","Chievo","Perugia",2,0,10,9,5,4,20,20,4,3,0,1,2.02,3.07,3.96,2.19,1.66,3,0,0.4612373,0.3034851,0.2352776,1.687197,1.009318,2,1,1,3,0.677879,0,1,-1,0
"2962","I2",10,"19.01.2020","Yes","Pescara","Salernitana",1,2,9,13,3,10,14,19,2,4,0,0,1.99,3.16,3.94,2.04,1.75,0,3,0.4684229,0.2949878,0.2365892,1.700257,1.004756,-1,-4,-7,-3,0.695501,-5,-2,0,0
"2963","I2",10,"19.01.2020","Yes","Spezia","Cittadella",1,1,8,7,3,2,15,14,1,1,0,0,2.42,2.96,3.11,2.24,1.63,1,1,0.3852521,0.3149697,0.2997782,1.470726,1.214304,0,1,1,0,0.2564218,1,0,0,0
"2964","I2",10,"19.01.2020","Yes","Benevento","Pisa",1,1,18,11,8,5,9,17,3,4,0,1,1.37,4.4,8.57,1.76,2.04,1,1,0.6797063,0.2116358,0.1086578,2.250755,0.5376093,0,7,3,0,1.713145,-8,-1,-1,0
"2965","I2",10,"20.01.2020","Yes","Cosenza","Crotone",0,1,12,11,4,4,26,19,1,3,0,0,3.05,2.92,2.48,2.15,1.68,0,3,0.3054033,0.319,0.3755968,1.23521,1.44579,-1,1,0,-3,-0.2105805,7,-2,0,0
"2966","I2",10,"24.01.2020","Yes","Empoli","Chievo",1,1,12,15,5,5,23,21,5,5,0,0,2.27,3.03,3.33,2.11,1.71,1,1,0.4113776,0.3081938,0.2804286,1.542327,1.14948,0,-3,0,0,0.3928471,2,0,0,0
"2967","I2",10,"25.01.2020","Yes","Cittadella","Benevento",1,2,12,13,1,6,24,7,6,3,1,0,2.98,3.03,2.46,2,1.79,0,3,0.3130008,0.3078357,0.3791635,1.246838,1.445326,-1,-1,-5,-3,-0.1984883,17,3,1,0
"2968","I2",10,"25.01.2020","Yes","Pisa","Juve Stabia",1,1,20,7,3,3,17,12,3,1,1,1,2.23,2.91,3.6,2.31,1.59,1,1,0.4191523,0.3212061,0.2596416,1.578663,1.100131,0,13,0,0,0.4785322,5,2,0,0
"2969","I2",10,"25.01.2020","Yes","Pordenone","Pescara",0,2,14,19,3,5,17,11,3,2,0,0,1.89,3.3,4.24,1.98,1.81,0,3,0.4954218,0.2837416,0.2208366,1.770007,0.9462514,-2,-5,-2,-3,0.8237556,6,1,0,0
"2970","I2",10,"25.01.2020","Yes","Virtus Entella","Cremonese",1,1,15,16,2,5,14,15,2,4,0,0,2.3,3.02,3.3,2.16,1.68,1,1,0.4067423,0.3097706,0.2834871,1.529998,1.160232,0,-1,-3,0,0.3697657,-1,-2,0,0
"2971","I2",10,"25.01.2020","Yes","Salernitana","Cosenza",2,1,13,9,5,2,21,18,2,2,0,0,2.25,2.92,3.5,2.27,1.61,3,0,0.4143523,0.3192783,0.2663693,1.562335,1.118386,1,4,3,3,0.4439489,3,0,0,0
"2972","I2",10,"26.01.2020","Yes","Crotone","Spezia",1,2,6,11,2,3,18,19,4,4,1,0,1.76,3.36,4.91,1.98,1.81,0,3,0.5312758,0.2782873,0.1904369,1.872115,0.8495981,-1,-5,-1,-3,1.022516,-1,0,1,0
"2973","I2",10,"26.01.2020","Yes","Venezia","Trapani",1,1,4,16,1,7,15,16,2,3,0,0,2.08,3.12,3.7,2.09,1.72,1,1,0.4486661,0.2991108,0.2522231,1.645109,1.05578,0,-12,-6,0,0.589329,-1,-1,0,0
"2974","I2",10,"26.01.2020","Yes","Ascoli","Frosinone",0,1,13,8,2,4,20,18,3,2,0,0,3.2,3.02,2.34,2.04,1.76,0,3,0.2917898,0.3091813,0.3990289,1.184551,1.506268,-1,5,-2,-3,-0.321717,2,1,0,0
"2975","I2",10,"27.01.2020","Yes","Perugia","Livorno",1,0,8,4,2,2,16,24,2,3,0,0,1.82,3.29,4.61,2.04,1.75,3,0,0.5133509,0.2839813,0.2026678,1.824034,0.8919847,1,4,0,3,0.9320492,-8,-1,0,0
"2976","I2",10,"31.01.2020","Yes","Cremonese","Pisa",3,4,14,17,4,8,16,15,4,3,1,0,1.85,3.14,4.74,2.28,1.61,0,3,0.5051864,0.2976417,0.1971719,1.813201,0.8891574,-1,-3,-4,-3,0.9240435,1,1,1,0
"2977","I2",10,"01.02.2020","Yes","Frosinone","Virtus Entella",1,0,10,6,1,0,11,24,2,4,0,0,1.76,3.19,5.31,2.28,1.6,3,0,0.5310183,0.2929756,0.1760061,1.886031,0.8209938,1,4,1,3,1.065037,-13,-2,0,0
"2978","I2",10,"01.02.2020","Yes","Livorno","Ascoli",0,3,17,18,8,9,19,19,2,2,0,0,2.31,3,3.27,2.05,1.74,0,3,0.4038084,0.3109325,0.2852591,1.522358,1.16671,-3,-1,-1,-3,0.3556478,0,0,0,0
"2979","I2",10,"01.02.2020","Yes","Spezia","Pordenone",1,0,12,11,3,1,14,18,2,3,1,0,2.28,2.94,3.41,2.24,1.62,3,0,0.4091432,0.3172947,0.273562,1.544724,1.137981,1,1,2,3,0.4067436,-4,-1,1,0
"2980","I2",10,"01.02.2020","Yes","Trapani","Cittadella",0,3,8,11,1,5,20,17,3,3,0,0,2.79,2.87,2.73,2.18,1.66,0,3,0.3339898,0.32468,0.3413302,1.326649,1.348671,-3,-3,-4,-3,-0.02202131,3,0,0,0
"2981","I2",10,"01.02.2020","Yes","Empoli","Crotone",3,1,17,10,7,5,18,13,3,3,0,0,2.55,2.99,2.88,2.03,1.76,3,0,0.3651955,0.3114543,0.3233502,1.407041,1.281505,2,7,2,3,0.1255359,5,0,0,0
"2982","I2",10,"02.02.2020","Yes","Chievo","Venezia",0,1,7,8,2,7,30,14,4,2,0,0,1.84,3.06,4.97,2.36,1.56,0,3,0.5072207,0.3049954,0.1877839,1.826657,0.8683472,-1,-1,-5,-3,0.9583103,16,2,0,0
"2983","I2",10,"02.02.2020","Yes","Juve Stabia","Perugia",1,2,13,20,2,7,14,24,2,5,0,0,2.67,2.97,2.75,2.06,1.74,0,3,0.3484443,0.3132479,0.3383078,1.358581,1.328171,-1,-7,-5,-3,0.03040969,-10,-3,0,0
"2984","I2",10,"02.02.2020","Yes","Benevento","Salernitana",1,1,16,8,2,2,19,21,3,4,1,0,1.44,4.03,7.66,1.93,1.85,1,1,0.6471195,0.2312288,0.1216517,2.172587,0.5961839,0,8,0,0,1.576403,-2,-1,1,0
"2985","I2",10,"03.02.2020","Yes","Pescara","Cosenza",2,1,8,12,3,4,15,18,5,4,1,2,2.01,3.05,4.07,2.13,1.69,3,0,0.4644954,0.3061101,0.2293945,1.699596,0.9942937,1,-4,-1,3,0.7053026,-3,1,-1,0
"2986","I2",10,"07.02.2020","Yes","Ascoli","Juve Stabia",2,2,14,17,5,6,24,12,2,3,0,0,1.88,3.27,4.3,2,1.79,1,1,0.4969851,0.2857284,0.2172865,1.776684,0.9375879,0,-3,-1,0,0.8390957,12,-1,0,0
"2987","I2",10,"08.02.2020","Yes","Cittadella","Empoli",1,2,14,11,4,5,19,18,2,1,0,0,2.24,3.17,3.24,1.88,1.91,0,3,0.4170172,0.2946746,0.2883082,1.545726,1.159599,-1,3,-1,-3,0.386127,1,1,0,0
"2988","I2",10,"08.02.2020","Yes","Crotone","Cremonese",1,0,14,9,4,4,7,14,1,2,0,0,1.76,3.26,5.21,2.03,1.76,3,0,0.5325695,0.2875222,0.1799083,1.885231,0.8272471,1,5,0,3,1.057984,-7,-1,0,0
"2989","I2",10,"08.02.2020","Yes","Pordenone","Livorno",2,2,23,11,12,4,14,17,4,5,0,0,1.78,3.26,4.98,2.11,1.71,1,1,0.5253641,0.2868552,0.1877807,1.862947,0.8501974,0,12,8,0,1.01275,-3,-1,0,0
"2990","I2",10,"08.02.2020","Yes","Venezia","Frosinone",0,1,15,12,6,2,12,18,2,3,0,0,3.23,2.84,2.44,2.42,1.54,0,3,0.288926,0.3286024,0.3824716,1.19538,1.476017,-1,3,4,-3,-0.2806371,-6,-1,0,0
"2991","I2",10,"08.02.2020","Yes","Perugia","Spezia",0,3,9,12,3,5,16,16,3,2,0,0,2.11,2.96,3.85,2.26,1.61,0,3,0.4423037,0.3152908,0.2424054,1.642202,1.042507,-3,-3,-2,-3,0.5996949,0,1,0,0
"2992","I2",10,"09.02.2020","Yes","Pisa","Chievo",1,1,14,11,6,4,27,22,5,3,1,0,2.75,2.9,2.75,2.34,1.57,1,1,0.3391813,0.3216374,0.3391813,1.339181,1.339181,0,3,2,0,0,5,2,1,0
"2993","I2",10,"09.02.2020","Yes","Virtus Entella","Pescara",2,0,10,7,3,2,16,16,3,3,0,0,2.15,2.98,3.71,2.12,1.7,3,0,0.4345953,0.3135503,0.2518544,1.617336,1.069114,2,3,1,3,0.5482226,0,0,0,0
"2994","I2",10,"09.02.2020","Yes","Cosenza","Benevento",0,1,14,8,8,5,27,12,5,2,0,1,4.06,2.96,2.05,2.29,1.6,0,3,0.2297736,0.3151625,0.4550639,1.004483,1.680354,-1,6,3,-3,-0.6758707,15,3,-1,0
"2995","I2",10,"10.02.2020","Yes","Salernitana","Trapani",1,0,8,11,5,3,16,18,3,3,0,0,1.88,3.21,4.39,2.08,1.72,3,0,0.4965451,0.2908115,0.2126435,1.780447,0.9287418,1,-3,2,3,0.8517049,-2,0,0,0
"2996","I2",10,"11.02.2020","Yes","Spezia","Cremonese",3,2,20,10,10,3,11,20,2,4,0,0,1.96,3.06,4.27,2.43,1.54,3,0,0.476295,0.3050778,0.2186272,1.733963,0.9609594,1,10,7,3,0.7730033,-9,-2,0,0
"2997","I2",10,"14.02.2020","Yes","Pescara","Cittadella",1,2,9,11,5,7,6,25,2,3,0,0,2.65,2.97,2.8,2.12,1.7,0,3,0.3522759,0.3143202,0.3334039,1.371148,1.314532,-1,-2,-2,-3,0.05661576,-19,-1,0,0
"2998","I2",10,"15.02.2020","Yes","Benevento","Pordenone",2,1,16,15,5,5,12,15,1,2,0,0,1.51,3.96,6.39,1.91,1.87,3,0,0.6181922,0.2357248,0.146083,2.090301,0.6739737,1,1,0,3,1.416328,-3,-1,0,0
"2999","I2",10,"15.02.2020","Yes","Juve Stabia","Crotone",3,2,20,19,7,8,18,18,4,3,0,0,3.09,3.01,2.4,2.13,1.69,3,0,0.301743,0.3097628,0.3884942,1.214992,1.475245,1,1,-1,3,-0.2602534,0,1,0,0
"3000","I2",10,"15.02.2020","Yes","Livorno","Cosenza",0,3,7,15,3,5,24,15,2,2,1,0,2.3,2.95,3.34,2.26,1.61,0,3,0.4051398,0.3158717,0.2789885,1.531291,1.152837,-3,-8,-2,-3,0.3784539,9,0,1,0
"3001","I2",10,"15.02.2020","Yes","Venezia","Virtus Entella",2,2,11,15,4,6,14,19,3,2,0,0,2.29,2.95,3.37,2.23,1.63,1,1,0.4071999,0.3160975,0.2767026,1.537697,1.146205,0,-4,-2,0,0.3914919,-5,1,0,0
"3002","I2",10,"15.02.2020","Yes","Spezia","Ascoli",3,1,20,9,7,4,11,16,5,4,0,1,1.9,3.18,4.38,2.1,1.72,3,0,0.4923018,0.2941426,0.2135556,1.771048,0.9348093,2,11,3,3,0.8362387,-5,1,-1,0
"3003","I2",10,"16.02.2020","Yes","Cremonese","Trapani",5,0,17,12,7,2,14,17,2,2,0,1,2.01,2.98,4.17,2.39,1.55,3,0,0.463712,0.3127722,0.2235158,1.703908,0.9833197,5,5,5,3,0.7205884,-3,0,-1,0
"3004","I2",10,"16.02.2020","Yes","Frosinone","Perugia",1,0,6,11,5,1,10,17,3,0,0,0,1.83,3.16,4.77,2.14,1.69,3,0,0.5094862,0.2950505,0.1954633,1.823509,0.8814403,1,-5,4,3,0.9420688,-7,3,0,0
"3005","I2",10,"16.02.2020","Yes","Empoli","Pisa",2,1,15,10,6,4,14,17,2,4,0,0,1.76,3.44,4.71,1.96,1.82,3,0,0.5304193,0.2713773,0.1982034,1.862635,0.8659875,1,5,2,3,0.9966477,-3,-2,0,0
"3006","I2",10,"17.02.2020","Yes","Chievo","Salernitana",2,0,9,16,2,3,13,16,4,2,0,0,2.03,3.09,3.9,2.1,1.71,3,0,0.4592484,0.3017069,0.2390447,1.679452,1.018841,2,-7,-1,3,0.6606112,-3,2,0,0
"3007","I2",10,"21.02.2020","Yes","Cosenza","Frosinone",0,2,15,13,4,3,17,13,3,3,0,0,3.06,2.73,2.64,2.72,1.44,0,3,0.3048808,0.3417346,0.3533846,1.256377,1.401888,-2,2,1,-3,-0.1455113,4,0,0,0
"3008","I2",10,"22.02.2020","Yes","Cittadella","Juve Stabia",3,0,26,4,11,2,21,6,4,2,0,0,1.7,3.63,4.81,1.84,1.94,3,0,0.5489228,0.2570713,0.194006,1.90384,0.8390892,3,22,9,3,1.06475,15,2,0,0
"3009","I2",10,"22.02.2020","Yes","Trapani","Spezia",1,1,9,13,4,4,18,16,4,1,1,0,2.89,2.98,2.57,2.16,1.68,1,1,0.3231736,0.3134133,0.3634131,1.282934,1.403653,0,-4,0,0,-0.1207185,2,3,1,0
"3010","I2",10,"22.02.2020","Yes","Virtus Entella","Benevento",0,4,5,6,3,3,16,8,1,0,0,0,3.58,3.04,2.16,2.1,1.71,0,3,0.2607535,0.3070716,0.4321749,1.089332,1.603596,-4,-1,0,-3,-0.5142639,8,1,0,0
"3011","I2",10,"22.02.2020","Yes","Pisa","Venezia",1,2,17,9,5,5,13,20,0,3,0,0,2.27,2.9,3.49,2.33,1.58,0,3,0.4109834,0.3217008,0.2673158,1.554651,1.123648,-1,8,0,-3,0.4310026,-7,-3,0,0
"3012","I2",10,"23.02.2020","Yes","Pordenone","Chievo",0,1,14,5,3,2,19,11,2,4,0,0,2.27,2.95,3.41,2.15,1.68,0,3,0.4106471,0.3159895,0.2733634,1.547931,1.13608,-1,9,1,-3,0.4118514,8,-2,0,0
"3013","I2",10,"23.02.2020","Yes","Salernitana","Livorno",1,0,15,9,3,1,18,14,3,2,0,0,1.84,3.18,4.72,1.97,1.82,3,0,0.5080147,0.2939456,0.1980396,1.81799,0.8880646,1,6,2,3,0.9299253,4,1,0,0
"3014","I2",10,"23.02.2020","Yes","Crotone","Pescara",4,1,16,16,9,5,18,11,3,2,0,1,1.72,3.37,5.22,1.9,1.87,3,0,0.5435114,0.2774005,0.1790881,1.907935,0.8146647,3,0,4,3,1.09327,7,1,-1,0
"3015","I2",10,"24.02.2020","Yes","Perugia","Empoli",0,1,15,8,1,3,23,17,2,4,0,0,2.37,2.97,3.17,1.97,1.8,0,3,0.3928326,0.3134724,0.293695,1.49197,1.194557,-1,7,-2,-3,0.2974127,6,-2,0,0
"3016","I2",10,"28.02.2020","Yes","Virtus Entella","Crotone",1,2,16,8,4,3,24,11,3,1,1,0,2.92,3.04,2.5,1.94,1.84,0,3,0.3196393,0.307022,0.3733387,1.26594,1.427038,-1,8,1,-3,-0.1610982,13,2,1,0
"3017","I2",10,"29.02.2020","Yes","Benevento","Spezia",3,1,13,8,7,5,14,21,4,4,0,1,1.73,3.43,4.99,2,1.79,3,0,0.5402291,0.2724771,0.1872939,1.893164,0.8343586,2,5,2,3,1.058806,-7,0,-1,0
"3018","I2",10,"29.02.2020","Yes","Cittadella","Cremonese",0,0,10,10,3,1,15,7,3,2,0,0,1.99,3.26,3.85,1.95,1.83,1,1,0.4700767,0.2869486,0.2429747,1.697179,1.015873,0,0,2,0,0.6813059,8,1,0,0
"3019","I2",10,"29.02.2020","Yes","Empoli","Pordenone",0,1,20,14,6,4,15,9,2,2,0,0,1.87,3.32,4.26,1.87,1.92,0,3,0.4994456,0.2813142,0.2192402,1.779651,0.9390348,-1,6,2,-3,0.8406161,6,0,0,0
"3020","I2",10,"29.02.2020","Yes","Juve Stabia","Trapani",2,2,14,14,5,4,9,20,2,5,0,0,2.22,3.01,3.46,2.13,1.69,1,1,0.4203164,0.3100008,0.2696828,1.57095,1.119049,0,0,1,0,0.4519009,-11,-3,0,0
"3021","I2",10,"29.02.2020","Yes","Pisa","Perugia",1,0,17,10,8,0,18,20,2,1,1,0,2.54,3,2.91,2.23,1.63,3,0,0.3677121,0.3113296,0.3209583,1.414466,1.274205,1,7,8,3,0.1402613,-2,1,1,0
"3022","I2",10,"29.02.2020","Yes","Venezia","Cosenza",1,1,14,12,5,4,19,22,2,1,0,0,2.4,2.91,3.21,2.38,1.56,1,1,0.3887412,0.3206113,0.2906476,1.486835,1.192554,0,2,1,0,0.2942807,-3,1,0,0
"3023","I2",10,"29.02.2020","Yes","Chievo","Livorno",0,1,14,9,3,3,14,21,1,4,0,0,1.77,3.26,5.02,2.08,1.73,0,3,0.5275557,0.2864336,0.1860107,1.869101,0.8444656,-1,5,0,-3,1.024635,-7,-3,0,0
"3024","I2",10,"29.02.2020","Yes","Frosinone","Salernitana",1,0,10,5,2,0,13,27,3,3,0,0,1.79,3.31,4.78,2.19,1.66,3,0,0.5221216,0.2823558,0.1955225,1.848721,0.8689234,1,5,2,3,0.9797973,-14,0,0,0
"3025","I2",10,"01.03.2020","Yes","Pescara","Ascoli",2,1,24,12,7,2,14,23,1,6,0,0,2.07,3.15,3.67,1.94,1.84,3,0,0.4502121,0.2958536,0.2539343,1.64649,1.057657,1,12,5,3,0.5888332,-9,-5,0,0
"3026","I2",10,"03.03.2020","Yes","Cosenza","Cittadella",1,2,15,15,5,5,13,13,2,2,0,0,2.58,2.95,2.91,2.19,1.66,0,3,0.3621648,0.3167407,0.3210945,1.403235,1.280024,-1,0,0,-3,0.1232107,0,0,0,0
"3027","I2",10,"03.03.2020","Yes","Cremonese","Empoli",2,3,16,16,8,8,9,9,1,1,0,0,2.47,3.08,2.93,2.08,1.73,0,3,0.3780788,0.3031995,0.3187217,1.437436,1.259365,-1,0,0,-3,0.1780712,0,0,0,0
"3028","I2",10,"03.03.2020","Yes","Crotone","Pisa",1,0,5,5,2,2,21,21,6,6,1,1,1.57,3.71,6.25,1.86,1.93,3,0,0.5972358,0.2527386,0.1500256,2.044446,0.7028155,1,0,0,3,1.34163,0,0,0,0
"3029","I2",10,"03.03.2020","Yes","Livorno","Frosinone",2,2,17,17,7,7,12,12,2,2,0,0,3.42,3.02,2.24,2.37,1.57,1,1,0.2732811,0.3094773,0.4172417,1.129321,1.561202,0,0,0,0,-0.4318817,0,0,0,0
"3030","I2",10,"03.03.2020","Yes","Perugia","Benevento",1,2,19,19,6,6,14,14,0,0,0,0,3.36,2.99,2.29,2.23,1.64,0,3,0.2784744,0.3129344,0.4085912,1.148358,1.538708,-1,0,0,-3,-0.3903505,0,0,0,0
"3031","I2",10,"03.03.2020","Yes","Pordenone","Juve Stabia",2,1,12,12,2,2,14,14,5,5,0,0,1.77,3.52,4.55,1.97,1.82,3,0,0.5285826,0.265793,0.2056244,1.851541,0.8826663,1,0,0,3,0.9688745,0,0,0,0
"3032","I2",10,"03.03.2020","Yes","Salernitana","Venezia",2,0,21,21,4,4,9,9,3,3,1,1,2.07,3.04,3.9,2.33,1.59,3,0,0.4521429,0.3078736,0.2399835,1.664302,1.027824,2,0,0,3,0.636478,0,0,0,0
"3033","I2",10,"03.03.2020","Yes","Trapani","Virtus Entella",4,1,11,11,3,3,16,16,2,2,0,0,2.4,3.03,3.09,2.12,1.71,3,0,0.3892901,0.3083486,0.3023613,1.476219,1.215432,3,0,0,3,0.2607866,0,0,0,0
"3034","I2",10,"04.03.2020","No","Ascoli","Chievo",1,1,12,14,5,4,14,10,2,3,0,0,2.71,2.91,2.78,2.15,1.68,1,1,0.3441048,0.320455,0.3354403,1.352769,1.326776,0,-2,1,0,0.02599353,4,-1,0,0
"3035","I2",10,"04.03.2020","No","Spezia","Pescara",2,0,14,6,7,0,11,13,1,4,0,0,1.72,3.33,5.39,2.03,1.76,3,0,0.5447733,0.2813844,0.1738423,1.915704,0.8029113,2,8,7,3,1.112793,-2,-3,0,0
"3036","I2",10,"07.03.2020","No","Cittadella","Pordenone",0,2,15,8,3,3,17,17,1,2,1,0,2.01,3.27,3.76,1.95,1.83,0,3,0.4652779,0.2859965,0.2487257,1.68183,1.032173,-2,7,0,-3,0.6496566,0,-1,1,0
"3037","I2",10,"07.03.2020","No","Empoli","Trapani",1,1,10,14,4,5,11,12,2,2,0,0,1.8,3.41,4.55,1.84,1.95,1,1,0.5198955,0.2744316,0.2056729,1.834118,0.8914504,0,-4,-1,0,0.9426676,-1,0,0,0
"3038","I2",10,"07.03.2020","No","Frosinone","Cremonese",0,2,10,11,4,6,8,15,2,2,1,0,1.68,3.36,5.67,2.22,1.64,0,3,0.556701,0.2783505,0.1649485,1.948454,0.7731959,-2,-1,-2,-3,1.175258,-7,0,1,0
"3039","I2",10,"07.03.2020","No","Perugia","Salernitana",1,0,13,4,5,3,20,23,2,4,0,0,2.19,2.94,3.66,2.38,1.56,3,0,0.4267561,0.3178898,0.2553541,1.598158,1.083952,1,9,2,3,0.5142062,-3,-2,0,0
"3040","I2",10,"07.03.2020","No","Venezia","Crotone",1,3,11,10,3,5,11,23,1,3,0,0,3.36,3.14,2.21,1.95,1.83,0,3,0.2785185,0.2980325,0.423449,1.133588,1.568379,-2,1,-2,-3,-0.4347913,-12,-2,0,0
"3041","I2",10,"07.03.2020","No","Pisa","Livorno",1,0,16,15,3,3,14,19,1,3,0,0,2.15,3.04,3.6,2.22,1.63,3,0,0.4339413,0.3068993,0.2591594,1.608723,1.084377,1,1,0,3,0.5243458,-5,-2,0,0
"3042","I2",10,"08.03.2020","No","Juve Stabia","Spezia",3,1,10,16,4,4,11,19,3,3,0,0,3.22,3.18,2.25,1.94,1.84,3,0,0.2903862,0.2940389,0.4155749,1.165197,1.540764,2,-6,0,3,-0.3755662,-8,0,0,0
"3043","I2",10,"08.03.2020","No","Virtus Entella","Ascoli",3,0,20,11,8,5,14,14,2,2,0,0,2.11,3.23,3.49,1.86,1.92,3,0,0.4429021,0.2893261,0.2677718,1.618032,1.092641,3,9,3,3,0.525391,0,0,0,0
"3044","I2",10,"08.03.2020","No","Benevento","Pescara",4,0,16,12,9,8,7,7,2,0,0,0,1.49,4.08,6.43,1.71,2.11,3,0,0.6262045,0.2286874,0.145108,2.107301,0.6640116,4,4,1,3,1.443289,0,2,0,0
"3045","I2",10,"09.03.2020","No","Chievo","Cosenza",2,0,14,12,5,1,18,19,3,2,0,0,1.99,2.98,4.29,2.35,1.56,3,0,0.4691191,0.3132708,0.21761,1.720628,0.9661009,2,2,4,3,0.7545273,-1,1,0,0
"3046","I2",10,"17.06.2020","No","Ascoli","Cremonese",1,3,12,14,6,7,16,16,3,3,0,0,2.42,3.03,3.05,2.12,1.7,0,3,0.3857842,0.3081181,0.3060977,1.465471,1.226411,-2,-2,-1,-3,0.2390597,0,0,0,0
"3047","I2",10,"19.06.2020","No","Spezia","Empoli",1,0,10,10,4,4,12,15,1,1,0,0,2.39,3.07,3.09,2.21,1.65,3,0,0.391855,0.3050598,0.3030853,1.480625,1.214316,1,0,0,3,0.2663092,-3,0,0,0
"3048","I2",10,"20.06.2020","No","Cosenza","Virtus Entella",2,1,16,19,11,10,25,13,3,2,1,0,2.5,3.01,2.97,2.22,1.64,3,0,0.3742073,0.3108034,0.3149893,1.433425,1.255771,1,-3,1,3,0.177654,12,1,1,0
"3049","I2",10,"20.06.2020","No","Crotone","Chievo",1,1,7,16,3,2,14,24,3,2,0,0,1.93,3.28,4.06,1.99,1.81,1,1,0.4845468,0.2851144,0.2303388,1.738755,0.9761307,0,-9,1,0,0.7626242,-10,1,0,0
"3050","I2",10,"20.06.2020","No","Livorno","Cittadella",0,2,8,17,3,5,8,16,0,2,0,0,3.09,3.03,2.4,2.18,1.67,0,3,0.3023613,0.3083486,0.3892901,1.215432,1.476219,-2,-9,-2,-3,-0.2607866,-8,-2,0,0
"3051","I2",10,"20.06.2020","No","Pescara","Juve Stabia",3,1,17,7,5,3,12,10,2,2,0,0,2.2,3.06,3.46,2.02,1.77,3,0,0.4246659,0.3053153,0.2700188,1.579313,1.115372,2,10,2,3,0.4639413,2,0,0,0
"3052","I2",10,"20.06.2020","No","Salernitana","Pisa",1,1,9,15,1,3,23,13,5,2,0,0,1.99,3.18,3.95,2.16,1.68,1,1,0.4695754,0.2938538,0.2365709,1.70258,1.003566,0,-6,-2,0,0.6990134,10,3,0,0
"3053","I2",10,"20.06.2020","No","Trapani","Frosinone",0,0,6,5,0,2,24,11,3,2,0,0,3.07,2.97,2.45,2.26,1.62,1,1,0.3042537,0.3144979,0.3812485,1.227259,1.458243,0,1,-2,0,-0.2309844,13,1,0,0
"3054","I2",10,"20.06.2020","No","Pordenone","Venezia",0,0,7,16,2,3,11,13,4,2,1,0,1.93,3.16,4.28,2.25,1.63,1,1,0.485038,0.2962416,0.2187204,1.751356,0.9524028,0,-9,-1,0,0.7989528,-2,2,1,0
"3055","I2",10,"21.06.2020","No","Cremonese","Benevento",0,1,16,8,5,2,15,16,2,2,0,0,3.32,3.13,2.22,2,1.79,0,3,0.2811992,0.2982688,0.4205321,1.141866,1.559865,-1,8,3,-3,-0.4179988,-1,0,0,0
"3056","I2",10,"21.06.2020","No","Ascoli","Perugia",0,1,12,14,2,3,20,17,4,2,0,0,2.58,3.03,2.83,2.09,1.73,0,3,0.3619063,0.3081579,0.3299358,1.393877,1.297965,-1,-2,-1,-3,0.09591157,3,2,0,0
"3057","I2",10,"26.06.2020","No","Trapani","Pordenone",3,0,16,10,6,1,19,17,2,3,0,0,2.46,3.08,2.95,2.02,1.78,3,0,0.3798527,0.3033888,0.3167585,1.442947,1.253664,3,6,5,3,0.1892825,2,-1,0,0
"3058","I2",10,"26.06.2020","No","Chievo","Spezia",1,3,10,15,2,6,14,17,1,2,0,0,2.41,2.96,3.16,2.39,1.57,0,3,0.3880711,0.3159633,0.2959656,1.480177,1.20386,-2,-5,-4,-3,0.2763164,-3,-1,0,0
"3059","I2",10,"26.06.2020","No","Cremonese","Cosenza",0,2,20,13,2,5,21,14,1,3,0,1,2.18,3.06,3.54,2.23,1.65,0,3,0.4295094,0.3059904,0.2645002,1.594519,1.099491,-2,7,-3,-3,0.4950278,7,-2,-1,0
"3060","I2",10,"26.06.2020","No","Empoli","Benevento",0,0,11,13,4,4,17,15,2,1,0,0,2.89,3.14,2.47,1.93,1.86,1,1,0.3235803,0.2978176,0.3786021,1.268559,1.433624,0,-2,0,0,-0.1650653,2,1,0,0
"3061","I2",10,"26.06.2020","No","Frosinone","Cittadella",0,2,21,10,9,3,17,24,2,7,0,0,2.19,2.94,3.67,2.5,1.52,0,3,0.4270533,0.3181111,0.2548356,1.599271,1.082618,-2,11,6,-3,0.516653,-7,-5,0,0
"3062","I2",10,"26.06.2020","No","Juve Stabia","Livorno",2,3,19,11,3,3,22,27,6,2,2,1,2.19,3.2,3.35,1.98,1.82,0,3,0.4276965,0.2927048,0.2795986,1.575794,1.131501,-1,8,0,-3,0.4442937,-5,4,1,0
"3063","I2",10,"26.06.2020","No","Perugia","Crotone",0,0,7,16,5,5,14,16,3,3,1,0,2.82,3.07,2.57,1.99,1.8,1,1,0.3315822,0.3045804,0.3638373,1.299327,1.396092,0,-9,0,0,-0.09676525,-2,0,1,0
"3064","I2",10,"26.06.2020","No","Pisa","Pescara",2,1,13,8,4,3,16,20,2,6,0,1,2.33,3.12,3.12,1.97,1.82,3,0,0.4010283,0.2994859,0.2994859,1.502571,1.197943,1,5,1,3,0.3046272,-4,-4,-1,0
"3065","I2",10,"26.06.2020","No","Venezia","Ascoli",2,1,14,16,3,6,12,17,2,4,0,0,2.18,3.18,3.39,1.99,1.81,3,0,0.4294421,0.2943974,0.2761604,1.582724,1.122879,1,-2,-3,3,0.4598451,-5,-2,0,0
"3066","I2",10,"26.06.2020","No","Virtus Entella","Salernitana",1,0,9,7,5,2,16,18,2,3,0,0,2.22,3.11,3.38,2.1,1.72,3,0,0.4218286,0.3011124,0.277059,1.566598,1.132289,1,2,3,3,0.4343087,-2,-1,0,0
"3067","I2",10,"29.06.2020","No","Salernitana","Cremonese",3,3,14,13,5,9,19,16,3,3,1,1,2.47,3.03,2.98,2.16,1.68,1,1,0.378209,0.308309,0.313482,1.442936,1.248755,0,1,-4,0,0.1941811,3,0,0,0
"3068","I2",10,"29.06.2020","No","Ascoli","Crotone",1,1,6,18,2,3,14,14,4,2,0,0,3.45,3.39,2.06,1.74,2.08,1,1,0.2708224,0.2756157,0.4535618,1.088083,1.636301,0,-12,-1,0,-0.5482182,0,2,0,0
"3069","I2",10,"29.06.2020","No","Benevento","Juve Stabia",1,0,10,10,3,3,9,15,2,2,1,0,1.47,3.85,7.71,1.81,1.99,3,0,0.6359383,0.2428128,0.1212489,2.150628,0.6065596,1,0,0,3,1.544068,-6,0,1,0
"3070","I2",10,"29.06.2020","No","Chievo","Frosinone",2,0,17,8,7,1,13,18,3,1,0,0,2.54,2.88,3.05,2.48,1.53,3,0,0.3683606,0.3248736,0.3067659,1.429955,1.245171,2,9,6,3,0.1847842,-5,2,0,0
"3071","I2",10,"29.06.2020","No","Cittadella","Perugia",2,0,11,11,1,4,15,18,3,2,0,0,2.04,3.19,3.77,2.15,1.69,3,0,0.4585868,0.2932655,0.2481477,1.669026,1.037709,2,0,-3,3,0.631317,-3,1,0,0
"3072","I2",10,"29.06.2020","No","Cosenza","Trapani",2,2,10,8,8,5,16,15,3,4,0,1,2.33,3.02,3.24,2.17,1.67,1,1,0.4015002,0.3097667,0.2887331,1.514267,1.175966,0,2,3,0,0.3383011,1,-1,-1,0
"3073","I2",10,"29.06.2020","No","Livorno","Venezia",0,2,13,12,2,5,18,16,1,1,0,0,2.64,2.98,2.83,2.18,1.67,0,3,0.3547649,0.3142884,0.3309468,1.378583,1.307129,-2,1,-3,-3,0.07145441,2,0,0,0
"3074","I2",10,"29.06.2020","No","Pescara","Empoli",1,1,14,10,3,3,8,21,2,2,0,0,2.91,3.25,2.39,1.77,2.04,1,1,0.3212379,0.2876315,0.3911306,1.251345,1.461023,0,4,0,0,-0.2096783,-13,0,0,0
"3075","I2",10,"29.06.2020","No","Pordenone","Virtus Entella",2,0,13,17,5,3,17,16,3,3,0,0,2.42,3.17,2.96,1.91,1.88,3,0,0.3874506,0.2957824,0.316767,1.458134,1.246083,2,-4,2,3,0.2120506,1,0,0,0
"3076","I2",10,"29.06.2020","No","Spezia","Pisa",1,2,12,8,2,4,15,10,4,0,0,0,1.88,3.34,4.23,2.03,1.78,0,3,0.498177,0.280411,0.221412,1.774942,0.944647,-1,4,-2,-3,0.830295,5,4,0,0
"3077","I2",10,"03.07.2020","No","Pisa","Cittadella",2,0,6,14,4,2,17,12,4,2,0,0,3.17,3,2.38,2.17,1.68,3,0,0.2951072,0.3118299,0.3930629,1.197151,1.491019,2,-8,2,3,-0.2938672,5,2,0,0
"3078","I2",10,"03.07.2020","No","Cosenza","Ascoli",0,1,15,9,6,5,13,20,2,3,0,0,2.1,3.14,3.64,2.14,1.69,0,3,0.4452929,0.2978074,0.2568997,1.633686,1.068507,-1,6,1,-3,0.5651794,-7,-1,0,0
"3079","I2",10,"03.07.2020","No","Cremonese","Pescara",1,0,9,14,2,4,19,11,2,2,0,0,2.17,3.11,3.49,2.13,1.7,3,0,0.4311226,0.3008155,0.2680619,1.594183,1.105001,1,-5,-2,3,0.4891821,8,0,0,0
"3080","I2",10,"03.07.2020","No","Crotone","Benevento",3,0,7,11,4,2,12,12,3,5,0,0,1.77,3.5,4.59,1.94,1.85,3,0,0.528727,0.2673848,0.2038882,1.853566,0.8790494,3,-4,2,3,0.9745164,0,-2,0,0
"3081","I2",10,"03.07.2020","No","Frosinone","Spezia",2,1,12,6,3,0,13,15,1,2,0,0,2.48,2.84,3.19,2.5,1.52,3,0,0.3772633,0.3294412,0.2932956,1.461231,1.209328,1,6,3,3,0.2519031,-2,-1,0,0
"3082","I2",10,"03.07.2020","No","Perugia","Pordenone",1,2,13,9,1,4,16,15,4,4,1,0,2.24,3.02,3.45,2.33,1.58,0,3,0.4182355,0.3102144,0.27155,1.564921,1.124865,-1,4,-3,-3,0.4400565,1,0,1,0
"3083","I2",10,"03.07.2020","No","Salernitana","Juve Stabia",2,1,13,18,6,6,14,23,4,7,2,0,2.07,3.16,3.72,2.08,1.73,3,0,0.4521787,0.2962057,0.2516156,1.652742,1.051052,1,-5,0,3,0.6016894,-9,-3,2,0
"3084","I2",10,"03.07.2020","No","Venezia","Empoli",0,2,13,17,3,10,20,11,1,2,0,0,2.82,2.94,2.67,2.19,1.67,0,3,0.331635,0.3180989,0.3502662,1.313004,1.368897,-2,-4,-7,-3,-0.05589354,9,-1,0,0
"3085","I2",10,"03.07.2020","No","Virtus Entella","Chievo",1,1,13,21,5,9,15,15,3,2,0,0,3.06,3,2.44,2.16,1.68,1,1,0.3054276,0.3115362,0.3830363,1.227819,1.460645,0,-8,-4,0,-0.232826,0,1,0,0
"3086","I2",10,"10.07.2020","No","Juve Stabia","Virtus Entella",1,1,8,13,0,5,12,10,1,1,1,1,2.79,3.19,2.52,1.87,1.91,1,1,0.3353734,0.2933203,0.3713063,1.299441,1.407239,0,-5,-5,0,-0.1077986,2,0,0,0
"3087","I2",10,"10.07.2020","No","Ascoli","Salernitana",3,2,11,18,5,7,17,18,3,2,0,0,2.32,3.26,3.04,1.96,1.83,3,0,0.4040707,0.2875595,0.3083698,1.499772,1.212669,1,-7,-2,3,0.2871029,-1,1,0,0
"3088","I2",10,"10.07.2020","No","Benevento","Venezia",1,1,12,8,3,3,19,17,1,3,0,0,1.98,3.32,3.82,2.07,1.74,1,1,0.472878,0.2820176,0.2451043,1.700652,1.017331,0,4,0,0,0.6833212,2,-2,0,0
"3089","I2",10,"10.07.2020","No","Chievo","Trapani",1,1,21,22,8,7,14,16,2,3,0,0,2.01,3.22,3.86,2.11,1.71,1,1,0.4662116,0.2910203,0.2427682,1.689655,1.019325,0,-1,1,0,0.6703301,-2,-1,0,0
"3090","I2",10,"10.07.2020","No","Cittadella","Crotone",1,3,10,14,6,6,16,15,4,3,0,0,2.54,3.14,2.79,1.89,1.9,0,3,0.3677401,0.2974713,0.3347885,1.400692,1.301837,-2,-4,0,-3,0.09885488,1,1,0,0
"3091","I2",10,"10.07.2020","No","Empoli","Frosinone",2,0,12,19,3,3,16,17,2,3,0,1,2.44,3.04,3.03,2.16,1.68,3,0,0.3834485,0.3077679,0.3087836,1.458113,1.234119,2,-7,0,3,0.2239947,-1,-1,-1,0
"3092","I2",10,"10.07.2020","No","Livorno","Cremonese",1,2,3,19,1,7,10,12,1,2,0,0,6.06,4.57,1.48,1.8,2.02,0,3,0.1557479,0.2065278,0.6377243,0.6737714,2.119701,-1,-16,-6,-3,-1.445929,-2,-1,0,0
"3093","I2",10,"10.07.2020","No","Pescara","Perugia",2,2,10,12,4,3,13,15,2,4,0,0,2.37,3.2,2.98,1.96,1.84,1,1,0.3943331,0.292053,0.3136139,1.475052,1.232895,0,-2,1,0,0.2421576,-2,-2,0,0
"3094","I2",10,"10.07.2020","No","Pordenone","Pisa",1,0,13,18,2,5,19,12,3,0,0,0,2.43,3.02,3.06,2.21,1.66,3,0,0.3847999,0.3096237,0.3055764,1.464023,1.226353,1,-5,-3,3,0.2376705,7,3,0,0
"3095","I2",10,"10.07.2020","No","Spezia","Cosenza",5,1,15,6,6,4,11,12,2,3,0,0,1.93,3.29,4.11,2.02,1.78,3,0,0.4863311,0.2852945,0.2283744,1.744288,0.9704178,4,9,2,3,0.7738699,-1,-1,0,0
"3096","I2",10,"13.07.2020","No","Cosenza","Perugia",2,1,16,15,3,3,15,16,2,1,0,0,2.67,3.05,2.72,2.06,1.75,3,0,0.3500141,0.3064058,0.3435801,1.356448,1.337146,1,1,0,3,0.01930225,-1,1,0,0
"3097","I2",10,"13.07.2020","No","Ascoli","Empoli",1,0,12,13,3,4,24,16,5,2,0,0,3.03,3.19,2.35,1.88,1.91,3,0,0.3087177,0.2932335,0.3980488,1.219387,1.48738,1,-1,-1,3,-0.2679933,8,3,0,0
"3098","I2",10,"13.07.2020","No","Cremonese","Chievo",1,0,9,8,4,1,17,8,1,2,0,0,2.65,2.94,2.84,2.16,1.68,3,0,0.352801,0.3180009,0.3291981,1.376404,1.305595,1,1,3,3,0.07080865,9,-1,0,0
"3099","I2",10,"13.07.2020","No","Crotone","Pordenone",1,0,8,14,4,2,16,20,1,3,0,0,1.63,3.67,5.47,1.93,1.85,3,0,0.5740097,0.2549417,0.1710486,1.976971,0.7680875,1,-6,2,3,1.208883,-4,-2,0,0
"3100","I2",10,"13.07.2020","No","Frosinone","Juve Stabia",2,2,12,12,4,7,16,19,3,5,1,0,1.6,3.69,5.8,2.15,1.69,1,1,0.5849779,0.2536489,0.1613732,2.008583,0.7377685,0,0,-3,0,1.270814,-3,-2,1,0
"3101","I2",10,"13.07.2020","No","Salernitana","Cittadella",4,1,17,6,6,1,18,20,1,1,0,0,2.61,3.01,2.82,2.02,1.78,3,0,0.3580839,0.310498,0.3314181,1.38475,1.304752,3,11,5,3,0.07999747,-2,0,0,0
"3102","I2",10,"13.07.2020","No","Trapani","Benevento",2,0,11,13,5,2,17,17,1,3,0,0,2.41,3.12,3,1.98,1.81,3,0,0.3882335,0.2998855,0.3118809,1.464586,1.235528,2,-2,3,3,0.2290578,0,-2,0,0
"3103","I2",10,"13.07.2020","No","Venezia","Pescara",1,1,14,8,3,4,24,7,6,2,1,1,2.57,3.03,2.85,2.02,1.78,1,1,0.3636444,0.3084377,0.3279179,1.399371,1.292191,0,6,-1,0,0.1071794,17,4,0,0
"3104","I2",10,"13.07.2020","No","Virtus Entella","Pisa",1,1,14,11,5,4,10,16,2,3,0,0,2.47,2.94,3.06,2.26,1.63,1,1,0.3777397,0.3173527,0.3049075,1.450572,1.232075,0,3,1,0,0.2184965,-6,-1,0,0
"3105","I2",10,"17.07.2020","No","Pescara","Frosinone",1,1,14,12,8,3,18,31,2,2,0,0,2.95,2.95,2.54,2.13,1.7,1,1,0.3163138,0.3163138,0.3673724,1.265255,1.418431,0,2,5,0,-0.1531756,-13,0,0,0
"3106","I2",10,"17.07.2020","No","Cittadella","Ascoli",1,2,13,9,4,4,19,18,4,5,0,0,1.88,3.33,4.21,1.99,1.8,0,3,0.4972353,0.2807214,0.2220433,1.772427,0.9468513,-1,4,0,-3,0.8255759,1,-1,0,0
"3107","I2",10,"17.07.2020","No","Crotone","Salernitana",1,1,17,6,6,1,13,27,0,5,0,1,1.74,3.42,4.96,1.98,1.82,1,1,0.5377563,0.2735953,0.1886484,1.886864,0.8395405,0,11,5,0,1.047324,-14,-5,-1,0
"3108","I2",10,"17.07.2020","No","Empoli","Virtus Entella",2,4,15,18,4,9,12,17,2,3,2,0,1.91,3.31,4.12,2.04,1.77,0,3,0.4900444,0.2827749,0.2271808,1.752908,0.9643172,-2,-3,-5,-3,0.7885908,-5,-1,2,0
"3109","I2",10,"17.07.2020","No","Juve Stabia","Chievo",3,2,15,11,4,2,13,20,3,3,1,0,3.52,3.14,2.14,2.05,1.76,3,0,0.2655423,0.2976779,0.4367798,1.094305,1.608017,1,4,2,3,-0.5137126,-7,0,1,0
"3110","I2",10,"17.07.2020","No","Perugia","Cremonese",0,0,9,13,5,8,11,12,1,2,0,0,2.26,3.03,3.37,2.22,1.65,1,1,0.413822,0.3086593,0.2775186,1.550125,1.141215,0,-4,-3,0,0.4089102,-1,-1,0,0
"3111","I2",10,"17.07.2020","No","Pisa","Trapani",3,2,16,10,5,4,20,20,7,4,0,1,2.48,3.11,2.89,2.02,1.78,3,0,0.3765685,0.3002862,0.3231453,1.429992,1.269722,1,6,1,3,0.1602697,0,3,-1,0
"3112","I2",10,"17.07.2020","No","Pordenone","Cosenza",1,2,21,10,4,4,11,15,1,1,0,0,2.06,3.16,3.73,2.14,1.69,0,3,0.453684,0.295756,0.25056,1.656808,1.047436,-1,11,0,-3,0.6093718,-4,0,0,0
"3113","I2",10,"17.07.2020","No","Spezia","Venezia",0,1,28,6,7,2,16,15,2,2,0,0,1.69,3.42,5.46,2.19,1.67,0,3,0.5544233,0.2739694,0.1716072,1.937239,0.7887911,-1,22,5,-3,1.148448,1,0,0,0
"3114","I2",10,"24.07.2020","No","Ascoli","Pordenone",2,2,19,14,7,5,16,10,3,2,0,0,2.52,2.99,2.92,2.01,1.79,1,1,0.3695733,0.3114799,0.3189468,1.4202,1.26832,0,5,2,0,0.1518794,6,1,0,0
"3115","I2",10,"24.07.2020","No","Chievo","Cittadella",4,1,17,5,8,3,10,10,1,4,0,1,2.26,3.04,3.32,2.07,1.74,3,0,0.4125168,0.3066736,0.2808096,1.544224,1.149102,3,12,5,3,0.3951215,0,-3,-1,0
"3116","I2",10,"24.07.2020","No","Cosenza","Pisa",2,1,14,12,4,5,10,17,3,2,0,0,2.39,2.98,3.15,2.14,1.69,3,0,0.3905116,0.3131955,0.2962929,1.48473,1.202074,1,2,-1,3,0.282656,-7,1,0,0
"3117","I2",10,"24.07.2020","No","Cremonese","Spezia",0,0,6,11,1,7,17,11,3,0,0,0,3.02,2.78,2.63,2.36,1.58,1,1,0.3091553,0.335845,0.3549997,1.263311,1.400844,0,-5,-6,0,-0.137533,6,3,0,0
"3118","I2",10,"24.07.2020","No","Frosinone","Benevento",2,3,15,18,4,5,19,17,2,3,0,0,1.75,3.46,4.77,2.09,1.72,0,3,0.5340007,0.2700871,0.1959122,1.872089,0.8578237,-1,-3,-1,-3,1.014266,2,-1,0,0
"3119","I2",10,"24.07.2020","No","Salernitana","Empoli",2,4,16,16,5,10,18,16,1,2,1,0,2.37,3.13,3.03,1.95,1.84,0,3,0.393799,0.2981801,0.308021,1.479577,1.222243,-2,0,-5,-3,0.257334,2,-1,1,0
"3120","I2",10,"24.07.2020","No","Trapani","Pescara",1,0,14,20,7,8,20,14,3,2,0,1,2.31,3.14,3.12,1.93,1.86,3,0,0.4038685,0.2971135,0.299018,1.508719,1.194168,1,-6,-1,3,0.3145514,6,1,-1,0
"3121","I2",10,"24.07.2020","No","Venezia","Juve Stabia",1,0,9,9,5,2,19,14,3,3,0,0,2.13,2.99,3.76,2.15,1.69,3,0,0.4388151,0.3126008,0.2485841,1.629046,1.058353,1,0,3,3,0.5706931,5,0,0,0
"3122","I2",10,"24.07.2020","No","Virtus Entella","Perugia",0,2,20,7,4,3,18,16,2,2,0,0,2.69,2.97,2.76,2.13,1.7,0,3,0.3471786,0.314448,0.3383734,1.355984,1.329568,-2,13,1,-3,0.02641577,2,0,0,0
"3123","I2",10,"27.07.2020","No","Benevento","Chievo",0,1,21,8,6,2,13,18,2,0,0,0,2.75,3.21,2.52,1.88,1.9,0,3,0.3392167,0.2906062,0.370177,1.308256,1.401137,-1,13,4,-3,-0.09288078,-5,2,0,0
"3124","I2",10,"27.07.2020","No","Cittadella","Venezia",1,0,14,6,4,1,21,13,3,3,0,0,2.26,2.98,3.39,2.09,1.72,3,0,0.4123616,0.3127306,0.2749077,1.549815,1.137454,1,8,3,3,0.4123616,8,0,0,0
"3125","I2",10,"27.07.2020","No","Crotone","Frosinone",1,0,8,4,2,1,20,17,5,2,0,0,3.01,3.2,2.34,1.9,1.89,3,0,0.3098902,0.2914904,0.3986194,1.221161,1.487349,1,4,1,3,-0.2661877,3,3,0,0
"3126","I2",10,"27.07.2020","No","Empoli","Cosenza",1,5,22,18,2,12,13,9,2,1,0,0,1.89,3.35,4.06,1.86,1.92,0,3,0.4926845,0.2779623,0.2293531,1.756016,0.9660218,-4,4,-10,-3,0.7899942,4,1,0,0
"3127","I2",10,"27.07.2020","No","Juve Stabia","Cremonese",1,2,14,9,5,6,13,20,1,4,0,0,2.63,2.97,2.82,2.16,1.68,0,3,0.3548432,0.3142214,0.3309353,1.378751,1.307027,-1,5,-1,-3,0.07172363,-7,-3,0,0
"3128","I2",10,"27.07.2020","No","Perugia","Trapani",1,2,11,16,5,6,11,18,3,4,0,0,2.21,3.12,3.33,1.99,1.8,0,3,0.4215857,0.2986232,0.2797911,1.56338,1.137997,-1,-5,-1,-3,0.4253838,-7,-1,0,0
"3129","I2",10,"27.07.2020","No","Pisa","Ascoli",1,0,8,12,2,1,21,10,5,2,0,0,2.19,3.23,3.28,1.91,1.88,3,0,0.4263117,0.2890473,0.284641,1.567982,1.14297,1,-4,1,3,0.425012,11,3,0,0
"3130","I2",10,"27.07.2020","No","Pordenone","Salernitana",1,1,9,13,4,4,22,16,3,4,0,0,2.44,3.07,2.96,1.99,1.8,1,1,0.3818087,0.3034571,0.3147342,1.448883,1.24766,0,-4,0,0,0.2012235,6,-1,0,0
"3131","I2",10,"27.07.2020","No","Spezia","Virtus Entella",0,0,8,7,3,1,17,13,2,1,0,0,1.85,3.32,4.32,2.02,1.78,1,1,0.5036592,0.2806535,0.2156874,1.791631,0.9277156,0,1,2,0,0.8639154,4,1,0,0
"3132","I2",10,"31.07.2020","No","Ascoli","Benevento",2,4,18,16,5,7,18,13,1,1,0,0,1.75,3.42,4.8,1.84,1.94,0,3,0.5329697,0.2727184,0.1943119,1.871628,0.855654,-2,2,-2,-3,1.015974,5,0,0,0
"3133","I2",10,"31.07.2020","No","Chievo","Pescara",1,0,17,3,6,1,6,14,1,2,0,0,2.3,2.61,3.93,2.33,1.58,3,0,0.4054381,0.3572826,0.2372793,1.573597,1.06912,1,14,5,3,0.5044764,-8,-1,0,0
"3134","I2",10,"31.07.2020","No","Cosenza","Juve Stabia",3,1,18,28,8,14,15,17,2,5,0,0,1.76,3.62,4.43,1.74,2.06,3,0,0.5309324,0.2581329,0.2109348,1.85093,0.8909371,2,-10,-6,3,0.9599928,-2,-3,0,0
"3135","I2",10,"31.07.2020","No","Cremonese","Pordenone",2,2,18,4,8,2,2,5,2,1,0,0,3.66,3,2.16,2.05,1.76,1,1,0.2554641,0.3116662,0.4328697,1.078058,1.610275,0,14,6,0,-0.5322169,-3,1,0,0
"3136","I2",10,"31.07.2020","No","Frosinone","Pisa",1,1,16,13,3,3,16,25,1,3,0,0,2.03,3.26,3.69,2.02,1.78,1,1,0.4602283,0.2865838,0.2531879,1.667269,1.046148,0,3,0,0,0.6211211,-9,-2,0,0
"3137","I2",10,"31.07.2020","No","Salernitana","Spezia",1,2,13,20,5,6,12,10,4,2,1,0,1.85,3.52,4.09,1.86,1.93,0,3,0.5055891,0.2657215,0.2286894,1.782489,0.9517898,-1,-7,-1,-3,0.8306989,2,2,1,0
"3138","I2",10,"31.07.2020","No","Trapani","Crotone",2,0,11,14,5,3,6,11,2,2,0,0,1.8,3.87,3.86,1.63,2.25,3,0,0.5177491,0.2408135,0.2414374,1.794061,0.9651257,2,-3,2,3,0.8289351,-5,0,0,0
"3139","I2",10,"31.07.2020","No","Venezia","Perugia",3,1,20,10,6,6,14,18,2,2,0,1,2.71,2.8,2.89,2.3,1.6,3,0,0.3441661,0.3331037,0.3227302,1.365602,1.301294,2,10,0,3,0.06430786,-4,0,-1,0
"3140","I2",10,"31.07.2020","No","Virtus Entella","Cittadella",2,3,14,15,6,5,19,25,2,4,0,0,3.77,3.25,2.01,1.82,1.98,0,3,0.2477933,0.2874402,0.4647665,1.03082,1.68174,-1,-1,1,-3,-0.6509197,-6,-2,0,0
"3141","T1",10,"16.08.2019","Yes","Denizlispor","Galatasaray",2,0,15,7,5,4,12,9,4,5,0,1,4.25,3.75,1.77,1.74,2.09,3,0,0.2205333,0.2499377,0.529529,0.9115375,1.838525,2,8,1,3,-0.9269873,3,-1,-1,0
"3142","T1",10,"17.08.2019","Yes","Genclerbirligi","Rizespor",0,1,8,11,1,5,16,14,4,2,1,0,2.06,3.36,3.51,2.05,1.76,0,3,0.4545476,0.2786809,0.2667715,1.642324,1.078995,-1,-3,-4,-3,0.5633282,2,2,1,0
"3143","T1",10,"17.08.2019","Yes","Kayserispor","Alanyaspor",0,1,6,14,3,7,13,10,4,1,0,0,2.38,3.3,2.91,2.02,1.79,0,3,0.3938432,0.2840445,0.3221123,1.465574,1.250381,-1,-8,-4,-3,0.2151927,3,3,0,0
"3144","T1",10,"17.08.2019","Yes","Sivasspor","Besiktas",3,0,13,13,8,3,15,9,4,3,0,0,2.76,3.46,2.4,1.74,2.08,3,0,0.3392489,0.2706148,0.3901363,1.288362,1.441024,3,0,5,3,-0.152662,6,1,0,0
"3145","T1",10,"18.08.2019","Yes","Konyaspor","Ankaragucu",0,0,23,9,4,1,7,14,0,2,0,0,1.75,3.51,4.78,2.1,1.72,1,1,0.5362838,0.267378,0.1963382,1.876229,0.8563926,0,14,3,0,1.019837,-7,-2,0,0
"3146","T1",10,"18.08.2019","Yes","Goztep","Antalyaspor",0,1,7,10,1,3,15,13,3,3,0,0,1.84,3.65,3.98,1.78,2.03,0,3,0.5085381,0.2563589,0.235103,1.781973,0.961668,-1,-3,-2,-3,0.8203051,2,0,0,0
"3147","T1",10,"18.08.2019","Yes","Kasimpasa","Trabzonspor",1,1,15,17,7,2,14,17,2,0,0,0,3.15,3.65,2.11,1.57,2.36,1,1,0.2979822,0.2571628,0.444855,1.151109,1.591728,0,-2,5,0,-0.4406183,-3,2,0,0
"3148","T1",10,"18.08.2019","Yes","Yeni Malatyaspor","Buyuksehyr",3,0,9,15,5,4,11,15,3,2,0,1,3.35,3.29,2.15,2.11,1.72,3,0,0.2796126,0.2847119,0.4356755,1.12355,1.591738,3,-6,1,3,-0.4681886,-4,1,-1,0
"3149","T1",10,"19.08.2019","Yes","Fenerbahce","Gaziantep",5,0,18,4,9,0,14,18,1,4,0,0,1.45,4.43,6.6,1.63,2.23,3,0,0.6464079,0.2115782,0.1420139,2.150802,0.6376198,5,14,9,3,1.513182,-4,-3,0,0
"3150","T1",10,"23.08.2019","Yes","Besiktas","Goztep",3,0,8,12,4,3,19,9,1,1,0,0,1.48,4.26,6.37,1.75,2.06,3,0,0.6330088,0.2199185,0.1470727,2.118945,0.6611366,3,-4,1,3,1.457808,10,0,0,0
"3151","T1",10,"24.08.2019","Yes","Ankaragucu","Kayserispor",1,1,15,15,5,5,18,9,3,1,0,0,2.34,3.23,3.04,2.04,1.77,1,1,0.400931,0.2904577,0.3086113,1.493251,1.216292,0,0,0,0,0.2769589,9,2,0,0
"3152","T1",10,"24.08.2019","Yes","Alanyaspor","Kasimpasa",4,1,18,6,8,1,13,11,4,4,0,0,1.67,4.21,4.35,1.51,2.49,3,0,0.5616139,0.222778,0.2156081,1.90762,0.8696023,3,12,7,3,1.038017,2,0,0,0
"3153","T1",10,"24.08.2019","Yes","Buyuksehyr","Fenerbahce",1,2,12,13,4,3,11,10,0,0,0,0,2.48,3.3,2.77,1.81,2,0,3,0.3778116,0.2839311,0.3382573,1.417366,1.298703,-1,-1,1,-3,0.1186628,1,0,0,0
"3154","T1",10,"25.08.2019","Yes","Rizespor","Sivasspor",2,1,11,15,5,2,15,11,2,2,0,0,2.12,3.46,3.27,1.75,2.07,3,0,0.4422754,0.2709895,0.2867351,1.597816,1.131195,1,-4,3,3,0.4666208,4,0,0,0
"3155","T1",10,"25.08.2019","Yes","Trabzonspor","Yeni Malatyaspor",2,1,16,13,5,2,5,13,1,2,0,0,1.66,3.96,4.73,1.59,2.33,3,0,0.564926,0.2368124,0.1982616,1.93159,0.8315971,1,3,3,3,1.099993,-8,-1,0,0
"3156","T1",10,"25.08.2019","Yes","Antalyaspor","Denizlispor",0,2,19,8,3,2,13,14,1,3,0,0,2.61,3.22,2.68,1.95,1.85,0,3,0.3591387,0.2911031,0.3497582,1.368519,1.340378,-2,11,1,-3,0.02814146,-1,-2,0,0
"3157","T1",10,"25.08.2019","Yes","Galatasaray","Konyaspor",1,1,18,16,6,4,8,11,1,3,1,0,1.43,4.54,6.62,1.58,2.33,1,1,0.6531721,0.2057348,0.1410931,2.165251,0.629014,0,2,2,0,1.536237,-3,-2,1,0
"3158","T1",10,"26.08.2019","Yes","Gaziantep","Genclerbirligi",4,1,15,12,7,4,17,8,1,1,0,2,2.4,3.17,2.96,2.13,1.69,3,0,0.389422,0.2948305,0.3157475,1.463096,1.242073,3,3,3,3,0.2210233,9,0,-2,0
"3159","T1",10,"30.08.2019","Yes","Kasimpasa","Ankaragucu",0,1,27,4,7,2,10,26,1,5,0,0,1.69,3.99,4.48,1.68,2.17,0,3,0.5553115,0.2352071,0.2094814,1.901142,0.8636512,-1,23,5,-3,1.03749,-16,-4,0,0
"3160","T1",10,"30.08.2019","Yes","Kayserispor","Galatasaray",2,3,8,20,4,10,21,13,8,6,3,1,4.42,3.78,1.73,1.81,1.99,0,3,0.2116749,0.247514,0.540811,0.8825388,1.869947,-1,-12,-6,-3,-0.9874084,8,2,2,0
"3161","T1",10,"31.08.2019","Yes","Konyaspor","Antalyaspor",2,2,17,15,4,6,13,14,2,2,0,0,1.61,3.67,5.77,2.22,1.65,1,1,0.5821665,0.2553919,0.1624416,2.001891,0.7427167,0,2,-2,0,1.259175,-1,0,0,0
"3162","T1",10,"31.08.2019","Yes","Besiktas","Rizespor",1,1,20,6,4,2,16,10,5,1,0,0,1.59,4.17,5.06,1.59,2.34,1,1,0.5897881,0.2248832,0.1853287,1.994248,0.7808692,0,14,2,0,1.213378,6,4,0,0
"3163","T1",10,"31.08.2019","Yes","Goztep","Denizlispor",0,0,17,5,2,1,13,14,2,3,0,1,2.38,3.29,2.93,2.03,1.78,1,1,0.3943698,0.2852888,0.3203414,1.468398,1.246313,0,12,1,0,0.2220854,-1,-1,-1,0
"3164","T1",10,"01.09.2019","Yes","Genclerbirligi","Buyuksehyr",1,2,8,22,5,9,26,17,5,2,0,0,4.29,3.47,1.83,2.18,1.67,0,3,0.2183133,0.2699032,0.5117836,0.924843,1.805254,-1,-14,-4,-3,-0.8804109,9,3,0,0
"3165","T1",10,"01.09.2019","Yes","Sivasspor","Gaziantep",1,1,22,11,5,4,14,19,3,4,0,0,1.48,4.22,6.47,1.78,2.03,1,1,0.6331282,0.222045,0.1448269,2.12143,0.6565255,0,11,1,0,1.464904,-5,-1,0,0
"3166","T1",10,"01.09.2019","Yes","Fenerbahce","Trabzonspor",1,1,21,10,9,5,14,9,1,3,0,0,1.64,4.15,4.6,1.49,2.58,1,1,0.5708732,0.2255981,0.2035287,1.938218,0.8361842,0,11,4,0,1.102033,5,-2,0,0
"3167","T1",10,"01.09.2019","Yes","Yeni Malatyaspor","Alanyaspor",2,3,14,8,8,5,18,13,4,2,0,0,2.82,3.4,2.4,1.83,1.97,0,3,0.3328439,0.2760646,0.3910915,1.274596,1.449339,-1,6,3,-3,-0.174743,5,2,0,0
"3168","T1",10,"13.09.2019","Yes","Galatasaray","Kasimpasa",1,0,14,9,4,2,15,18,2,3,0,0,1.3,5.64,8.6,1.39,2.95,3,0,0.7237675,0.1668258,0.1094067,2.338128,0.495046,1,5,2,3,1.843082,-3,-1,0,0
"3169","T1",10,"14.09.2019","Yes","Buyuksehyr","Sivasspor",1,1,13,9,5,2,13,15,2,2,0,0,1.58,3.94,5.52,1.81,1.99,1,1,0.5926814,0.2376743,0.1696443,2.015719,0.7466072,0,4,3,0,1.269111,-2,0,0,0
"3170","T1",10,"14.09.2019","Yes","Antalyaspor","Kayserispor",2,2,18,5,5,3,14,15,3,1,0,0,2.1,3.34,3.42,2.04,1.77,1,1,0.4458757,0.280341,0.2737833,1.617968,1.101691,0,13,2,0,0.5162771,-1,2,0,0
"3171","T1",10,"14.09.2019","Yes","Gaziantep","Besiktas",3,2,14,12,5,5,15,9,4,4,1,2,4.06,3.75,1.81,1.69,2.14,3,0,0.2311732,0.2502835,0.5185432,0.9438032,1.805913,1,2,0,3,-0.8621101,6,0,-1,0
"3172","T1",10,"15.09.2019","Yes","Ankaragucu","Yeni Malatyaspor",0,4,11,18,2,10,12,12,4,3,1,0,2.72,3.16,2.61,2.13,1.7,0,3,0.3444825,0.2965166,0.3590009,1.329964,1.373519,-4,-7,-8,-3,-0.04355526,0,1,1,0
"3173","T1",10,"15.09.2019","Yes","Rizespor","Goztep",0,0,9,3,2,1,21,10,3,4,0,0,1.97,3.39,3.79,1.99,1.81,1,1,0.4759842,0.2766044,0.2474113,1.704557,1.018838,0,6,1,0,0.6857187,11,-1,0,0
"3174","T1",10,"15.09.2019","Yes","Denizlispor","Konyaspor",0,1,8,10,2,4,13,4,4,2,0,0,2.08,3.24,3.61,2.18,1.67,0,3,0.4508256,0.2894189,0.2597555,1.641896,1.068685,-1,-2,-2,-3,0.5732104,9,2,0,0
"3175","T1",10,"15.09.2019","Yes","Trabzonspor","Genclerbirligi",2,2,17,14,9,6,11,15,2,2,0,0,1.49,4.42,5.84,1.53,2.45,1,1,0.6280456,0.2117167,0.1602377,2.095854,0.6924297,0,3,3,0,1.403424,-4,0,0,0
"3176","T1",10,"16.09.2019","Yes","Alanyaspor","Fenerbahce",3,1,12,11,6,4,13,14,1,1,0,0,2.77,3.45,2.4,1.73,2.08,3,0,0.3381731,0.2715187,0.3903082,1.286038,1.442443,2,1,2,3,-0.1564051,-1,0,0,0
"3177","T1",10,"20.09.2019","Yes","Goztep","Konyaspor",1,0,16,9,10,1,9,14,1,3,1,0,2.37,2.98,3.24,2.5,1.52,3,0,0.3957601,0.3147488,0.2894912,1.502029,1.183222,1,7,9,3,0.3188067,-5,-2,1,0
"3178","T1",10,"21.09.2019","Yes","Kasimpasa","Antalyaspor",3,0,15,10,7,3,17,15,2,3,0,0,2.36,3.43,2.84,1.71,2.12,3,0,0.3969778,0.2731392,0.329883,1.464073,1.262788,3,5,4,3,0.2012845,2,-1,0,0
"3179","T1",10,"21.09.2019","Yes","Kayserispor","Denizlispor",1,1,12,18,5,5,19,13,2,1,0,0,2.44,3.23,2.87,1.98,1.82,1,1,0.3837899,0.2899218,0.3262883,1.441292,1.268787,0,-6,0,0,0.1725049,6,1,0,0
"3180","T1",10,"21.09.2019","Yes","Fenerbahce","Ankaragucu",2,1,30,6,8,3,11,11,2,3,0,0,1.23,6.08,11.34,1.47,2.64,3,0,0.7629114,0.154339,0.08274965,2.443073,0.4025879,1,24,5,3,2.040485,0,-1,0,0
"3181","T1",10,"22.09.2019","Yes","Rizespor","Gaziantep",1,2,15,5,4,4,9,13,2,2,0,0,1.98,3.42,3.7,1.79,2.01,0,3,0.4730184,0.2738528,0.2531288,1.692908,1.033239,-1,10,0,-3,0.659669,-4,0,0,0
"3182","T1",10,"22.09.2019","Yes","Genclerbirligi","Alanyaspor",1,1,12,14,5,5,5,22,3,3,0,0,3.44,3.55,2.02,1.81,1.99,1,1,0.2723323,0.2638938,0.4637738,1.080891,1.655215,0,-2,0,0,-0.5743246,-17,0,0,0
"3183","T1",10,"22.09.2019","Yes","Yeni Malatyaspor","Galatasaray",1,1,16,12,4,3,16,16,1,3,0,0,3.99,3.63,1.85,1.77,2.04,1,1,0.2349663,0.2582687,0.5067651,0.9631675,1.778564,0,4,1,0,-0.8153964,0,-2,0,0
"3184","T1",10,"23.09.2019","Yes","Besiktas","Buyuksehyr",1,1,8,11,2,7,9,18,4,5,0,0,2.32,3.42,2.9,1.8,1.99,1,1,0.4034922,0.273714,0.3227938,1.484191,1.242095,0,-3,-5,0,0.2420953,-9,-1,0,0
"3185","T1",10,"23.09.2019","Yes","Sivasspor","Trabzonspor",2,1,16,15,6,4,16,18,3,3,0,0,2.34,3.54,2.77,1.62,2.25,3,0,0.399077,0.2637966,0.3371264,1.461028,1.275176,1,1,2,3,0.1858517,-2,0,0,0
"3186","T1",10,"27.09.2019","Yes","Buyuksehyr","Rizespor",5,0,16,13,7,1,9,14,0,2,0,0,1.61,3.8,5.41,1.9,1.89,3,0,0.5809626,0.2461447,0.1728927,1.989032,0.7648229,5,3,6,3,1.22421,-5,-2,0,0
"3187","T1",10,"28.09.2019","Yes","Denizlispor","Kasimpasa",0,1,16,16,7,7,10,19,0,2,0,0,1.95,3.64,3.59,1.64,2.23,0,3,0.481026,0.2576925,0.2612815,1.70077,1.041537,-1,0,0,-3,0.6592334,-9,-2,0,0
"3188","T1",10,"28.09.2019","Yes","Alanyaspor","Sivasspor",1,1,29,8,11,4,19,17,3,4,0,0,1.76,3.78,4.29,1.63,2.25,1,1,0.5330874,0.24821,0.2187025,1.847472,0.9043176,0,21,7,0,0.9431547,2,-1,0,0
"3189","T1",10,"28.09.2019","Yes","Galatasaray","Fenerbahce",0,0,5,12,3,3,18,13,2,1,0,0,2.11,3.56,3.21,1.65,2.21,1,1,0.444441,0.2634187,0.2921403,1.596742,1.13984,0,-7,0,0,0.4569019,5,1,0,0
"3190","T1",10,"29.09.2019","Yes","Konyaspor","Kayserispor",2,1,24,7,8,3,10,19,4,7,0,2,1.96,3.38,3.81,2.1,1.72,3,0,0.4774826,0.2768834,0.2456341,1.709331,1.013786,1,17,5,3,0.6955455,-9,-3,-2,0
"3191","T1",10,"29.09.2019","Yes","Ankaragucu","Genclerbirligi",2,1,12,17,5,6,15,11,1,2,0,0,3.23,3.39,2.16,1.94,1.85,3,0,0.2900087,0.2763209,0.4336704,1.146347,1.577332,1,-5,-1,3,-0.4309851,4,-1,0,0
"3192","T1",10,"29.09.2019","Yes","Antalyaspor","Yeni Malatyaspor",3,0,11,11,5,1,14,14,2,2,0,1,2.41,3.28,2.88,1.9,1.9,3,0,0.3888688,0.2857237,0.3254075,1.45233,1.261946,3,0,4,3,0.1903837,0,0,-1,0
"3193","T1",10,"29.09.2019","Yes","Trabzonspor","Besiktas",4,1,13,12,5,4,23,10,6,3,0,0,2.21,3.73,2.89,1.55,2.4,3,0,0.4242323,0.2513548,0.3244129,1.524052,1.224594,3,1,1,3,0.2994581,13,3,0,0
"3194","T1",10,"30.09.2019","Yes","Gaziantep","Goztep",1,1,15,4,2,2,12,9,2,4,0,1,2.34,3.24,3.01,2.03,1.76,1,1,0.4000591,0.2889316,0.3110094,1.489109,1.22196,0,11,0,0,0.2671491,3,-2,-1,0
"3195","T1",10,"04.10.2019","Yes","Fenerbahce","Antalyaspor",0,1,25,7,6,5,10,17,1,2,0,0,1.38,4.95,7.15,1.49,2.55,0,3,0.6794425,0.1894203,0.1311372,2.227748,0.5828318,-1,18,1,-3,1.644916,-7,-1,0,0
"3196","T1",10,"04.10.2019","Yes","Yeni Malatyaspor","Denizlispor",5,1,15,9,7,4,20,13,2,6,0,0,1.97,3.62,3.53,1.73,2.09,3,0,0.4756757,0.2588622,0.2654621,1.685889,1.055248,4,6,3,3,0.6306409,7,-4,0,0
"3197","T1",10,"05.10.2019","Yes","Kasimpasa","Konyaspor",1,4,17,14,8,9,11,10,5,4,0,0,2.33,3.3,2.98,1.97,1.83,0,3,0.401939,0.2837933,0.3142677,1.48961,1.226596,-3,3,-1,-3,0.2630138,1,1,0,0
"3198","T1",10,"05.10.2019","Yes","Goztep","Kayserispor",4,0,16,8,8,3,13,15,1,2,0,0,1.75,3.55,4.66,2.12,1.71,3,0,0.5351903,0.2638262,0.2009835,1.869397,0.8667767,4,8,5,3,1.00262,-2,-1,0,0
"3199","T1",10,"05.10.2019","Yes","Genclerbirligi","Galatasaray",0,0,20,11,6,2,19,17,7,4,1,0,3.4,3.54,2.04,1.77,2.04,1,1,0.2757009,0.2647975,0.4595016,1.0919,1.643302,0,9,4,0,-0.5514019,2,3,1,0
"3200","T1",10,"06.10.2019","Yes","Sivasspor","Ankaragucu",3,1,11,14,5,4,14,12,4,1,0,0,1.39,4.71,7.27,1.59,2.31,3,0,0.6728056,0.1985562,0.1286382,2.216973,0.5844708,2,-3,1,3,1.632502,2,3,0,0
"3201","T1",10,"06.10.2019","Yes","Besiktas","Alanyaspor",2,0,7,14,4,3,11,11,3,4,0,0,2.02,3.63,3.38,1.67,2.17,3,0,0.4642295,0.2583316,0.2774389,1.65102,1.090648,2,-7,1,3,0.5603717,0,-1,0,0
"3202","T1",10,"06.10.2019","Yes","Gaziantep","Buyuksehyr",1,2,5,21,2,9,14,18,1,6,1,0,3.9,3.34,1.96,2.05,1.76,0,3,0.2405314,0.2808601,0.4786085,1.002454,1.716686,-1,-16,-7,-3,-0.7142311,-4,-5,1,0
"3203","T1",10,"06.10.2019","Yes","Rizespor","Trabzonspor",1,2,16,13,4,4,17,11,5,2,0,0,2.6,3.44,2.55,1.65,2.2,0,3,0.3603056,0.272324,0.3673704,1.353241,1.374435,-1,3,0,-3,-0.02119445,6,3,0,0
"3204","T1",10,"18.10.2019","Yes","Galatasaray","Sivasspor",3,2,19,16,8,7,10,20,4,4,0,1,1.55,4.21,5.45,1.6,2.3,3,0,0.6051164,0.2227863,0.1720973,2.038135,0.7390783,1,3,1,3,1.299057,-10,0,-1,0
"3205","T1",10,"19.10.2019","Yes","Antalyaspor","Genclerbirligi",0,6,11,11,1,9,5,16,2,2,1,0,2.25,3.35,3.1,2.03,1.78,0,3,0.4171102,0.2801486,0.3027412,1.531479,1.188372,-6,0,-8,-3,0.3431067,-11,0,1,0
"3206","T1",10,"19.10.2019","Yes","Buyuksehyr","Goztep",2,1,14,11,5,2,17,13,1,3,0,0,1.6,3.78,5.71,2.06,1.75,3,0,0.58703,0.2484783,0.1644918,2.009568,0.7419536,1,3,3,3,1.267615,4,-2,0,0
"3207","T1",10,"19.10.2019","Yes","Trabzonspor","Gaziantep",4,1,12,14,5,5,16,14,1,1,0,1,1.6,4.09,5.14,1.62,2.27,3,0,0.5873777,0.229781,0.1828413,1.991914,0.7783049,3,-2,0,3,1.213609,2,0,-1,0
"3208","T1",10,"19.10.2019","Yes","Ankaragucu","Besiktas",0,0,4,14,1,4,17,9,3,4,1,0,5.82,4.3,1.51,1.65,2.21,1,1,0.1610878,0.2180305,0.6208816,0.7012941,2.080675,0,-10,-3,0,-1.379381,8,-1,1,0
"3209","T1",10,"20.10.2019","Yes","Kayserispor","Kasimpasa",1,1,23,9,10,1,14,17,5,3,0,0,2.38,3.39,2.86,1.78,2.02,1,1,0.3945968,0.2770325,0.3283707,1.460823,1.262145,0,14,9,0,0.1986781,-3,2,0,0
"3210","T1",10,"20.10.2019","Yes","Alanyaspor","Rizespor",5,2,21,5,11,3,21,16,0,1,0,0,1.65,3.79,5.12,1.97,1.83,3,0,0.5689506,0.2476962,0.1833532,1.954548,0.7977558,3,16,8,3,1.156792,5,-1,0,0
"3211","T1",10,"20.10.2019","Yes","Denizlispor","Fenerbahce",1,2,3,9,1,3,12,12,2,0,0,0,3.97,3.67,1.84,1.72,2.1,0,3,0.2358851,0.2551672,0.5089477,0.9628225,1.78201,-1,-6,-2,-3,-0.8191878,0,2,0,0
"3212","T1",10,"21.10.2019","Yes","Konyaspor","Yeni Malatyaspor",0,2,6,12,3,6,10,16,1,2,1,0,2.13,3.26,3.42,2.09,1.71,0,3,0.4393323,0.2870484,0.2736193,1.605045,1.107906,-2,-6,-3,-3,0.4971392,-6,-1,1,0
"3213","T1",10,"25.10.2019","Yes","Rizespor","Ankaragucu",2,0,22,15,8,3,20,11,1,3,0,0,1.6,4.02,5.17,1.7,2.14,3,0,0.5856558,0.2330968,0.1812474,1.990064,0.7768391,2,7,5,3,1.213225,9,-2,0,0
"3214","T1",10,"26.10.2019","Yes","Sivasspor","Antalyaspor",2,1,9,8,3,3,15,8,3,1,0,0,1.74,3.71,4.48,1.77,2.04,3,0,0.5383883,0.2525056,0.2091062,1.86767,0.879824,1,1,0,3,0.9878464,7,2,0,0
"3215","T1",10,"26.10.2019","Yes","Gaziantep","Alanyaspor",1,1,9,7,3,2,19,13,3,3,0,0,3.45,3.47,2.04,1.77,2.05,1,1,0.27134,0.2697761,0.4588839,1.083796,1.646428,0,2,1,0,-0.5626315,6,0,0,0
"3216","T1",10,"26.10.2019","Yes","Fenerbahce","Konyaspor",5,1,19,5,8,1,13,6,1,1,0,0,1.46,4.43,6.29,1.77,2.03,3,0,0.6403338,0.2110355,0.1486307,2.132037,0.6569277,4,14,7,3,1.475109,7,0,0,0
"3217","T1",10,"27.10.2019","Yes","Yeni Malatyaspor","Kayserispor",4,0,18,5,7,2,15,18,1,3,0,0,1.55,4.18,5.53,1.63,2.24,3,0,0.6056558,0.2245853,0.1697589,2.041553,0.7338619,4,13,5,3,1.307691,-3,-2,0,0
"3218","T1",10,"27.10.2019","Yes","Genclerbirligi","Denizlispor",0,2,16,10,7,3,13,9,1,2,0,0,1.81,3.69,4.09,1.81,1.99,0,3,0.5173151,0.2537508,0.2289341,1.805696,0.940553,-2,6,4,-3,0.8651432,4,-1,0,0
"3219","T1",10,"27.10.2019","Yes","Goztep","Kasimpasa",1,4,11,16,3,8,13,18,4,3,0,0,1.82,3.73,4.02,1.73,2.09,0,3,0.5152854,0.2514261,0.2332884,1.797282,0.9512914,-3,-5,-5,-3,0.845991,-5,1,0,0
"3220","T1",10,"27.10.2019","Yes","Besiktas","Galatasaray",1,0,13,14,7,2,11,15,2,3,0,0,2.72,3.51,2.41,1.67,2.17,3,0,0.3444049,0.2668892,0.3887059,1.300104,1.433007,1,-1,5,3,-0.1329031,-4,-1,0,0
"3221","T1",10,"28.10.2019","Yes","Buyuksehyr","Trabzonspor",2,2,15,9,5,7,11,6,2,3,0,0,2,3.49,3.56,1.79,1.99,1,1,0.468414,0.2684321,0.2631539,1.673674,1.057894,0,6,-2,0,0.6157802,5,-1,0,0
"3222","T1",10,"01.11.2019","Yes","Galatasaray","Rizespor",2,0,12,10,7,3,14,19,1,3,0,0,1.52,4.1,6.07,1.73,2.09,3,0,0.6168485,0.2286853,0.1544662,2.079231,0.6920839,2,2,4,3,1.387147,-5,-2,0,0
"3223","T1",10,"02.11.2019","Yes","Konyaspor","Genclerbirligi",1,1,10,15,3,2,13,9,0,3,0,0,2.3,3.24,3.1,2.18,1.67,1,1,0.4078616,0.2895314,0.302607,1.513116,1.197352,0,-5,1,0,0.3157638,4,-3,0,0
"3224","T1",10,"02.11.2019","Yes","Alanyaspor","Buyuksehyr",0,0,22,4,3,1,13,10,1,1,0,0,2.34,3.33,2.95,1.91,1.88,1,1,0.4006534,0.2815402,0.3178064,1.4835,1.234959,0,18,2,0,0.2485409,3,0,0,0
"3225","T1",10,"02.11.2019","Yes","Trabzonspor","Goztep",0,1,21,6,6,2,3,10,0,3,0,0,1.66,3.8,5.02,1.85,1.94,0,3,0.5657647,0.2471498,0.1870855,1.944444,0.8084064,-1,15,4,-3,1.136037,-7,-3,0,0
"3226","T1",10,"02.11.2019","Yes","Antalyaspor","Besiktas",1,2,14,12,4,6,13,17,3,2,0,0,3.02,3.44,2.24,1.77,2.03,0,3,0.3099697,0.2721246,0.4179056,1.202034,1.525842,-1,2,-2,-3,-0.3238077,-4,1,0,0
"3227","T1",10,"03.11.2019","Yes","Denizlispor","Sivasspor",0,2,10,16,2,6,14,22,3,3,0,0,2.72,3.38,2.46,1.82,1.97,0,3,0.3435925,0.2765004,0.3799071,1.307278,1.416222,-2,-6,-4,-3,-0.1089439,-8,0,0,0
"3228","T1",10,"03.11.2019","Yes","Kasimpasa","Yeni Malatyaspor",2,2,19,13,6,5,13,14,2,3,0,1,2.24,3.67,2.87,1.55,2.4,1,1,0.4182627,0.2552884,0.3264489,1.510076,1.234635,0,6,1,0,0.2754413,-1,-1,-1,0
"3229","T1",10,"03.11.2019","Yes","Kayserispor","Fenerbahce",1,0,11,22,1,5,19,10,1,3,0,0,6.38,4.44,1.46,1.62,2.24,3,0,0.1469119,0.2111032,0.6419849,0.6518389,2.137058,1,-11,-4,3,-1.485219,9,-2,0,0
"3230","T1",10,"04.11.2019","Yes","Ankaragucu","Gaziantep",1,2,13,9,6,5,16,16,2,2,0,0,2.83,3.43,2.35,1.81,1.97,0,3,0.3301062,0.2723617,0.3975321,1.26268,1.464958,-1,4,1,-3,-0.2022778,0,0,0,0
"3231","T1",10,"08.11.2019","Yes","Fenerbahce","Kasimpasa",3,2,19,8,9,5,14,14,3,5,1,1,1.34,5.35,7.38,1.36,3.07,3,0,0.698305,0.1749025,0.1267925,2.269817,0.55528,1,11,4,3,1.714537,0,-2,0,0
"3232","T1",10,"09.11.2019","Yes","Genclerbirligi","Kayserispor",2,1,15,7,7,3,13,7,2,0,0,0,1.6,4.06,5.11,1.68,2.16,3,0,0.5857544,0.2308392,0.1834065,1.988102,0.7810585,1,8,4,3,1.207044,6,2,0,0
"3233","T1",10,"09.11.2019","Yes","Rizespor","Antalyaspor",1,0,5,33,3,8,18,13,2,4,1,0,1.93,3.55,3.74,1.93,1.87,3,0,0.4855065,0.2639514,0.2505421,1.720471,1.015578,1,-28,-5,3,0.7048931,5,-2,1,0
"3234","T1",10,"09.11.2019","Yes","Sivasspor","Konyaspor",2,0,17,2,10,1,10,9,1,5,0,1,1.82,3.6,4.21,1.97,1.83,3,0,0.5160333,0.2608835,0.2230833,1.808983,0.9301333,2,15,9,3,0.87885,1,-4,-1,0
"3235","T1",10,"09.11.2019","Yes","Gaziantep","Galatasaray",0,2,7,12,0,3,17,13,3,1,0,0,3.81,3.64,1.89,1.83,1.97,0,3,0.2461492,0.2576452,0.4962056,0.9960929,1.746262,-2,-5,-3,-3,-0.7501691,4,2,0,0
"3236","T1",10,"10.11.2019","Yes","Goztep","Yeni Malatyaspor",1,1,7,7,3,2,19,13,6,6,1,1,2.02,3.44,3.56,1.95,1.84,1,1,0.4641179,0.2725343,0.2633478,1.664888,1.062578,0,0,1,0,0.6023103,6,0,0,0
"3237","T1",10,"10.11.2019","Yes","Trabzonspor","Alanyaspor",1,0,7,13,2,4,8,18,4,4,1,1,2.38,3.52,2.75,1.62,2.26,3,0,0.3934544,0.2660288,0.3405169,1.446392,1.287579,1,-6,-2,3,0.1588125,-10,0,0,0
"3238","T1",10,"10.11.2019","Yes","Besiktas","Denizlispor",1,0,12,8,7,3,13,18,2,2,0,0,1.55,4.16,5.52,1.66,2.18,3,0,0.6048168,0.2253524,0.1698308,2.039803,0.7348448,1,4,4,3,1.304958,-5,0,0,0
"3239","T1",10,"10.11.2019","Yes","Buyuksehyr","Ankaragucu",2,1,17,16,7,6,14,9,1,2,0,0,1.24,5.92,11.33,1.49,2.56,3,0,0.7582056,0.1588133,0.08298102,2.43343,0.4077564,1,1,1,3,2.025674,5,-1,0,0
"3240","T1",10,"22.11.2019","Yes","Galatasaray","Buyuksehyr",0,1,8,7,3,2,19,17,3,3,0,0,2.52,3.25,2.76,2.04,1.78,0,3,0.3719646,0.2884156,0.3396198,1.404309,1.307275,-1,1,1,-3,0.09703424,2,0,0,0
"3241","T1",10,"23.11.2019","Yes","Denizlispor","Rizespor",2,0,12,5,3,0,13,14,3,2,0,0,2.17,3.34,3.25,2.05,1.76,3,0,0.4315194,0.2803584,0.2881222,1.574917,1.144725,2,7,3,3,0.4301916,-1,1,0,0
"3242","T1",10,"23.11.2019","Yes","Ankaragucu","Trabzonspor",0,3,12,21,1,10,18,12,5,2,1,0,3.51,3.68,1.97,1.63,2.26,0,3,0.2676996,0.2553331,0.4769673,1.058432,1.686235,-3,-9,-9,-3,-0.6278032,6,3,1,0
"3243","T1",10,"23.11.2019","Yes","Konyaspor","Besiktas",0,1,7,9,1,4,12,11,3,1,0,0,2.82,3.31,2.43,2,1.8,0,3,0.3319549,0.2828135,0.3852316,1.278678,1.438508,-1,-2,-3,-3,-0.1598301,1,2,0,0
"3244","T1",10,"24.11.2019","Yes","Kayserispor","Sivasspor",1,4,9,19,6,6,14,14,0,0,0,0,3.76,3.6,1.91,1.75,2.06,0,3,0.2491882,0.2602632,0.4905485,1.007828,1.731909,-3,-10,0,-3,-0.7240809,0,0,0,0
"3245","T1",10,"24.11.2019","Yes","Alanyaspor","Goztep",0,1,14,7,7,2,12,10,3,1,0,0,1.63,3.82,5.17,1.99,1.81,0,3,0.5740587,0.2449518,0.1809895,1.967128,0.7879203,-1,7,5,-3,1.179208,2,2,0,0
"3246","T1",10,"24.11.2019","Yes","Kasimpasa","Genclerbirligi",1,2,10,18,4,3,10,13,1,1,0,0,2.21,3.66,2.93,1.6,2.3,0,3,0.4240718,0.2560652,0.319863,1.528281,1.215654,-1,-8,1,-3,0.3126263,-3,0,0,0
"3247","T1",10,"24.11.2019","Yes","Yeni Malatyaspor","Fenerbahce",0,0,13,19,6,5,13,21,3,4,0,0,2.6,3.53,2.49,1.67,2.17,1,1,0.359619,0.2648752,0.3755058,1.343732,1.391393,0,-6,1,0,-0.04766035,-8,-1,0,0
"3248","T1",10,"25.11.2019","Yes","Antalyaspor","Gaziantep",1,1,22,7,6,3,19,18,2,3,0,0,2.01,3.52,3.5,1.88,1.92,1,1,0.4661334,0.2661728,0.2676938,1.664573,1.069254,0,15,3,0,0.595319,1,-1,0,0
"3249","T1",10,"29.11.2019","Yes","Genclerbirligi","Yeni Malatyaspor",3,3,16,11,8,7,15,12,2,2,0,0,2.18,3.4,3.18,1.79,2.01,1,1,0.4297912,0.275572,0.2946368,1.564946,1.159482,0,5,1,0,0.4054634,3,0,0,0
"3250","T1",10,"30.11.2019","Yes","Rizespor","Konyaspor",3,1,9,13,5,2,16,9,1,0,0,0,2.27,3.13,3.25,2.28,1.62,3,0,0.4125921,0.2992282,0.2881797,1.537005,1.163767,2,-4,3,3,0.3732372,7,1,0,0
"3251","T1",10,"30.11.2019","Yes","Sivasspor","Kasimpasa",2,0,16,16,9,4,19,10,1,3,0,0,1.63,4.16,4.71,1.52,2.48,3,0,0.5754074,0.2254601,0.1991325,1.951682,0.8228576,2,0,5,3,1.128825,9,-2,0,0
"3252","T1",10,"30.11.2019","Yes","Alanyaspor","Ankaragucu",5,0,19,7,12,2,14,12,1,2,0,0,1.3,5.41,9.08,1.58,2.33,3,0,0.7228214,0.1736909,0.1034877,2.342155,0.4841539,5,12,10,3,1.858001,2,-1,0,0
"3253","T1",10,"30.11.2019","Yes","Goztep","Fenerbahce",2,2,11,12,4,3,11,12,1,8,0,1,3.16,3.3,2.23,2.02,1.78,1,1,0.29633,0.2837584,0.4199116,1.172748,1.543493,0,-1,1,0,-0.3707447,-1,-7,-1,0
"3254","T1",10,"01.12.2019","Yes","Gaziantep","Denizlispor",1,2,18,5,3,2,10,18,3,5,0,0,2.03,3.34,3.63,2.04,1.77,0,3,0.4614647,0.280471,0.2580643,1.664865,1.054664,-1,13,1,-3,0.6102012,-8,-2,0,0
"3255","T1",10,"01.12.2019","Yes","Buyuksehyr","Antalyaspor",2,0,12,14,4,5,16,18,1,3,0,0,1.44,4.33,6.9,1.74,2.07,3,0,0.6488201,0.2157739,0.1354059,2.162234,0.6219917,2,-2,-1,3,1.540243,-2,-2,0,0
"3256","T1",10,"01.12.2019","Yes","Trabzonspor","Galatasaray",1,1,10,9,5,3,11,7,4,3,0,0,2.27,3.45,2.95,1.73,2.08,1,1,0.4119528,0.271053,0.3169942,1.506911,1.222036,0,1,2,0,0.2848758,4,1,0,0
"3257","T1",10,"02.12.2019","Yes","Besiktas","Kayserispor",4,1,24,7,13,3,12,10,2,1,0,0,1.25,5.8,10.49,1.5,2.52,3,0,0.7492442,0.161475,0.08928077,2.409208,0.4293173,3,17,10,3,1.97989,2,1,0,0
"3258","T1",10,"06.12.2019","Yes","Fenerbahce","Genclerbirligi",5,2,24,14,13,6,14,12,3,4,0,0,1.43,4.6,6.52,1.58,2.34,3,0,0.6535116,0.2031569,0.1433315,2.163692,0.6331515,3,10,7,3,1.53054,2,-1,0,0
"3259","T1",10,"07.12.2019","Yes","Yeni Malatyaspor","Sivasspor",1,3,14,13,2,7,14,16,2,4,0,0,2.22,3.59,2.95,1.63,2.24,0,3,0.421776,0.2608197,0.3174043,1.526148,1.213033,-2,1,-5,-3,0.3131151,-2,-2,0,0
"3260","T1",10,"07.12.2019","Yes","Ankaragucu","Goztep",1,3,11,15,4,6,13,9,2,3,0,0,3.62,3.33,2.04,2.11,1.71,0,3,0.2589602,0.2815123,0.4595275,1.058393,1.660095,-2,-4,-2,-3,-0.6017017,4,-1,0,0
"3261","T1",10,"07.12.2019","Yes","Galatasaray","Alanyaspor",1,0,7,21,4,5,15,13,2,4,0,0,1.92,3.53,3.82,1.95,1.85,3,0,0.4886327,0.2657719,0.2455955,1.73167,1.002558,1,-14,-1,3,0.7291116,2,-2,0,0
"3262","T1",10,"08.12.2019","Yes","Konyaspor","Gaziantep",0,0,16,13,5,2,16,16,2,1,0,0,2.07,3.24,3.63,2.15,1.68,1,1,0.4526655,0.289203,0.2581316,1.647199,1.063598,0,3,3,0,0.5836018,0,1,0,0
"3263","T1",10,"08.12.2019","Yes","Antalyaspor","Trabzonspor",1,3,24,11,8,5,12,14,2,2,0,0,2.63,3.47,2.5,1.72,2.1,0,3,0.3558814,0.2697314,0.3743872,1.337376,1.392893,-2,13,3,-3,-0.05551749,-2,0,0,0
"3264","T1",10,"08.12.2019","Yes","Denizlispor","Buyuksehyr",1,1,8,18,2,5,15,10,3,1,0,0,3.63,3.26,2.06,2.11,1.71,1,1,0.2580224,0.2873071,0.4546705,1.061374,1.651319,0,-10,-3,0,-0.5899444,5,2,0,0
"3265","T1",10,"08.12.2019","Yes","Kasimpasa","Besiktas",2,3,9,13,5,7,10,12,3,5,1,0,3.65,3.89,1.86,1.52,2.47,0,3,0.2563663,0.2405493,0.5030844,1.009648,1.749802,-1,-4,-2,-3,-0.7401543,-2,-2,1,0
"3266","T1",10,"09.12.2019","Yes","Kayserispor","Rizespor",1,0,17,19,7,7,8,6,2,3,0,0,2.92,3.45,2.29,1.81,1.98,3,0,0.3203602,0.2711455,0.4084943,1.232226,1.496628,1,-2,0,3,-0.2644021,2,-1,0,0
"3267","T1",10,"13.12.2019","Yes","Alanyaspor","Antalyaspor",0,0,15,8,1,1,22,19,3,3,0,0,1.53,4.17,5.68,1.71,2.14,1,1,0.6111451,0.2242331,0.1646218,2.057668,0.7180986,0,7,0,0,1.33957,3,0,0,0
"3268","T1",10,"14.12.2019","Yes","Rizespor","Kasimpasa",0,3,16,9,4,4,16,19,5,6,1,0,2.12,3.49,3.25,1.59,2.33,0,3,0.4425253,0.268812,0.2886627,1.596388,1.1348,-3,7,0,-3,0.461588,-3,-1,1,0
"3269","T1",10,"14.12.2019","Yes","Genclerbirligi","Goztep",3,1,8,11,5,1,17,11,3,1,0,0,2.07,3.29,3.56,2,1.8,3,0,0.4523577,0.2846141,0.2630282,1.641687,1.073699,2,-3,4,3,0.5679884,6,2,0,0
"3270","T1",10,"14.12.2019","Yes","Galatasaray","Ankaragucu",2,2,14,7,5,3,10,15,2,5,0,1,1.27,5.38,10.55,1.61,2.27,1,1,0.7372247,0.1740289,0.08874648,2.385703,0.4402683,0,7,2,0,1.945435,-5,-3,-1,0
"3271","T1",10,"15.12.2019","Yes","Gaziantep","Kayserispor",3,0,14,5,6,1,21,19,2,2,0,0,1.55,4.14,5.5,1.67,2.18,3,0,0.6037866,0.2260554,0.170158,2.037415,0.7365295,3,9,5,3,1.300886,2,0,0,0
"3272","T1",10,"15.12.2019","Yes","Sivasspor","Fenerbahce",3,1,14,9,3,4,19,12,4,3,0,2,2.63,3.46,2.5,1.65,2.21,3,0,0.3556042,0.2703003,0.3740956,1.337113,1.392587,2,5,-1,3,-0.05547425,7,1,-2,0
"3273","T1",10,"15.12.2019","Yes","Besiktas","Yeni Malatyaspor",0,2,12,4,1,3,11,12,6,3,1,0,1.47,4.53,5.97,1.52,2.49,0,3,0.6366448,0.2065934,0.1567618,2.116528,0.6768787,-2,8,-2,-3,1.439649,-1,3,1,0
"3274","T1",10,"16.12.2019","Yes","Buyuksehyr","Konyaspor",1,1,19,6,6,2,14,10,0,3,0,0,1.46,4.15,6.85,1.97,1.81,1,1,0.6389997,0.2248047,0.1361956,2.141804,0.6333914,0,13,4,0,1.508412,4,-3,0,0
"3275","T1",10,"16.12.2019","Yes","Trabzonspor","Denizlispor",1,2,15,10,7,4,11,13,0,1,0,0,1.6,4.13,5.04,1.62,2.24,0,3,0.5865552,0.2272369,0.186208,1.986902,0.7858608,-1,5,3,-3,1.201042,-2,-1,0,0
"3276","T1",10,"20.12.2019","Yes","Antalyaspor","Ankaragucu",2,2,14,6,3,3,20,21,2,3,0,0,1.55,4.13,5.52,1.74,2.07,1,1,0.6038284,0.2266184,0.1695533,2.038103,0.7352781,0,8,0,0,1.302825,-1,-1,0,0
"3277","T1",10,"21.12.2019","Yes","Yeni Malatyaspor","Rizespor",0,2,11,7,5,3,11,12,2,3,0,0,1.64,4.13,4.66,1.6,2.3,0,3,0.5717469,0.2270375,0.2012156,1.942278,0.8306844,-2,4,2,-3,1.111594,-1,-1,0,0
"3278","T1",10,"21.12.2019","Yes","Kasimpasa","Gaziantep",3,4,7,6,4,5,12,15,4,2,0,0,2.03,3.66,3.32,1.59,2.32,0,3,0.4616612,0.256058,0.2822808,1.641042,1.1029,-1,1,-1,-3,0.5381412,-3,2,0,0
"3279","T1",10,"21.12.2019","Yes","Goztep","Galatasaray",2,1,14,12,6,1,6,9,4,2,0,0,2.89,3.25,2.41,2,1.8,3,0,0.3237922,0.287926,0.3882819,1.259302,1.452772,1,2,5,3,-0.1934692,-3,2,0,0
"3280","T1",10,"22.12.2019","Yes","Genclerbirligi","Sivasspor",2,2,11,9,7,6,16,11,3,2,0,0,2.52,3.6,2.53,1.59,2.32,1,1,0.3709134,0.2596393,0.3694473,1.372379,1.367981,0,2,1,0,0.004398182,5,1,0,0
"3281","T1",10,"22.12.2019","Yes","Kayserispor","Buyuksehyr",1,4,11,18,5,9,12,6,3,2,0,0,7.81,4.98,1.35,1.65,2.21,0,3,0.1197109,0.1877394,0.6925497,0.5468721,2.265389,-3,-7,-4,-3,-1.718516,6,1,0,0
"3282","T1",10,"22.12.2019","Yes","Fenerbahce","Besiktas",3,1,14,5,5,2,18,21,2,3,0,0,2.07,3.6,3.26,1.59,2.31,3,0,0.452495,0.2601846,0.2873204,1.61767,1.122146,2,9,3,3,0.4955236,-3,-1,0,0
"3283","T1",10,"23.12.2019","Yes","Denizlispor","Alanyaspor",1,5,7,14,3,10,12,21,1,3,0,0,3.21,3.32,2.19,2.01,1.78,0,3,0.2913226,0.2816703,0.4270071,1.155638,1.562692,-4,-7,-7,-3,-0.4070535,-9,-2,0,0
"3284","T1",10,"23.12.2019","Yes","Konyaspor","Trabzonspor",0,1,8,5,3,2,13,17,5,2,1,0,2.97,3.2,2.38,2,1.79,0,3,0.3148591,0.2922286,0.3929124,1.236806,1.470966,-1,3,1,-3,-0.2341599,-4,3,1,0
"3285","T1",10,"27.12.2019","Yes","Besiktas","Genclerbirligi",4,1,17,4,6,3,12,9,2,4,0,2,1.51,4.35,5.72,1.63,2.26,3,0,0.6206891,0.2154576,0.1638533,2.077525,0.7070174,3,13,3,3,1.370508,3,-2,-2,0
"3286","T1",10,"28.12.2019","Yes","Ankaragucu","Denizlispor",2,2,16,7,5,3,22,9,2,1,0,1,2.82,3.4,2.39,1.82,1.99,1,1,0.3323001,0.2756136,0.3920863,1.272514,1.451873,0,9,2,0,-0.1793586,13,1,-1,0
"3287","T1",10,"28.12.2019","Yes","Buyuksehyr","Kasimpasa",5,1,14,18,9,6,21,12,2,3,0,0,1.38,4.96,7.05,1.45,2.69,3,0,0.6784396,0.1887594,0.1328009,2.224078,0.5871623,4,-4,3,3,1.636916,9,-1,0,0
"3288","T1",10,"28.12.2019","Yes","Trabzonspor","Kayserispor",6,2,21,6,13,3,8,10,0,2,0,0,1.12,8.56,18.1,1.29,3.43,3,0,0.83842,0.1096998,0.05188014,2.62496,0.2653402,4,15,10,3,2.35962,-2,-2,0,0
"3289","T1",10,"28.12.2019","Yes","Galatasaray","Antalyaspor",5,0,12,7,8,3,16,18,2,4,0,0,1.4,4.53,7.43,1.71,2.11,3,0,0.6677903,0.2063811,0.1258286,2.209752,0.5838669,5,5,5,3,1.625885,-2,-2,0,0
"3290","T1",10,"29.12.2019","Yes","Sivasspor","Goztep",1,0,10,3,4,0,17,13,1,1,0,0,1.74,3.72,4.47,1.78,2.02,3,0,0.5385019,0.2518799,0.2096182,1.867386,0.8807345,1,7,4,3,0.9866511,4,0,0,0
"3291","T1",10,"29.12.2019","Yes","Alanyaspor","Konyaspor",2,1,16,4,7,2,8,13,1,4,0,0,1.53,3.93,6.31,2.17,1.67,3,0,0.6128257,0.238581,0.1485932,2.077058,0.6843608,1,12,5,3,1.392697,-5,-3,0,0
"3292","T1",10,"29.12.2019","Yes","Gaziantep","Yeni Malatyaspor",1,1,6,7,3,6,15,19,5,4,1,1,2.36,3.52,2.78,1.64,2.22,1,1,0.3969238,0.2661193,0.3369569,1.456891,1.27699,0,-1,-3,0,0.1799007,-4,1,0,0
"3293","T1",10,"29.12.2019","Yes","Rizespor","Fenerbahce",1,2,5,12,4,4,17,13,3,2,0,0,4.49,3.85,1.71,1.65,2.21,0,3,0.2086827,0.2433728,0.5479446,0.8694208,1.887206,-1,-7,0,-3,-1.017786,4,1,0,0
"3294","T1",10,"17.01.2020","Yes","Ankaragucu","Konyaspor",0,1,6,5,1,2,18,14,0,1,0,0,2.83,3.11,2.55,2.18,1.67,0,3,0.3311509,0.3013366,0.3675125,1.294789,1.403874,-1,1,-1,-3,-0.109085,4,-1,0,0
"3295","T1",10,"18.01.2020","Yes","Alanyaspor","Kayserispor",5,1,16,9,8,5,10,17,0,2,0,1,1.19,6.84,12.09,1.33,3.2,3,0,0.7859133,0.1367305,0.07735623,2.49447,0.3687992,4,7,3,3,2.125671,-7,-2,-1,0
"3296","T1",10,"18.01.2020","Yes","Buyuksehyr","Yeni Malatyaspor",4,1,11,9,6,7,15,21,2,4,0,0,1.55,4.17,5.48,1.65,2.2,3,0,0.6043942,0.2246549,0.1709509,2.037837,0.7375076,3,2,-1,3,1.30033,-6,-2,0,0
"3297","T1",10,"18.01.2020","Yes","Gaziantep","Fenerbahce",0,2,10,10,3,6,15,19,5,5,0,1,4.17,3.95,1.73,1.61,2.27,0,3,0.223909,0.2363798,0.5397112,0.9081067,1.855513,-2,0,-3,-3,-0.9474067,-4,0,-1,0
"3298","T1",10,"19.01.2020","Yes","Antalyaspor","Goztep",0,3,8,6,2,3,16,8,4,2,1,0,2.48,3.14,2.88,2.07,1.73,0,3,0.3772275,0.2979377,0.3248348,1.42962,1.272442,-3,2,-1,-3,0.1571781,8,2,1,0
"3299","T1",10,"19.01.2020","Yes","Galatasaray","Denizlispor",2,1,14,4,4,2,15,10,1,4,0,0,1.3,5.25,9.01,1.55,2.38,3,0,0.7184408,0.1778996,0.1036596,2.333222,0.4888784,1,10,2,3,1.844344,5,-3,0,0
"3300","T1",10,"19.01.2020","Yes","Trabzonspor","Kasimpasa",6,0,12,3,9,2,15,14,1,4,0,1,1.47,4.83,5.48,1.34,3.15,3,0,0.6358912,0.1935321,0.1705767,2.101206,0.7052621,6,9,7,3,1.395944,1,-3,-1,0
"3301","T1",10,"19.01.2020","Yes","Besiktas","Sivasspor",1,2,12,9,7,5,5,21,2,6,0,1,1.86,3.7,3.82,1.58,2.33,0,3,0.5026101,0.2526635,0.2447264,1.760494,0.9868427,-1,3,2,-3,0.7736512,-16,-4,-1,0
"3302","T1",10,"20.01.2020","Yes","Rizespor","Genclerbirligi",2,0,8,7,4,3,19,14,1,1,0,0,2.37,3.31,2.89,1.85,1.93,3,0,0.3943091,0.2823301,0.3233608,1.465257,1.252412,2,1,1,3,0.2128451,5,0,0,0
"3303","T1",10,"24.01.2020","Yes","Genclerbirligi","Gaziantep",1,0,13,7,6,2,11,8,3,2,0,0,1.96,3.52,3.67,1.77,2.03,3,0,0.478268,0.2663083,0.2554238,1.701112,1.03258,1,6,4,3,0.6685326,3,1,0,0
"3304","T1",10,"25.01.2020","Yes","Kayserispor","Ankaragucu",1,1,12,8,5,2,20,15,5,6,0,1,2.68,3.54,2.43,1.77,2.03,1,1,0.3496573,0.2647123,0.3856303,1.313684,1.421603,0,4,3,0,-0.1079189,5,-1,-1,0
"3305","T1",10,"25.01.2020","Yes","Kasimpasa","Alanyaspor",1,2,4,12,2,4,23,21,3,1,1,0,3.67,3.93,1.85,1.49,2.55,0,3,0.2552566,0.2383694,0.506374,1.004139,1.757491,-1,-8,-2,-3,-0.753352,2,2,1,0
"3306","T1",10,"25.01.2020","Yes","Fenerbahce","Buyuksehyr",2,0,24,3,9,1,13,18,0,1,0,0,2.18,3.36,3.21,1.79,2,3,0,0.4295648,0.2787058,0.2917294,1.5674,1.153894,2,21,8,3,0.4135063,-5,-1,0,0
"3307","T1",10,"26.01.2020","Yes","Denizlispor","Antalyaspor",0,3,9,8,3,6,12,16,2,2,0,0,2.22,3.37,3.09,1.87,1.91,0,3,0.4206629,0.2771133,0.3022238,1.539102,1.183785,-3,1,-3,-3,0.3553172,-4,0,0,0
"3308","T1",10,"26.01.2020","Yes","Goztep","Besiktas",2,1,10,5,6,4,14,14,4,4,0,0,2.8,3.22,2.49,1.88,1.9,3,0,0.3339943,0.2904298,0.3755759,1.292413,1.417158,1,5,2,3,-0.1247449,0,0,0,0
"3309","T1",10,"26.01.2020","Yes","Konyaspor","Galatasaray",0,3,6,6,4,5,9,14,0,2,0,0,3.56,3.33,2.06,2.06,1.75,0,3,0.2633503,0.2815396,0.4551101,1.07159,1.64687,-3,0,-1,-3,-0.5752797,-5,-2,0,0
"3310","T1",10,"27.01.2020","Yes","Sivasspor","Rizespor",1,1,17,5,5,3,10,16,1,5,0,0,1.49,4.31,5.94,1.59,2.3,1,1,0.6263508,0.2165343,0.1571149,2.095587,0.6878791,0,12,2,0,1.407708,-6,-4,0,0
"3311","T1",10,"31.01.2020","Yes","Buyuksehyr","Genclerbirligi",3,1,9,14,3,5,11,13,1,1,0,0,1.43,4.51,6.82,1.64,2.23,3,0,0.6549858,0.2076784,0.1373357,2.172636,0.6196856,2,-5,-2,3,1.55295,-2,0,0,0
"3312","T1",10,"01.02.2020","Yes","Antalyaspor","Konyaspor",0,0,6,15,2,3,16,10,3,0,0,0,2.2,3.17,3.36,2.26,1.62,1,1,0.4257551,0.2954767,0.2787682,1.572742,1.131781,0,-9,-1,0,0.4409606,6,3,0,0
"3313","T1",10,"01.02.2020","Yes","Rizespor","Besiktas",1,2,14,7,4,2,15,10,3,0,0,0,3.46,3.49,2.03,1.75,2.05,0,3,0.2705747,0.2682488,0.4611765,1.079973,1.651778,-1,7,2,-3,-0.5718056,5,3,0,0
"3314","T1",10,"01.02.2020","Yes","Trabzonspor","Fenerbahce",2,1,16,23,4,9,20,14,4,5,0,1,2.54,3.57,2.52,1.63,2.23,3,0,0.3677253,0.2616309,0.3706438,1.364807,1.373562,1,-7,-5,3,-0.008755365,6,-1,-1,0
"3315","T1",10,"02.02.2020","Yes","Ankaragucu","Kasimpasa",1,1,11,19,3,3,14,15,3,3,0,0,2.44,3.56,2.64,1.62,2.26,1,1,0.3831953,0.2626394,0.3541653,1.412225,1.325135,0,-8,0,0,0.08708983,-1,0,0,0
"3316","T1",10,"02.02.2020","Yes","Alanyaspor","Yeni Malatyaspor",2,1,14,12,7,2,12,17,2,3,1,0,1.48,4.4,5.99,1.73,2.09,3,0,0.6315356,0.2124256,0.1560388,2.107032,0.6805421,1,2,5,3,1.42649,-5,-1,1,0
"3317","T1",10,"02.02.2020","Yes","Gaziantep","Sivasspor",5,1,11,21,7,8,13,14,3,4,0,0,3.28,3.5,2.1,1.71,2.11,3,0,0.2857921,0.267828,0.44638,1.125204,1.606968,4,-10,-1,3,-0.4817637,-1,-1,0,0
"3318","T1",10,"02.02.2020","Yes","Galatasaray","Kayserispor",4,1,11,10,5,2,16,10,2,1,0,0,1.14,7.96,15.5,1.34,3.13,3,0,0.8218517,0.1177024,0.06044587,2.583258,0.29904,3,1,3,3,2.284218,6,1,0,0
"3319","T1",10,"03.02.2020","Yes","Denizlispor","Goztep",1,1,19,8,7,3,11,14,4,4,0,0,3.02,3.34,2.27,1.91,1.87,1,1,0.3091584,0.2795384,0.4113032,1.207014,1.513448,0,11,4,0,-0.3064345,-3,0,0,0
"3320","T1",10,"07.02.2020","Yes","Yeni Malatyaspor","Ankaragucu",0,1,12,15,2,7,7,16,1,2,1,0,1.58,3.93,5.53,1.69,2.14,0,3,0.5925048,0.2382081,0.1692871,2.015723,0.7460694,-1,-3,-5,-3,1.269653,-9,-1,1,0
"3321","T1",10,"08.02.2020","Yes","Konyaspor","Denizlispor",0,0,20,10,5,2,14,18,2,1,0,0,1.92,3.32,4.1,2.13,1.7,1,1,0.4886138,0.2825719,0.2288143,1.748413,0.9690147,0,10,3,0,0.7793987,-4,1,0,0
"3322","T1",10,"08.02.2020","Yes","Besiktas","Gaziantep",3,0,17,11,8,2,14,13,3,2,0,0,1.39,4.65,7.53,1.58,2.34,3,0,0.6740726,0.201497,0.1244304,2.223715,0.5747882,3,6,6,3,1.648927,1,1,0,0
"3323","T1",10,"08.02.2020","Yes","Genclerbirligi","Trabzonspor",0,2,13,15,2,7,19,11,8,1,0,1,3.22,3.58,2.1,1.6,2.31,0,3,0.2913095,0.2620158,0.4466746,1.135944,1.60204,-2,-2,-5,-3,-0.4660953,8,7,-1,0
"3324","T1",10,"08.02.2020","Yes","Fenerbahce","Alanyaspor",1,1,15,5,3,2,11,13,3,4,0,0,1.79,3.69,4.2,1.73,2.07,1,1,0.5232081,0.2538056,0.2229863,1.82343,0.9227645,0,10,1,0,0.9006654,-2,-1,0,0
"3325","T1",10,"09.02.2020","Yes","Kayserispor","Antalyaspor",2,2,15,11,9,3,16,15,4,4,0,0,2.99,3.45,2.25,1.75,2.06,1,1,0.3129346,0.27121,0.4158554,1.210014,1.518776,0,4,6,0,-0.3087622,1,0,0,0
"3326","T1",10,"09.02.2020","Yes","Sivasspor","Buyuksehyr",1,1,14,8,4,1,12,11,0,3,0,0,2.46,3.39,2.72,1.72,2.1,1,1,0.3802172,0.2759098,0.3438729,1.416562,1.307529,0,6,3,0,0.1090329,1,-3,0,0
"3327","T1",10,"09.02.2020","Yes","Kasimpasa","Galatasaray",0,3,11,19,3,8,12,11,2,0,0,0,4.42,4.09,1.67,1.54,2.42,0,3,0.2115332,0.2286006,0.5598662,0.8632001,1.908199,-3,-8,-5,-3,-1.044999,1,2,0,0
"3328","T1",10,"14.02.2020","Yes","Buyuksehyr","Besiktas",1,0,6,19,3,7,14,11,3,3,0,0,2.2,3.5,3.06,1.66,2.2,3,0,0.4259804,0.2677591,0.3062604,1.5457,1.18654,1,-13,-4,3,0.35916,3,0,0,0
"3329","T1",10,"15.02.2020","Yes","Denizlispor","Kayserispor",0,1,9,17,3,4,11,19,0,0,0,0,1.73,3.74,4.46,1.84,1.95,0,3,0.5404064,0.2499741,0.2096195,1.871193,0.8788326,-1,-8,-1,-3,0.9923606,-8,0,0,0
"3330","T1",10,"15.02.2020","Yes","Konyaspor","Goztep",1,3,14,12,5,3,10,12,2,0,0,0,2.7,3.11,2.66,2.38,1.56,0,3,0.3468363,0.3011119,0.3520519,1.341621,1.357267,-2,2,2,-3,-0.01564675,-2,2,0,0
"3331","T1",10,"15.02.2020","Yes","Ankaragucu","Fenerbahce",2,1,9,16,3,7,13,12,1,2,0,0,6.58,4.55,1.43,1.57,2.36,3,0,0.1418932,0.2051994,0.6529073,0.6308791,2.163921,1,-7,-4,3,-1.533042,1,-1,0,0
"3332","T1",10,"16.02.2020","Yes","Alanyaspor","Genclerbirligi",0,1,23,14,11,6,11,8,3,2,0,0,1.46,4.35,6.45,1.64,2.21,0,3,0.6402095,0.2148749,0.1449156,2.135503,0.6496218,-1,9,5,-3,1.485882,3,1,0,0
"3333","T1",10,"16.02.2020","Yes","Trabzonspor","Sivasspor",2,1,12,18,4,3,9,16,2,1,0,0,1.91,3.51,3.87,1.71,2.11,3,0,0.4907495,0.267046,0.2422045,1.739294,0.9936596,1,-6,1,3,0.7456349,-7,1,0,0
"3334","T1",10,"16.02.2020","Yes","Galatasaray","Yeni Malatyaspor",1,0,18,10,3,4,8,20,2,3,0,0,1.41,4.53,7.2,1.66,2.18,3,0,0.6635297,0.2065291,0.1299412,2.197118,0.5963528,1,8,-1,3,1.600765,-12,-1,0,0
"3335","T1",10,"17.02.2020","Yes","Antalyaspor","Kasimpasa",3,1,16,6,9,3,12,15,4,3,0,0,2.03,3.62,3.32,1.59,2.31,3,0,0.4603587,0.2581569,0.2814844,1.639233,1.10261,2,10,6,3,0.5366229,-3,1,0,0
"3336","T1",10,"17.02.2020","Yes","Gaziantep","Rizespor",2,0,21,6,3,1,14,14,3,4,0,1,2.21,3.35,3.15,1.84,1.94,3,0,0.4234975,0.279382,0.2971205,1.549875,1.170743,2,15,2,3,0.3791311,0,-1,-1,0
"3337","T1",10,"21.02.2020","Yes","Sivasspor","Alanyaspor",1,0,5,11,2,4,17,13,5,2,0,0,2.19,3.47,3.1,1.78,2.01,3,0,0.4277937,0.2699908,0.3022155,1.553372,1.176637,1,-6,-2,3,0.3767344,4,3,0,0
"3338","T1",10,"22.02.2020","Yes","Kayserispor","Konyaspor",2,2,17,11,6,4,15,15,3,5,0,0,2.62,3.24,2.64,2,1.79,1,1,0.3570069,0.2886908,0.3543023,1.359712,1.351598,0,6,2,0,0.008113793,0,-2,0,0
"3339","T1",10,"22.02.2020","Yes","Goztep","Gaziantep",1,1,12,17,4,5,13,11,2,3,0,0,1.73,3.74,4.49,1.8,1.99,1,1,0.5411643,0.2503247,0.208511,1.873818,0.8758576,0,-5,-1,0,0.9979601,2,-1,0,0
"3340","T1",10,"22.02.2020","Yes","Besiktas","Trabzonspor",2,2,29,9,9,3,12,17,2,2,0,0,2.12,3.64,3.11,1.61,2.27,1,1,0.4416786,0.2572414,0.30108,1.582277,1.160481,0,20,6,0,0.421796,-5,0,0,0
"3341","T1",10,"23.02.2020","Yes","Yeni Malatyaspor","Antalyaspor",1,2,18,9,8,3,10,14,2,2,0,1,1.97,3.51,3.6,1.79,2,0,3,0.4742763,0.2661892,0.2595345,1.689018,1.044793,-1,9,5,-3,0.6442252,-4,0,-1,0
"3342","T1",10,"23.02.2020","Yes","Genclerbirligi","Ankaragucu",1,0,14,10,5,5,20,15,3,3,0,0,1.75,3.73,4.36,1.78,2.02,3,0,0.5346035,0.2508194,0.2145771,1.85463,0.8945507,1,4,0,3,0.9600793,5,0,0,0
"3343","T1",10,"23.02.2020","Yes","Fenerbahce","Galatasaray",1,3,10,14,4,7,22,14,5,8,2,1,2.01,3.5,3.52,1.77,2.03,0,3,0.4661334,0.2676938,0.2661728,1.666094,1.066212,-2,-4,-3,-3,0.599882,8,-3,1,0
"3344","T1",10,"24.02.2020","Yes","Kasimpasa","Denizlispor",2,0,14,8,5,3,11,13,2,1,0,0,2.01,3.57,3.4,1.64,2.2,3,0,0.4642091,0.2613614,0.2744295,1.653989,1.08465,2,6,2,3,0.5693388,-2,1,0,0
"3345","T1",10,"24.02.2020","Yes","Rizespor","Buyuksehyr",1,2,17,21,6,5,11,14,0,1,0,0,3.51,3.35,2.05,1.97,1.81,0,3,0.2659605,0.2786631,0.4553763,1.076545,1.644792,-1,-4,1,-3,-0.5682474,-3,-1,0,0
"3346","T1",10,"28.02.2020","Yes","Alanyaspor","Besiktas",1,2,8,18,2,5,10,11,1,0,0,0,2.38,3.56,2.73,1.67,2.17,0,3,0.393649,0.2631698,0.3431812,1.444117,1.292713,-1,-10,-3,-3,0.1514035,-1,1,0,0
"3347","T1",10,"29.02.2020","Yes","Konyaspor","Kasimpasa",0,0,10,8,3,0,14,12,1,0,0,0,1.94,3.5,3.74,1.88,1.91,1,1,0.4823921,0.2673831,0.2502248,1.714559,1.018057,0,2,3,0,0.696502,2,1,0,0
"3348","T1",10,"29.02.2020","Yes","Trabzonspor","Rizespor",5,2,17,18,6,3,11,8,3,2,1,0,1.45,4.44,6.52,1.6,2.29,3,0,0.6455906,0.2108348,0.1435746,2.147607,0.6415586,3,-1,3,3,1.506048,3,1,1,0
"3349","T1",10,"29.02.2020","Yes","Antalyaspor","Fenerbahce",2,2,12,17,4,4,15,10,6,1,1,0,3.58,3.54,1.96,1.76,2.04,1,1,0.2605639,0.2635081,0.475928,1.0452,1.691292,0,-5,0,0,-0.6460921,5,5,1,0
"3350","T1",10,"01.03.2020","Yes","Denizlispor","Yeni Malatyaspor",2,0,24,2,11,0,17,23,0,4,0,1,2.36,3.42,2.82,1.86,1.91,3,0,0.3957359,0.2730809,0.3311832,1.460289,1.266631,2,22,11,3,0.193658,-6,-4,-1,0
"3351","T1",10,"01.03.2020","Yes","Ankaragucu","Sivasspor",0,3,8,21,2,9,14,17,2,2,1,0,3.8,3.64,1.88,1.7,2.12,0,3,0.2459884,0.2568011,0.4972106,0.9947662,1.748433,-3,-13,-7,-3,-0.7536665,-3,0,1,0
"3352","T1",10,"01.03.2020","Yes","Galatasaray","Genclerbirligi",3,0,12,9,6,2,7,10,1,4,0,0,1.34,4.92,8.23,1.6,2.27,3,0,0.6967783,0.189773,0.1134487,2.280108,0.5301191,3,3,4,3,1.749989,-3,-3,0,0
"3353","T1",10,"02.03.2020","Yes","Buyuksehyr","Gaziantep",3,1,20,22,10,8,9,7,1,0,0,0,1.41,4.52,6.92,1.59,2.3,3,0,0.6597594,0.2058099,0.1344307,2.185088,0.6091021,2,-2,2,3,1.575986,2,1,0,0
"3354","T1",10,"02.03.2020","Yes","Kayserispor","Goztep",1,0,9,13,3,2,17,13,4,1,0,0,3.14,3.31,2.22,1.98,1.8,3,0,0.2973487,0.282077,0.4205743,1.174123,1.5438,1,-4,1,3,-0.3696768,4,3,0,0
"3355","T1",10,"06.03.2020","Yes","Besiktas","Ankaragucu",2,1,12,12,2,5,14,17,3,5,0,0,1.22,6.34,10.86,1.33,3.2,3,0,0.7664198,0.1474814,0.08609873,2.446741,0.4057776,1,0,-3,3,2.040963,-3,-2,0,0
"3356","T1",10,"07.03.2020","Yes","Yeni Malatyaspor","Konyaspor",1,1,8,9,4,3,15,14,1,2,1,1,2.33,3.23,3.02,2.02,1.77,1,1,0.4011416,0.2893684,0.30949,1.492793,1.217838,0,-1,1,0,0.2749547,1,-1,0,0
"3357","T1",10,"07.03.2020","Yes","Gaziantep","Trabzonspor",1,1,10,6,3,2,8,14,2,5,0,0,3.4,3.63,2.01,1.6,2.29,1,1,0.2756202,0.2581566,0.4662232,1.085017,1.656826,0,4,1,0,-0.571809,-6,-3,0,0
"3358","T1",10,"07.03.2020","Yes","Goztep","Buyuksehyr",0,3,17,12,1,4,10,10,1,2,0,1,2.86,3.23,2.44,2.07,1.74,0,3,0.327056,0.2895914,0.3833526,1.27076,1.439649,-3,5,-3,-3,-0.1688896,0,-1,-1,0
"3359","T1",10,"07.03.2020","Yes","Fenerbahce","Denizlispor",2,2,9,12,3,8,16,20,7,4,1,0,1.37,4.91,7.4,1.54,2.42,1,1,0.6829866,0.1905686,0.1264448,2.239528,0.569903,0,-3,-5,0,1.669625,-4,3,1,0
"3360","T1",10,"08.03.2020","Yes","Kasimpasa","Kayserispor",5,1,16,13,10,4,19,15,3,4,0,0,1.79,3.8,4.02,1.62,2.25,3,0,0.5218318,0.2458102,0.2323579,1.811306,0.9428841,4,3,6,3,0.8684216,4,-1,0,0
"3361","T1",10,"08.03.2020","Yes","Rizespor","Alanyaspor",1,1,12,22,4,5,10,15,1,3,0,0,2.84,3.39,2.37,1.81,1.97,1,1,0.3293731,0.275935,0.3946919,1.264054,1.460011,0,-10,-1,0,-0.1959562,-5,-2,0,0
"3362","T1",10,"08.03.2020","Yes","Sivasspor","Galatasaray",2,2,10,11,8,6,15,12,1,2,0,0,2.61,3.43,2.52,1.79,1.99,1,1,0.357571,0.2720876,0.3703414,1.344801,1.383112,0,-1,2,0,-0.03831118,3,-1,0,0
"3363","T1",10,"09.03.2020","Yes","Genclerbirligi","Antalyaspor",1,1,20,7,8,2,11,11,3,1,0,0,2.08,3.36,3.41,1.88,1.88,1,1,0.448628,0.2777221,0.2736499,1.623606,1.098672,0,13,6,0,0.5249342,0,2,0,0
"3364","T1",10,"11.03.2020","Yes","Yeni Malatyaspor","Trabzonspor",1,3,6,13,3,5,12,9,3,2,0,0,3.26,3.65,2.04,1.65,2.2,0,3,0.2864353,0.2558299,0.4577348,1.115136,1.629034,-2,-7,-2,-3,-0.5138986,3,1,0,0
"3365","T1",10,"13.03.2020","No","Ankaragucu","Rizespor",2,1,13,15,3,2,15,17,2,3,0,1,2.41,3.22,2.92,1.95,1.84,3,0,0.3885321,0.2907958,0.3206721,1.456392,1.252812,1,-2,1,3,0.2035802,-2,-1,-1,0
"3366","T1",10,"13.03.2020","No","Kasimpasa","Goztep",2,0,11,9,5,3,15,13,3,2,0,0,2.26,3.51,2.94,1.72,2.09,3,0,0.4144937,0.266882,0.3186244,1.510363,1.222755,2,2,2,3,0.2876078,2,1,0,0
"3367","T1",10,"14.03.2020","No","Denizlispor","Genclerbirligi",1,0,19,13,8,2,9,11,1,2,0,0,2.44,3.38,2.77,1.8,1.99,3,0,0.3842075,0.2773569,0.3384355,1.42998,1.292664,1,6,6,3,0.1373161,-2,-1,0,0
"3368","T1",10,"14.03.2020","No","Alanyaspor","Gaziantep",1,0,7,14,2,0,8,10,0,3,0,0,1.55,4.24,5.35,1.59,2.3,3,0,0.6041253,0.2208477,0.175027,2.033224,0.7459286,1,-7,2,3,1.287295,-2,-3,0,0
"3369","T1",10,"14.03.2020","No","Konyaspor","Fenerbahce",1,0,8,10,2,0,14,10,7,2,2,0,3.47,3.29,2.11,2.14,1.69,3,0,0.2703243,0.285114,0.4445617,1.096087,1.618799,1,-2,2,3,-0.5227123,4,5,2,0
"3370","T1",10,"15.03.2020","No","Kayserispor","Yeni Malatyaspor",2,1,15,15,5,8,19,9,3,1,0,0,2.52,3.31,2.7,1.93,1.85,3,0,0.371104,0.2825323,0.3463637,1.395844,1.321623,1,0,-3,3,0.07422079,10,2,0,0
"3371","T1",10,"15.03.2020","No","Trabzonspor","Buyuksehyr",1,1,17,12,2,5,6,14,1,1,0,0,2.31,3.41,2.92,1.73,2.08,1,1,0.4051018,0.2744238,0.3204744,1.489729,1.235847,0,5,-3,0,0.2538823,-8,0,0,0
"3372","T1",10,"15.03.2020","No","Galatasaray","Besiktas",0,0,16,3,4,2,15,15,1,2,0,0,1.96,3.54,3.61,1.74,2.06,1,1,0.4769607,0.26408,0.2589593,1.694962,1.040958,0,13,2,0,0.6540043,0,-1,0,0
"3373","T1",10,"16.03.2020","No","Antalyaspor","Sivasspor",1,0,17,8,6,3,12,17,1,4,0,1,2.89,3.48,2.28,1.73,2.06,3,0,0.3227885,0.2680629,0.4091486,1.236428,1.495509,1,9,3,3,-0.2590803,-5,-3,-1,0
"3374","T1",10,"17.03.2020","No","Goztep","Rizespor",2,0,14,4,4,1,11,17,1,2,0,0,1.97,3.48,3.76,1.87,1.92,3,0,0.4784625,0.2708537,0.2506838,1.706241,1.022905,2,10,3,3,0.683336,-6,-1,0,0
"3375","T1",10,"12.06.2020","No","Fenerbahce","Kayserispor",2,1,10,11,4,6,6,14,1,2,1,0,1.32,5.43,7.98,1.41,2.83,3,0,0.7099714,0.1725897,0.1174389,2.302504,0.5249064,1,-1,-2,3,1.777598,-8,-1,1,0
"3376","T1",10,"12.06.2020","No","Goztep","Trabzonspor",1,3,18,10,7,7,10,16,2,3,0,1,3.38,3.5,2.05,1.8,2,0,3,0.2766638,0.2671782,0.4561579,1.09717,1.635652,-2,8,0,-3,-0.5384823,-6,-1,-1,0
"3377","T1",10,"13.06.2020","No","Buyuksehyr","Alanyaspor",2,0,18,12,6,4,10,13,1,3,0,0,1.84,3.68,3.99,1.85,1.94,3,0,0.5099042,0.2549521,0.2351438,1.784665,0.9603834,2,6,2,3,0.8242812,-3,-2,0,0
"3378","T1",10,"13.06.2020","No","Besiktas","Antalyaspor",1,2,25,11,6,4,12,13,3,3,0,0,1.47,4.39,6.16,1.61,2.29,0,3,0.6355306,0.2128087,0.1516607,2.119401,0.6677908,-1,14,2,-3,1.45161,-1,0,0,0
"3379","T1",10,"13.06.2020","No","Yeni Malatyaspor","Kasimpasa",1,2,14,11,1,3,9,13,2,2,0,0,2.2,3.57,3.01,1.63,2.25,0,3,0.4260498,0.2625517,0.3113985,1.540701,1.196747,-1,3,-2,-3,0.3439538,-4,0,0,0
"3380","T1",10,"14.06.2020","No","Genclerbirligi","Konyaspor",2,1,12,19,3,3,15,13,2,2,0,0,2.36,3.22,2.99,2.12,1.71,3,0,0.3964766,0.2905853,0.3129381,1.480015,1.2294,1,-7,0,3,0.2506156,2,0,0,0
"3381","T1",10,"14.06.2020","No","Gaziantep","Ankaragucu",1,1,5,16,1,7,10,19,3,3,0,0,1.92,3.62,3.7,1.73,2.08,1,1,0.4879702,0.2588129,0.2532169,1.722723,1.018464,0,-11,-6,0,0.7042596,-9,0,0,0
"3382","T1",10,"14.06.2020","No","Rizespor","Galatasaray",2,0,8,15,4,3,17,18,4,3,0,1,5.03,4.03,1.61,1.75,2.07,3,0,0.1861378,0.2323259,0.5815363,0.7907394,1.976935,2,-7,1,3,-1.186195,-1,1,-1,0
"3383","T1",10,"15.06.2020","No","Sivasspor","Denizlispor",1,0,16,9,4,2,19,13,3,2,0,1,1.5,4.18,6.06,1.75,2.05,3,0,0.6225191,0.223392,0.1540889,2.090949,0.6856587,1,7,2,3,1.405291,6,1,-1,0
"3384","T1",10,"19.06.2020","No","Ankaragucu","Buyuksehyr",1,2,10,20,2,11,19,15,4,4,0,0,4.87,3.89,1.66,1.72,2.12,0,3,0.1928394,0.241421,0.5657396,0.8199391,1.93864,-1,-10,-9,-3,-1.118701,4,0,0,0
"3385","T1",10,"20.06.2020","No","Kayserispor","Genclerbirligi",2,0,15,16,4,3,14,9,4,3,0,0,2.36,3.39,2.89,1.77,2.04,3,0,0.3979665,0.2770504,0.324983,1.47095,1.252,2,-1,1,3,0.2189504,5,1,0,0
"3386","T1",10,"20.06.2020","No","Denizlispor","Besiktas",1,5,11,17,3,10,15,9,2,0,0,0,3.73,3.69,1.9,1.8,2,0,3,0.2516358,0.2543635,0.4940007,1.009271,1.736366,-4,-6,-7,-3,-0.7270949,6,2,0,0
"3387","T1",10,"20.06.2020","No","Yeni Malatyaspor","Goztep",2,1,7,10,3,2,10,11,3,1,0,0,2.43,3.43,2.75,1.85,1.95,3,0,0.3857889,0.273314,0.3408971,1.430681,1.296005,1,-3,1,3,0.1346754,-1,2,0,0
"3388","T1",10,"21.06.2020","No","Kasimpasa","Fenerbahce",2,0,12,13,5,6,15,11,4,0,0,0,3.26,3.59,2.08,1.61,2.3,3,0,0.2877378,0.2612884,0.4509737,1.124502,1.61421,2,-1,-1,3,-0.4897077,4,4,0,0
"3389","T1",10,"21.06.2020","No","Galatasaray","Gaziantep",3,3,10,10,6,6,18,14,6,1,1,0,1.5,4.23,6.04,1.71,2.12,1,1,0.6238481,0.2212227,0.1549292,2.092767,0.6860102,0,0,0,0,1.406757,4,5,1,0
"3390","T1",10,"21.06.2020","No","Konyaspor","Sivasspor",2,2,10,11,5,2,13,6,3,1,0,0,2.67,3.29,2.58,2.07,1.75,1,1,0.3513168,0.2851112,0.363572,1.339062,1.375827,0,-1,3,0,-0.03676571,7,2,0,0
"3391","T1",10,"22.06.2020","No","Alanyaspor","Trabzonspor",2,2,17,12,8,6,12,16,3,1,1,1,2.79,3.36,2.43,1.83,1.97,1,1,0.3357389,0.2787832,0.385478,1.286,1.435217,0,5,2,0,-0.1492173,-4,2,0,0
"3392","T1",10,"22.06.2020","No","Antalyaspor","Rizespor",3,1,10,9,7,4,16,15,2,2,0,0,2.27,3.37,3.04,1.89,1.9,3,0,0.4131717,0.2783086,0.3085197,1.517824,1.203868,2,1,3,3,0.3139562,1,0,0,0
"3393","T1",10,"26.06.2020","No","Besiktas","Konyaspor",3,0,15,4,4,2,14,6,3,0,0,1,1.69,3.8,4.84,1.79,2.02,3,0,0.5574414,0.2479147,0.1946438,1.920239,0.8318462,3,11,2,3,1.088393,8,3,-1,0
"3394","T1",10,"27.06.2020","No","Fenerbahce","Yeni Malatyaspor",3,2,18,8,4,4,12,14,3,4,0,1,1.61,4.09,4.96,1.56,2.41,3,0,0.5819909,0.2290967,0.1889124,1.975069,0.7958338,1,10,0,3,1.179236,-2,-1,-1,0
"3395","T1",10,"27.06.2020","No","Goztep","Alanyaspor",3,3,7,14,3,6,12,12,3,2,0,0,3.01,3.27,2.34,2.01,1.8,1,1,0.311836,0.2870417,0.4011223,1.22255,1.490409,0,-7,-3,0,-0.2678591,0,1,0,0
"3396","T1",10,"27.06.2020","No","Trabzonspor","Ankaragucu",1,1,8,9,2,4,14,28,4,8,0,1,1.33,5.29,8,1.48,2.62,1,1,0.7053839,0.177346,0.1172701,2.293498,0.5291563,0,-1,-2,0,1.764341,-14,-4,-1,0
"3397","T1",10,"28.06.2020","No","Rizespor","Denizlispor",2,2,16,5,7,1,19,11,2,1,0,0,2.02,3.37,3.65,2,1.8,1,1,0.4645046,0.2784271,0.2570683,1.671941,1.049632,0,11,6,0,0.6223089,8,1,0,0
"3398","T1",10,"28.06.2020","No","Sivasspor","Kayserispor",0,2,20,9,5,4,11,16,3,4,0,0,1.57,4.12,5.28,1.63,2.24,0,3,0.5957997,0.2270402,0.1771601,2.014439,0.7585206,-2,11,1,-3,1.255919,-5,-1,0,0
"3399","T1",10,"28.06.2020","No","Buyuksehyr","Galatasaray",1,1,11,21,4,6,15,9,7,1,1,0,2.04,3.45,3.5,1.92,1.88,1,1,0.4599474,0.2719689,0.2680836,1.651811,1.07622,0,-10,-2,0,0.5755914,6,6,1,0
"3400","T1",10,"28.06.2020","No","Gaziantep","Antalyaspor",1,1,20,8,3,1,16,13,2,3,0,1,2.45,3.46,2.7,1.73,2.09,1,1,0.3823361,0.2707293,0.3469346,1.417738,1.311533,0,12,2,0,0.1062045,3,-1,-1,0
"3401","T1",10,"29.06.2020","No","Genclerbirligi","Kasimpasa",0,2,12,16,3,9,13,9,2,2,0,0,2.45,3.32,2.79,1.74,2.07,0,3,0.3822501,0.2820822,0.3356677,1.428833,1.289085,-2,-4,-6,-3,0.1397474,4,0,0,0
"3402","T1",10,"03.07.2020","No","Denizlispor","Gaziantep",0,1,9,8,0,4,17,21,2,1,0,0,2.53,3.2,2.82,1.92,1.88,0,3,0.3720531,0.2941545,0.3337924,1.410314,1.295532,-1,1,-4,-3,0.1147824,-4,1,0,0
"3403","T1",10,"04.07.2020","No","Ankaragucu","Alanyaspor",1,4,19,14,8,7,14,10,2,2,0,0,3.67,3.55,1.95,1.79,2.02,0,3,0.2553721,0.2640044,0.4806234,1.030121,1.705875,-3,5,1,-3,-0.6757539,4,0,0,0
"3404","T1",10,"04.07.2020","No","Yeni Malatyaspor","Genclerbirligi",0,0,4,8,1,1,10,7,5,2,0,0,2.27,3.44,2.99,1.74,2.09,1,1,0.4133801,0.2727828,0.3138371,1.512923,1.214294,0,-4,0,0,0.2986291,3,3,0,0
"3405","T1",10,"04.07.2020","No","Antalyaspor","Buyuksehyr",0,2,11,16,3,4,24,12,1,2,0,0,3.39,3.4,2.1,1.66,2.21,0,3,0.2769052,0.2760908,0.4470041,1.106806,1.617103,-2,-5,-1,-3,-0.5102967,12,-1,0,0
"3406","T1",10,"04.07.2020","No","Fenerbahce","Goztep",2,1,11,10,5,4,12,9,2,2,1,0,1.62,4.06,4.95,1.62,2.28,3,0,0.5792778,0.2311404,0.1895818,1.968974,0.7998859,1,1,1,3,1.169088,3,0,1,0
"3407","T1",10,"05.07.2020","No","Kasimpasa","Sivasspor",0,0,6,16,2,5,19,9,3,2,1,0,2.34,3.69,2.72,1.54,2.44,1,1,0.4008915,0.2542239,0.3448846,1.456898,1.288878,0,-10,-3,0,0.1680207,10,1,1,0
"3408","T1",10,"05.07.2020","No","Galatasaray","Trabzonspor",1,3,9,10,4,5,13,16,2,3,1,0,2.23,3.57,2.98,1.62,2.28,0,3,0.4214125,0.2632352,0.3153523,1.527473,1.209292,-2,-1,-1,-3,0.3181806,-3,-1,1,0
"3409","T1",10,"05.07.2020","No","Konyaspor","Rizespor",1,0,13,5,4,1,14,17,3,2,0,0,2.16,3.22,3.42,2.17,1.68,3,0,0.434332,0.2913531,0.2743149,1.594349,1.114298,1,8,3,3,0.4800511,-3,1,0,0
"3410","T1",10,"06.07.2020","No","Kayserispor","Besiktas",3,1,9,12,4,8,18,15,1,1,0,0,4.25,3.91,1.74,1.55,2.41,3,0,0.2207756,0.2399735,0.5392508,0.9023004,1.857726,2,-3,-4,3,-0.9554256,3,0,0,0
"3411","T1",10,"07.07.2020","No","Genclerbirligi","Fenerbahce",1,1,17,15,6,7,13,14,3,4,0,0,3.67,3.75,1.91,1.63,2.26,1,1,0.2564015,0.2509316,0.4926668,1.020136,1.728932,0,2,-1,0,-0.7087959,-1,-1,0,0
"3412","T1",10,"07.07.2020","No","Buyuksehyr","Denizlispor",2,0,13,10,4,3,15,12,3,1,0,0,1.31,5.23,8.93,1.65,2.24,3,0,0.7157302,0.1792747,0.1049951,2.326465,0.4942601,2,3,1,3,1.832205,3,2,0,0
"3413","T1",10,"08.07.2020","No","Sivasspor","Yeni Malatyaspor",0,1,11,8,1,4,8,16,1,3,0,0,1.78,3.74,4.24,1.75,2.06,0,3,0.5274965,0.2510545,0.221449,1.833544,0.9154015,-1,3,-3,-3,0.9181425,-8,-2,0,0
"3414","T1",10,"08.07.2020","No","Trabzonspor","Antalyaspor",2,2,15,13,3,7,14,17,1,5,0,0,1.36,5.03,7.62,1.5,2.54,1,1,0.6902,0.1866147,0.1231853,2.257215,0.5561706,0,2,-4,0,1.701044,-3,-4,0,0
"3415","T1",10,"08.07.2020","No","Alanyaspor","Galatasaray",4,1,13,21,6,6,7,6,1,1,0,0,2.25,3.5,2.98,1.77,2.04,3,0,0.4170332,0.2680928,0.3148741,1.519192,1.212715,3,-8,0,3,0.3064774,1,0,0,0
"3416","T1",10,"08.07.2020","No","Goztep","Ankaragucu",2,2,10,16,5,7,14,21,2,4,0,0,2.19,3.45,3.13,2.01,1.79,1,1,0.428364,0.271918,0.299718,1.55701,1.171072,0,-6,-2,0,0.3859382,-7,-2,0,0
"3417","T1",10,"09.07.2020","No","Rizespor","Kayserispor",3,2,14,17,8,4,16,15,3,3,0,1,2.34,3.36,2.93,1.83,1.96,3,0,0.4007914,0.2791226,0.320086,1.481497,1.239381,1,-3,4,3,0.2421163,1,0,-1,0
"3418","T1",10,"09.07.2020","No","Besiktas","Kasimpasa",3,2,16,14,6,4,12,14,3,1,0,0,1.67,4.17,4.43,1.45,2.71,3,0,0.5626022,0.2253107,0.2120871,1.913117,0.8615719,1,2,2,3,1.051545,-2,2,0,0
"3419","T1",10,"09.07.2020","No","Gaziantep","Konyaspor",3,1,18,15,8,8,15,9,3,5,0,0,2.68,3.23,2.6,2.07,1.75,3,0,0.3495904,0.2900626,0.360347,1.338834,1.371104,2,3,0,3,-0.03226988,6,-2,0,0
"3420","T1",10,"11.07.2020","No","Goztep","Genclerbirligi",1,3,15,5,6,3,6,13,2,1,0,0,2.35,3.43,2.87,1.76,2.06,0,3,0.3993696,0.2736205,0.3270099,1.471729,1.25465,-2,10,3,-3,0.2170789,-7,1,0,0
"3421","T1",10,"12.07.2020","No","Ankaragucu","Galatasaray",1,0,14,18,5,2,12,10,4,4,0,0,3.83,3.83,1.84,1.55,2.43,3,0,0.2450067,0.2450067,0.5099867,0.9800266,1.774967,1,-4,3,3,-0.7949401,2,0,0,0
"3422","T1",10,"12.07.2020","No","Antalyaspor","Alanyaspor",1,0,12,11,2,4,10,11,1,2,0,0,3.35,3.68,2.02,1.6,2.32,3,0,0.2802108,0.2550832,0.464706,1.095716,1.649201,1,1,-2,3,-0.5534857,-1,-1,0,0
"3423","T1",10,"12.07.2020","No","Fenerbahce","Sivasspor",1,2,12,13,3,4,15,21,3,3,0,0,1.98,3.66,3.49,1.62,2.27,0,3,0.4743116,0.2565948,0.2690937,1.679529,1.063876,-1,-1,-1,-3,0.6156537,-6,0,0,0
"3424","T1",10,"13.07.2020","No","Kasimpasa","Rizespor",2,0,12,5,6,0,17,14,1,2,0,0,2,3.66,3.39,1.62,2.27,3,0,0.4680731,0.2557776,0.2761493,1.659997,1.084226,2,7,6,3,0.5757713,3,-1,0,0
"3425","T1",10,"13.07.2020","No","Kayserispor","Gaziantep",1,1,12,13,9,6,12,17,1,4,2,0,1.79,3.88,3.98,1.72,2.1,1,1,0.5232619,0.2414017,0.2353364,1.811187,0.9474109,0,-1,3,0,0.8637765,-5,-3,2,0
"3426","T1",10,"13.07.2020","No","Denizlispor","Trabzonspor",2,1,13,23,5,4,13,20,0,3,0,0,5.58,4.25,1.53,1.59,2.32,3,0,0.1677852,0.2202921,0.6119226,0.7236478,2.05606,1,-10,1,3,-1.332412,-7,-3,0,0
"3427","T1",10,"13.07.2020","No","Konyaspor","Buyuksehyr",4,3,16,17,5,5,8,10,4,3,0,0,4.41,3.36,1.85,2.1,1.72,3,0,0.2129343,0.2794763,0.5075894,0.9182793,1.802244,1,-1,0,3,-0.8839652,-2,1,0,0
"3428","T1",10,"13.07.2020","No","Yeni Malatyaspor","Besiktas",0,1,13,6,2,3,13,14,0,2,0,0,3.71,3.79,1.88,1.57,2.38,0,3,0.2530175,0.2476767,0.4993058,1.006729,1.745594,-1,7,-1,-3,-0.7388649,-1,-2,0,0
"3429","T1",10,"18.07.2020","No","Galatasaray","Goztep",3,1,14,10,3,2,16,11,2,2,0,0,1.43,4.58,6.54,1.59,2.33,3,0,0.6532184,0.2039525,0.1428291,2.163608,0.6324398,2,4,1,3,1.531168,5,0,0,0
"3430","T1",10,"18.07.2020","No","Gaziantep","Kasimpasa",2,2,11,11,5,4,12,10,2,0,0,0,2.58,3.66,2.46,1.49,2.58,1,1,0.363148,0.2559895,0.3808625,1.345433,1.398577,0,0,1,0,-0.0531436,2,2,0,0
"3431","T1",10,"19.07.2020","No","Alanyaspor","Denizlispor",1,0,19,10,4,2,7,14,1,1,0,0,1.58,4.06,5.24,1.68,2.15,3,0,0.5914747,0.2301798,0.1783454,2.004604,0.7652161,1,9,2,3,1.239388,-7,0,0,0
"3432","T1",10,"19.07.2020","No","Ankaragucu","Antalyaspor",0,1,19,9,6,5,19,14,4,3,0,1,1.85,3.58,4.03,1.94,1.85,0,3,0.5061198,0.2615423,0.2323379,1.779902,0.9585559,-1,10,1,-3,0.8213458,5,1,-1,0
"3433","T1",10,"19.07.2020","No","Besiktas","Fenerbahce",2,0,13,17,7,5,18,19,3,5,0,1,2.19,3.52,3.06,1.63,2.25,3,0,0.4277443,0.266125,0.3061307,1.549358,1.184517,2,-4,2,3,0.3648407,-1,-2,-1,0
"3434","T1",10,"19.07.2020","No","Buyuksehyr","Kayserispor",1,0,20,6,4,3,12,12,2,0,0,0,1.41,4.8,6.68,1.5,2.52,3,0,0.6645278,0.1952051,0.1402671,2.188789,0.6160064,1,14,1,3,1.572782,0,2,0,0
"3435","T1",10,"19.07.2020","No","Rizespor","Yeni Malatyaspor",3,0,12,13,9,4,16,16,3,1,0,0,2.49,3.33,2.73,1.87,1.92,3,0,0.3759631,0.2811255,0.3429114,1.409015,1.30986,3,-1,5,3,0.0991551,0,2,0,0
"3436","T1",10,"19.07.2020","No","Sivasspor","Genclerbirligi",2,0,14,9,6,5,14,9,1,1,0,0,1.66,3.88,4.78,1.76,2.05,3,0,0.5633437,0.2410182,0.1956382,1.931049,0.8279327,2,5,1,3,1.103116,5,0,0,0
"3437","T1",10,"19.07.2020","No","Trabzonspor","Konyaspor",3,4,16,9,7,6,15,8,2,0,0,0,1.52,4.3,5.55,1.53,2.44,0,3,0.6144913,0.2172155,0.1682931,2.06069,0.7220949,-1,7,1,-3,1.338595,7,2,0,0
"3438","T1",10,"24.07.2020","No","Antalyaspor","Galatasaray",2,2,13,8,7,3,12,12,0,1,0,0,3.11,3.64,2.13,1.53,2.48,1,1,0.3017056,0.2577759,0.4405185,1.162893,1.579331,0,5,4,0,-0.4164387,0,-1,0,0
"3439","T1",10,"25.07.2020","No","Denizlispor","Ankaragucu",0,1,18,6,5,2,12,11,2,1,0,0,1.54,4.3,5.22,1.66,2.19,0,3,0.6049026,0.2166395,0.1784579,2.031347,0.7520131,-1,12,3,-3,1.279334,1,1,0,0
"3440","T1",10,"25.07.2020","No","Fenerbahce","Rizespor",3,1,9,17,6,10,12,15,1,0,0,0,2.4,3.37,2.81,1.61,2.26,3,0,0.3896723,0.2775114,0.3328162,1.446528,1.27596,2,-8,-4,3,0.1705683,-3,1,0,0
"3441","T1",10,"25.07.2020","No","Genclerbirligi","Besiktas",0,3,14,10,4,5,15,12,2,3,0,0,3.57,4.23,1.82,1.55,2.39,0,3,0.2627769,0.2217762,0.5154469,1.010107,1.768117,-3,4,-1,-3,-0.7580102,3,-1,0,0
"3442","T1",10,"25.07.2020","No","Goztep","Sivasspor",3,1,8,25,3,6,13,14,3,3,1,0,4.4,3.93,1.7,1.68,2.16,3,0,0.2124122,0.2378152,0.5497727,0.8750517,1.887133,2,-17,-3,3,-1.012082,-1,0,1,0
"3443","T1",10,"25.07.2020","No","Kayserispor","Trabzonspor",1,2,22,16,6,8,18,14,2,1,0,0,3.01,3.65,2.16,1.51,2.5,0,3,0.310735,0.25625,0.433015,1.188455,1.555295,-1,6,-2,-3,-0.36684,4,1,0,0
"3444","T1",10,"25.07.2020","No","Konyaspor","Alanyaspor",2,3,13,17,4,5,9,10,1,2,0,0,2.83,3.59,2.29,1.57,2.35,0,3,0.3306759,0.2606721,0.4086519,1.2527,1.486628,-1,-4,-1,-3,-0.233928,-1,-1,0,0
"3445","T1",10,"25.07.2020","No","Yeni Malatyaspor","Gaziantep",0,1,9,12,3,7,14,9,1,0,0,0,1.7,3.91,4.4,1.9,1.87,0,3,0.5491047,0.2387412,0.2121541,1.886055,0.8752035,-1,-3,-4,-3,1.010852,5,1,0,0
"3446","T1",10,"26.07.2020","No","Kasimpasa","Buyuksehyr",3,2,15,16,5,4,6,7,1,2,0,0,2.8,3.58,2.32,1.55,2.39,3,0,0.3345579,0.2616654,0.4037767,1.265339,1.472996,1,-1,1,3,-0.2076566,-1,-1,0,0
"3447","P1",10,"09.08.2019","Yes","Portimonense","Belenenses",0,0,16,8,5,2,19,15,1,1,0,0,1.98,3.38,3.78,2.03,1.77,1,1,0.4740216,0.2776813,0.248297,1.699746,1.022572,0,8,3,0,0.6771738,4,0,0,0
"3448","P1",10,"10.08.2019","Yes","Santa Clara","Famalicao",0,2,22,14,6,6,14,22,0,3,0,0,2.04,3.18,3.77,2.24,1.63,0,3,0.4581642,0.2939167,0.2479191,1.668409,1.037674,-2,8,0,-3,0.6307354,-8,-3,0,0
"3449","P1",10,"10.08.2019","Yes","Gil Vicente","Porto",2,1,13,16,7,5,15,19,3,3,0,0,9.88,5.21,1.29,1.65,2.19,3,0,0.09473942,0.1796594,0.7256012,0.4638777,2.356463,1,-3,2,3,-1.892585,-4,0,0,0
"3450","P1",10,"10.08.2019","Yes","Benfica","Pacos Ferreira",5,0,15,7,7,0,15,11,0,4,0,1,1.12,8.26,18.66,1.44,2.71,3,0,0.8363899,0.1134088,0.05020132,2.622578,0.2640128,5,8,7,3,2.358566,4,-4,-1,0
"3451","P1",10,"11.08.2019","Yes","Boavista","Aves",2,1,8,17,3,2,24,20,5,3,0,0,2.26,3.04,3.37,2.52,1.5,3,0,0.4142426,0.3079567,0.2778007,1.550685,1.141359,1,-9,1,3,0.4093258,4,2,0,0
"3452","P1",10,"11.08.2019","Yes","Maritimo","Sp Lisbon",1,1,10,17,3,2,14,14,4,4,0,0,5.07,3.68,1.67,1.96,1.83,1,1,0.1847184,0.2544898,0.5607918,0.808645,1.936865,0,-7,1,0,-1.12822,0,0,0,0
"3453","P1",10,"11.08.2019","Yes","Sp Braga","Moreirense",3,1,19,11,9,4,14,11,2,2,0,0,1.43,4.3,7.43,1.9,1.89,3,0,0.6557286,0.2180679,0.1262035,2.185254,0.5966784,2,8,5,3,1.588575,3,0,0,0
"3454","P1",10,"12.08.2019","Yes","Setubal","Tondela",0,0,7,7,4,2,23,18,7,2,1,0,2.15,3.15,3.46,2.31,1.59,1,1,0.4340415,0.2962506,0.2697079,1.598375,1.105374,0,0,2,0,0.4930009,5,5,1,0
"3455","P1",10,"16.08.2019","Yes","Famalicao","Rio Ave",1,0,16,13,4,1,16,16,3,5,0,1,2.78,3.43,2.43,1.77,2.05,3,0,0.3384635,0.2743232,0.3872134,1.289714,1.435963,1,3,3,3,-0.1462496,0,-2,-1,0
"3456","P1",10,"17.08.2019","Yes","Moreirense","Gil Vicente",3,0,12,16,4,2,17,16,0,3,0,0,2.24,3.18,3.28,2.23,1.64,3,0,0.4188781,0.2950588,0.2860631,1.551693,1.153248,3,-4,2,3,0.398445,1,-3,0,0
"3457","P1",10,"17.08.2019","Yes","Belenenses","Benfica",0,2,7,21,1,5,11,10,7,1,0,0,14.32,6.88,1.18,1.5,2.53,0,3,0.06571602,0.136781,0.7975029,0.3339291,2.52929,-2,-14,-4,-3,-2.195361,1,6,0,0
"3458","P1",10,"17.08.2019","Yes","Porto","Setubal",4,0,23,6,10,5,16,16,0,2,0,0,1.16,6.97,16.64,1.61,2.27,3,0,0.8089705,0.134635,0.05639458,2.561546,0.3038187,4,17,5,3,2.257728,0,-2,0,0
"3459","P1",10,"18.08.2019","Yes","Aves","Maritimo",3,1,11,10,4,1,25,14,2,4,0,0,2.27,3.16,3.25,2.27,1.61,3,0,0.4137675,0.2972317,0.2890007,1.538534,1.164234,2,1,3,3,0.3743005,11,-2,0,0
"3460","P1",10,"18.08.2019","Yes","Pacos Ferreira","Santa Clara",0,1,19,6,3,3,24,20,3,1,0,0,2.36,3.21,3.03,2.17,1.67,0,3,0.3977598,0.292434,0.3098063,1.485713,1.221853,-1,13,0,-3,0.2638604,4,2,0,0
"3461","P1",10,"18.08.2019","Yes","Guimaraes","Boavista",1,1,16,5,4,2,14,13,3,3,0,0,1.63,3.72,5.42,2.2,1.66,1,1,0.5750729,0.2519809,0.1729463,1.977199,0.7708197,0,11,2,0,1.20638,1,0,0,0
"3462","P1",10,"18.08.2019","Yes","Sp Lisbon","Sp Braga",2,1,11,21,6,7,13,16,3,5,0,0,1.97,3.4,3.78,2.02,1.79,3,0,0.4760599,0.2758347,0.2481053,1.704015,1.020151,1,-10,-1,3,0.6838639,-3,-2,0,0
"3463","P1",10,"19.08.2019","Yes","Tondela","Portimonense",1,2,8,14,3,6,11,16,1,1,0,0,2.71,3.27,2.55,2.09,1.73,0,3,0.3458423,0.2866155,0.3675422,1.324142,1.389242,-1,-6,-3,-3,-0.06509973,-5,0,0,0
"3464","P1",10,"23.08.2019","Yes","Setubal","Moreirense",0,0,18,5,1,2,18,27,3,1,0,0,2.57,3.02,2.89,2.41,1.55,1,1,0.364928,0.3105513,0.3245207,1.405335,1.284113,0,13,-1,0,0.1212218,-9,2,0,0
"3465","P1",10,"23.08.2019","Yes","Rio Ave","Aves",5,1,17,7,9,1,17,15,0,3,0,0,1.8,3.61,4.34,1.94,1.86,3,0,0.5226404,0.2605963,0.2167633,1.828517,0.9108862,4,10,8,3,0.9176313,2,-3,0,0
"3466","P1",10,"24.08.2019","Yes","Benfica","Porto",0,2,6,11,1,5,15,12,2,5,0,0,1.9,3.43,4.03,2,1.81,0,3,0.4937297,0.2734946,0.2327758,1.754684,0.9718219,-2,-5,-4,-3,0.7828617,3,-3,0,0
"3467","P1",10,"24.08.2019","Yes","Boavista","Pacos Ferreira",1,1,15,14,2,5,17,17,5,2,0,0,2.14,3.13,3.58,2.49,1.52,1,1,0.4383136,0.2996777,0.2620087,1.614619,1.085704,0,1,-3,0,0.5289148,0,3,0,0
"3468","P1",10,"25.08.2019","Yes","Maritimo","Tondela",2,3,15,10,5,7,11,13,2,5,0,0,2.02,3.16,3.94,2.29,1.6,0,3,0.4646989,0.2970544,0.2382467,1.691151,1.011794,-1,5,-2,-3,0.6793568,-2,-3,0,0
"3469","P1",10,"25.08.2019","Yes","Santa Clara","Belenenses",0,0,15,6,3,1,10,12,2,1,0,0,2.11,3.2,3.58,2.17,1.67,1,1,0.4446894,0.2932171,0.2620935,1.627285,1.079498,0,9,2,0,0.5477878,-2,1,0,0
"3470","P1",10,"25.08.2019","Yes","Portimonense","Sp Lisbon",1,3,16,11,2,6,16,13,1,0,0,0,4.15,3.54,1.85,1.81,1.99,0,3,0.2264719,0.2654967,0.5080315,0.9449123,1.789591,-2,5,-4,-3,-0.8446788,3,1,0,0
"3471","P1",10,"25.08.2019","Yes","Gil Vicente","Sp Braga",1,1,15,8,6,4,13,13,2,2,0,0,4.85,3.55,1.73,2.03,1.77,1,1,0.1934361,0.2642719,0.542292,0.8445802,1.891148,0,7,2,0,-1.046568,0,0,0,0
"3472","P1",10,"25.08.2019","Yes","Guimaraes","Famalicao",1,1,18,15,4,3,16,12,4,1,0,0,1.73,3.54,4.9,2.07,1.75,1,1,0.5429584,0.2653441,0.1916976,1.894219,0.8404367,0,3,1,0,1.053782,4,3,0,0
"3473","P1",10,"30.08.2019","Yes","Moreirense","Portimonense",1,0,9,10,3,2,21,23,2,5,0,1,2.3,3.27,3.12,2.09,1.74,3,0,0.4097448,0.2881997,0.3020555,1.517434,1.194366,1,-1,1,3,0.323068,-2,-3,-1,0
"3474","P1",10,"30.08.2019","Yes","Belenenses","Boavista",0,1,9,12,3,7,17,20,3,4,1,0,2.43,3.04,3.09,2.4,1.56,0,3,0.386735,0.3091336,0.3041314,1.469339,1.221528,-1,-3,-4,-3,0.2478108,-3,-1,1,0
"3475","P1",10,"31.08.2019","Yes","Aves","Famalicao",2,3,18,12,6,7,21,11,5,3,1,1,2.41,3.26,2.9,2.02,1.78,0,3,0.3890599,0.2876179,0.3233222,1.454798,1.257584,-1,6,-1,-3,0.1972131,10,2,0,0
"3476","P1",10,"31.08.2019","Yes","Pacos Ferreira","Maritimo",0,1,21,9,3,2,19,15,1,4,0,1,2.04,3.24,3.74,2.27,1.61,0,3,0.4597523,0.2894737,0.250774,1.668731,1.041796,-1,12,1,-3,0.626935,4,-3,-1,0
"3477","P1",10,"31.08.2019","Yes","Sp Lisbon","Rio Ave",2,3,9,6,5,3,18,14,2,2,1,0,1.37,4.92,7.54,1.47,2.6,0,3,0.6848598,0.1907028,0.1244374,2.245282,0.564015,-1,3,2,-3,1.681267,4,0,1,0
"3478","P1",10,"31.08.2019","Yes","Gil Vicente","Setubal",0,0,15,8,2,3,16,18,3,6,0,0,2.21,3.12,3.42,2.28,1.61,1,1,0.4247128,0.3008382,0.2744489,1.574977,1.124185,0,7,-1,0,0.4507917,-2,-3,0,0
"3479","P1",10,"01.09.2019","Yes","Tondela","Santa Clara",0,0,11,13,4,4,9,11,2,2,1,0,2.31,3.2,3.14,2.26,1.62,1,1,0.4069103,0.2937384,0.2993512,1.514469,1.191792,0,-2,0,0,0.3226773,-2,0,1,0
"3480","P1",10,"01.09.2019","Yes","Porto","Guimaraes",3,0,18,8,10,3,19,7,3,3,0,2,1.18,6.78,14.55,1.48,2.61,3,0,0.7967233,0.1386628,0.06461398,2.528833,0.3325047,3,10,7,3,2.196328,12,0,-2,0
"3481","P1",10,"01.09.2019","Yes","Sp Braga","Benfica",0,4,11,12,2,6,10,16,2,1,0,0,5.02,3.94,1.64,1.72,2.1,0,3,0.1874384,0.2388174,0.5737442,0.8011325,1.96005,-4,-1,-4,-3,-1.158918,-6,1,0,0
"3482","P1",10,"08.09.2019","Yes","Rio Ave","Guimaraes",1,1,6,15,2,5,13,16,2,2,1,0,1.89,3.55,3.92,1.93,1.87,1,1,0.4963919,0.2642763,0.2393318,1.753452,0.9822717,0,-9,-3,0,0.7711803,-3,0,1,0
"3483","P1",10,"13.09.2019","Yes","Setubal","Sp Braga",1,0,7,22,4,6,13,11,1,4,0,1,4.75,3.54,1.76,2.2,1.66,3,0,0.1983863,0.2661963,0.5354175,0.8613551,1.872449,1,-15,-2,3,-1.011094,2,-3,-1,0
"3484","P1",10,"14.09.2019","Yes","Famalicao","Pacos Ferreira",4,2,11,15,5,3,20,18,3,2,0,0,2.09,3.34,3.48,2.07,1.74,3,0,0.4491711,0.2810681,0.2697608,1.628581,1.090351,2,-4,2,3,0.5382309,2,1,0,0
"3485","P1",10,"14.09.2019","Yes","Benfica","Gil Vicente",2,0,13,8,4,1,13,14,1,4,0,0,1.12,8.22,20.22,1.39,2.88,3,0,0.839177,0.1143404,0.0464826,2.631871,0.2537882,2,5,3,3,2.378083,-1,-3,0,0
"3486","P1",10,"14.09.2019","Yes","Guimaraes","Aves",5,1,18,12,8,2,12,15,3,2,0,0,1.53,4.05,6.03,2,1.8,3,0,0.6129295,0.2315511,0.1555194,2.070339,0.6981094,4,6,6,3,1.37223,-3,1,0,0
"3487","P1",10,"15.09.2019","Yes","Maritimo","Belenenses",1,3,12,13,4,7,11,26,2,3,0,0,2.08,3.2,3.68,2.38,1.57,0,3,0.451423,0.2934249,0.2551521,1.647694,1.058881,-2,-1,-3,-3,0.5888126,-15,-1,0,0
"3488","P1",10,"15.09.2019","Yes","Rio Ave","Tondela",2,4,23,5,6,4,15,18,2,3,0,0,1.64,3.97,4.96,1.81,1.99,0,3,0.5734789,0.2369031,0.189618,1.95734,0.8057572,-2,18,2,-3,1.151583,-3,-1,0,0
"3489","P1",10,"15.09.2019","Yes","Santa Clara","Moreirense",2,0,18,12,5,2,13,20,3,2,0,0,2.31,3.07,3.26,2.38,1.57,3,0,0.4063336,0.3057429,0.2879235,1.524744,1.169513,2,6,3,3,0.3552303,-7,1,0,0
"3490","P1",10,"15.09.2019","Yes","Portimonense","Porto",2,3,8,21,4,6,10,14,1,1,0,1,6.8,4.52,1.43,1.6,2.3,0,3,0.1377473,0.2072305,0.6550222,0.6204724,2.172297,-1,-13,-2,-3,-1.551825,-4,0,-1,0
"3491","P1",10,"15.09.2019","Yes","Boavista","Sp Lisbon",1,1,11,13,4,3,22,17,2,6,0,1,4.8,3.58,1.73,2.03,1.77,1,1,0.1954901,0.2621096,0.5424003,0.8485799,1.88931,0,-2,1,0,-1.040731,5,-4,-1,0
"3492","P1",10,"20.09.2019","Yes","Pacos Ferreira","Aves",2,1,15,8,2,3,24,13,5,3,1,0,1.88,3.46,4.13,2.09,1.73,3,0,0.5003607,0.2718723,0.2277671,1.772954,0.9551735,1,7,-1,3,0.8177807,11,2,1,0
"3493","P1",10,"21.09.2019","Yes","Belenenses","Rio Ave",0,2,9,16,2,4,20,13,3,0,0,0,3.19,3.35,2.21,1.94,1.86,0,3,0.294492,0.2804267,0.4250812,1.163903,1.55567,-2,-7,-2,-3,-0.3917677,7,3,0,0
"3494","P1",10,"21.09.2019","Yes","Moreirense","Benfica",1,2,6,20,2,2,12,15,3,2,0,0,8.61,5.02,1.33,1.65,2.21,0,3,0.1088279,0.186655,0.7045172,0.5131385,2.300207,-1,-14,0,-3,-1.787068,-3,1,0,0
"3495","P1",10,"22.09.2019","Yes","Gil Vicente","Boavista",0,0,15,4,6,0,18,19,5,2,0,1,2.25,3.07,3.39,2.46,1.53,1,1,0.417255,0.3058058,0.2769392,1.557571,1.136623,0,11,6,0,0.4209475,-1,3,-1,0
"3496","P1",10,"22.09.2019","Yes","Setubal","Portimonense",0,0,7,7,3,1,17,9,3,0,0,0,2.82,3.08,2.58,2.4,1.55,1,1,0.3323797,0.3043216,0.3632987,1.301461,1.394218,0,0,2,0,-0.09275711,8,3,0,0
"3497","P1",10,"22.09.2019","Yes","Tondela","Guimaraes",1,3,5,20,3,6,9,21,2,4,0,0,3.26,3.38,2.16,1.94,1.86,0,3,0.2878728,0.2776525,0.4344747,1.141271,1.581077,-2,-15,-3,-3,-0.4398057,-12,-2,0,0
"3498","P1",10,"22.09.2019","Yes","Porto","Santa Clara",2,0,19,6,7,2,25,11,4,4,0,0,1.16,7.12,16.06,1.49,2.55,3,0,0.8096179,0.131904,0.05847801,2.560758,0.3073381,2,13,5,3,2.25342,14,0,0,0
"3499","P1",10,"23.09.2019","Yes","Sp Braga","Maritimo",2,2,26,6,6,3,15,17,2,5,0,1,1.36,4.72,8.43,1.77,2.03,1,1,0.6899101,0.1987877,0.1113022,2.268518,0.5326943,0,20,3,0,1.735824,-2,-3,-1,0
"3500","P1",10,"23.09.2019","Yes","Sp Lisbon","Famalicao",1,2,20,13,5,7,16,14,3,2,0,0,1.54,4.11,5.71,1.58,2.33,0,3,0.6081252,0.227862,0.1640128,2.052238,0.7199003,-1,7,-2,-3,1.332337,2,1,0,0
"3501","P1",10,"27.09.2019","Yes","Boavista","Tondela",0,0,16,5,3,0,21,17,3,4,0,0,2.02,3.28,3.81,2.36,1.58,1,1,0.4659751,0.2869725,0.2470524,1.684898,1.02813,0,11,3,0,0.6567681,4,-1,0,0
"3502","P1",10,"28.09.2019","Yes","Maritimo","Moreirense",2,1,12,12,4,4,13,21,4,6,0,0,2.48,3.07,2.96,2.37,1.57,3,0,0.3779782,0.3053374,0.3166844,1.439272,1.255391,1,0,0,3,0.1838813,-8,-2,0,0
"3503","P1",10,"28.09.2019","Yes","Benfica","Setubal",1,0,13,9,3,2,11,8,4,4,1,0,1.14,7.66,18.02,1.55,2.4,3,0,0.8250225,0.122784,0.05219343,2.597852,0.2793643,1,4,1,3,2.318487,3,0,1,0
"3504","P1",10,"28.09.2019","Yes","Famalicao","Belenenses",3,1,16,9,6,3,15,10,2,2,0,0,1.78,3.51,4.54,2.09,1.73,3,0,0.5265394,0.26702,0.2064406,1.846638,0.8863417,2,7,3,3,0.9602966,5,0,0,0
"3505","P1",10,"29.09.2019","Yes","Guimaraes","Pacos Ferreira",1,0,14,5,4,1,16,23,1,6,0,1,1.52,4.01,6.31,1.95,1.85,3,0,0.6173069,0.2339916,0.1487015,2.085912,0.6800961,1,9,3,3,1.405816,-7,-5,-1,0
"3506","P1",10,"29.09.2019","Yes","Santa Clara","Gil Vicente",1,0,14,7,6,5,17,15,4,1,0,1,2.08,3.2,3.67,2.35,1.58,3,0,0.4511093,0.2932211,0.2556696,1.646549,1.06023,1,7,1,3,0.5863192,2,3,-1,0
"3507","P1",10,"29.09.2019","Yes","Portimonense","Sp Braga",0,1,12,9,5,3,11,23,3,4,0,0,3.42,3.4,2.09,1.91,1.88,0,3,0.2745559,0.2761709,0.4492732,1.099838,1.623991,-1,3,2,-3,-0.5241521,-12,-1,0,0
"3508","P1",10,"29.09.2019","Yes","Rio Ave","Porto",0,1,8,13,1,5,15,15,3,3,0,0,5.69,4.27,1.52,1.59,2.32,0,3,0.1645827,0.2193151,0.6161022,0.7130631,2.067622,-1,-5,-4,-3,-1.354559,0,0,0,0
"3509","P1",10,"30.09.2019","Yes","Aves","Sp Lisbon",0,1,7,15,2,3,12,19,3,2,0,0,5.26,4.19,1.57,1.66,2.21,0,3,0.1783902,0.2239457,0.5976641,0.7591164,2.016938,-1,-8,-1,-3,-1.257822,-7,1,0,0
"3510","P1",10,"05.10.2019","Yes","Aves","Tondela",0,1,12,11,1,2,12,14,1,1,0,0,2.43,3.31,2.84,1.98,1.82,0,3,0.3861343,0.2834762,0.3303895,1.441879,1.274645,-1,1,-1,-3,0.1672342,-2,0,0,0
"3511","P1",10,"25.10.2019","Yes","Pacos Ferreira","Rio Ave",0,0,16,4,3,0,19,15,0,1,0,0,2.73,3.18,2.62,2.07,1.75,1,1,0.3447711,0.2959827,0.3592462,1.330296,1.373721,0,12,3,0,-0.04342536,4,-1,0,0
"3512","P1",10,"26.10.2019","Yes","Belenenses","Aves",3,2,11,8,5,2,16,21,3,2,0,0,2.07,3.27,3.6,2.1,1.73,3,0,0.4528929,0.2866937,0.2604134,1.645372,1.067934,1,3,3,3,0.5774385,-5,1,0,0
"3513","P1",10,"26.10.2019","Yes","Gil Vicente","Portimonense",1,1,6,10,2,4,22,20,3,2,1,0,2.45,3.11,2.96,2.3,1.6,1,1,0.3823384,0.3011991,0.3164625,1.448214,1.250587,0,-4,-2,0,0.1976276,2,1,1,0
"3514","P1",10,"26.10.2019","Yes","Setubal","Maritimo",0,0,11,10,2,3,14,20,0,1,0,0,2.25,3,3.46,2.78,1.43,1,1,0.4166165,0.3124624,0.2709211,1.562312,1.125226,0,1,-1,0,0.4370861,-6,-1,0,0
"3515","P1",10,"26.10.2019","Yes","Moreirense","Boavista",1,1,9,23,4,4,18,20,3,4,1,0,2.24,3.07,3.4,2.55,1.5,1,1,0.4186789,0.3054856,0.2758355,1.561522,1.132992,0,-14,0,0,0.4285302,-2,-1,1,0
"3516","P1",10,"27.10.2019","Yes","Tondela","Benfica",0,1,9,12,4,3,17,14,1,2,0,0,9,5.27,1.31,1.59,2.33,0,3,0.1044058,0.1783022,0.717292,0.4915197,2.330178,-1,-3,1,-3,-1.838658,3,-1,0,0
"3517","P1",10,"27.10.2019","Yes","Porto","Famalicao",3,0,19,5,9,2,14,12,0,3,0,0,1.23,6.06,11.31,1.5,2.55,3,0,0.7623557,0.1547356,0.08290871,2.441803,0.4034617,3,14,7,3,2.038341,2,-3,0,0
"3518","P1",10,"27.10.2019","Yes","Sp Lisbon","Guimaraes",3,1,13,13,6,3,7,9,1,1,0,0,1.79,3.65,4.26,1.76,2.05,3,0,0.5233961,0.2566792,0.2199247,1.826868,0.9164532,2,0,3,3,0.9104144,-2,0,0,0
"3519","P1",10,"28.10.2019","Yes","Sp Braga","Santa Clara",2,0,20,8,12,5,18,7,1,1,0,0,1.44,4.49,6.71,1.65,2.19,3,0,0.651331,0.2088901,0.1397789,2.162883,0.6282269,2,12,7,3,1.534656,11,0,0,0
"3520","P1",10,"30.10.2019","Yes","Rio Ave","Moreirense",1,1,20,8,7,4,14,14,1,1,0,0,1.73,3.74,4.54,1.96,1.83,1,1,0.5424099,0.2509008,0.2066892,1.878131,0.8709686,0,12,3,0,1.007162,0,0,0,0
"3521","P1",10,"30.10.2019","Yes","Maritimo","Porto",1,1,6,14,2,5,17,20,4,5,0,0,9.14,4.85,1.33,1.78,2.01,1,1,0.1024935,0.1931527,0.7043538,0.5006332,2.306214,0,-8,-3,0,-1.805581,-3,-1,0,0
"3522","P1",10,"30.10.2019","Yes","Guimaraes","Belenenses",5,0,14,6,6,2,13,13,1,4,0,0,1.42,4.39,7.4,1.82,1.98,3,0,0.6599117,0.2134566,0.1266317,2.193192,0.5933517,5,8,4,3,1.59984,0,-3,0,0
"3523","P1",10,"30.10.2019","Yes","Benfica","Portimonense",4,0,17,8,6,2,14,9,1,1,0,0,1.19,6.47,13.95,1.52,2.46,3,0,0.787879,0.1449113,0.06720975,2.508548,0.3465405,4,9,4,3,2.162008,5,0,0,0
"3524","P1",10,"30.10.2019","Yes","Famalicao","Gil Vicente",2,1,10,12,2,4,17,15,3,1,0,0,1.78,3.59,4.41,1.93,1.87,3,0,0.5264682,0.2610344,0.2124974,1.840439,0.8985265,1,-2,-2,3,0.9419125,2,2,0,0
"3525","P1",10,"31.10.2019","Yes","Pacos Ferreira","Sp Lisbon",1,2,12,12,5,4,19,25,5,7,0,0,3.89,3.42,1.93,1.9,1.89,0,3,0.2407915,0.2738827,0.4853258,0.9962571,1.72986,-1,0,1,-3,-0.733603,-6,-2,0,0
"3526","P1",10,"31.10.2019","Yes","Boavista","Sp Braga",2,0,10,19,2,2,14,8,4,2,0,0,3.75,3.36,1.99,2.16,1.68,3,0,0.2499692,0.2789834,0.4710474,1.028891,1.692126,2,-9,0,3,-0.6632347,6,2,0,0
"3527","P1",10,"31.10.2019","Yes","Santa Clara","Setubal",1,1,20,13,4,3,9,17,3,5,0,1,2.03,3.14,3.89,2.66,1.46,1,1,0.4611806,0.2981518,0.2406675,1.681694,1.020154,0,7,1,0,0.6615393,-8,-2,-1,0
"3528","P1",10,"02.11.2019","Yes","Benfica","Rio Ave",2,0,20,3,4,0,11,14,1,3,0,0,1.3,5.34,9.25,1.52,2.48,3,0,0.7225505,0.1759018,0.1015476,2.343553,0.4805447,2,17,4,3,1.863009,-3,-2,0,0
"3529","P1",10,"02.11.2019","Yes","Moreirense","Guimaraes",1,1,7,15,1,6,21,11,5,3,0,0,3.74,3.36,1.99,2.09,1.72,1,1,0.2504701,0.2787971,0.4707328,1.030207,1.690995,0,-8,-5,0,-0.660788,10,2,0,0
"3530","P1",10,"03.11.2019","Yes","Gil Vicente","Maritimo",2,0,15,8,6,1,18,14,0,0,0,0,1.96,3.26,4.03,2.38,1.56,3,0,0.4790237,0.288002,0.2329743,1.725073,0.9869249,2,7,5,3,0.7381482,4,0,0,0
"3531","P1",10,"03.11.2019","Yes","Tondela","Sp Lisbon",1,0,5,15,3,3,15,13,4,3,0,0,4.55,3.81,1.71,1.7,2.12,3,0,0.2059713,0.2459763,0.5480524,0.8638903,1.890133,1,-10,0,3,-1.026243,2,1,0,0
"3532","P1",10,"03.11.2019","Yes","Porto","Aves",1,0,12,9,4,0,21,15,1,1,0,0,1.11,8.29,21.04,1.43,2.72,3,0,0.8427064,0.1128352,0.04445837,2.640954,0.2462103,1,3,4,3,2.394744,6,0,0,0
"3533","P1",10,"03.11.2019","Yes","Sp Braga","Famalicao",2,2,18,6,5,4,11,15,5,4,0,1,1.48,4.48,5.96,1.61,2.27,1,1,0.6334409,0.2092617,0.1572974,2.109584,0.6811539,0,12,1,0,1.42843,-4,1,-1,0
"3534","P1",10,"04.11.2019","Yes","Belenenses","Pacos Ferreira",1,0,8,16,2,5,22,23,1,4,0,0,2.48,3.15,2.89,2.25,1.63,3,0,0.3780099,0.2976078,0.3243822,1.431638,1.270755,1,-8,-3,3,0.1608831,-1,-3,0,0
"3535","P1",10,"04.11.2019","Yes","Portimonense","Santa Clara",1,1,14,15,4,4,11,15,4,2,0,0,2.16,3.19,3.44,2.3,1.6,1,1,0.4338352,0.2937567,0.2724081,1.595262,1.110981,0,-1,0,0,0.4842811,-4,2,0,0
"3536","P1",10,"04.11.2019","Yes","Setubal","Boavista",1,0,7,27,2,5,8,9,3,4,0,0,2.49,2.83,3.19,3.06,1.36,3,0,0.3758801,0.3307213,0.2933986,1.458362,1.210917,1,-20,-3,3,0.2474446,-1,-1,0,0
"3537","P1",10,"08.11.2019","Yes","Aves","Gil Vicente",1,2,5,5,4,4,19,26,2,3,0,0,2.72,2.99,2.76,2.43,1.55,0,3,0.3453985,0.3142087,0.3403928,1.350404,1.335387,-1,0,0,-3,0.01501733,-7,-1,0,0
"3538","P1",10,"09.11.2019","Yes","Rio Ave","Setubal",1,0,7,10,3,3,14,10,0,1,0,0,1.55,3.9,6.17,2.13,1.71,3,0,0.6065563,0.2410673,0.1523764,2.060736,0.6981964,1,-3,0,3,1.36254,4,-1,0,0
"3539","P1",10,"09.11.2019","Yes","Santa Clara","Benfica",1,2,12,11,3,6,13,10,3,3,0,0,6.86,4.33,1.45,1.84,1.97,0,3,0.1366992,0.216572,0.6467288,0.6266697,2.156758,-1,1,-3,-3,-1.530089,3,0,0,0
"3540","P1",10,"09.11.2019","Yes","Famalicao","Moreirense",3,3,17,9,14,5,15,10,3,3,1,0,1.8,3.58,4.32,1.92,1.87,1,1,0.5209799,0.2619452,0.2170749,1.824885,0.91317,0,8,9,0,0.9117148,5,0,1,0
"3541","P1",10,"10.11.2019","Yes","Maritimo","Portimonense",1,1,15,10,4,2,25,21,4,6,0,0,2.54,3.11,2.85,2.33,1.59,1,1,0.3692833,0.3016011,0.3291156,1.409451,1.288948,0,5,2,0,0.120503,4,-2,0,0
"3542","P1",10,"10.11.2019","Yes","Pacos Ferreira","Tondela",1,0,9,13,2,5,24,24,5,2,1,1,1.98,3.32,3.83,2.24,1.64,3,0,0.4731809,0.2821982,0.2446209,1.701741,1.016061,1,-4,-3,3,0.6856798,0,3,0,0
"3543","P1",10,"10.11.2019","Yes","Sp Lisbon","Belenenses",2,0,19,9,5,3,15,18,4,3,0,0,1.34,4.84,8.6,1.57,2.37,3,0,0.6979958,0.1932468,0.1087575,2.287234,0.5195192,2,10,2,3,1.767715,-3,1,0,0
"3544","P1",10,"10.11.2019","Yes","Guimaraes","Sp Braga",0,2,14,9,2,5,17,16,5,2,0,0,2.26,3.54,2.93,1.71,2.12,0,3,0.414981,0.2649313,0.3200877,1.509874,1.225194,-2,5,-3,-3,0.2846798,1,3,0,0
"3545","P1",10,"10.11.2019","Yes","Boavista","Porto",0,1,7,9,1,1,14,16,3,1,0,0,7.1,3.95,1.49,2.11,1.72,0,3,0.1322302,0.2376796,0.6300902,0.6343702,2.12795,-1,-2,0,-3,-1.49358,-2,2,0,0
"3546","P1",10,"29.11.2019","Yes","Santa Clara","Boavista",1,2,15,17,2,7,17,19,2,2,0,0,2.11,3.02,3.84,2.63,1.48,0,3,0.4448093,0.3107773,0.2444134,1.645205,1.044018,-1,-2,-5,-3,0.6011875,-2,0,0,0
"3547","P1",10,"30.11.2019","Yes","Moreirense","Aves",3,2,18,12,5,3,11,18,1,2,0,1,1.99,3.29,3.84,2.12,1.71,3,0,0.4710111,0.2848973,0.2440917,1.69793,1.017172,1,6,2,3,0.6807582,-7,-1,-1,0
"3548","P1",10,"30.11.2019","Yes","Benfica","Maritimo",4,0,12,12,9,1,12,13,3,2,1,0,1.13,7.83,18.22,1.49,2.55,3,0,0.8289561,0.1196322,0.05141166,2.606501,0.2738672,4,0,8,3,2.332633,-1,1,1,0
"3549","P1",10,"30.11.2019","Yes","Portimonense","Famalicao",2,1,12,12,5,4,21,17,1,1,0,0,2,3.58,3.49,1.76,2.05,3,0,0.4691036,0.2620691,0.2688273,1.66938,1.068551,1,0,1,3,0.600829,4,0,0,0
"3550","P1",10,"01.12.2019","Yes","Tondela","Belenenses",0,1,15,11,3,3,14,16,2,3,0,0,2.03,3.22,3.75,2.24,1.64,0,3,0.4604543,0.2902864,0.2492593,1.671649,1.038064,-1,4,0,-3,0.6335851,-2,-1,0,0
"3551","P1",10,"01.12.2019","Yes","Setubal","Guimaraes",1,1,17,13,4,3,16,15,2,1,0,0,4.17,3.35,1.89,2.29,1.61,1,1,0.2246623,0.2796543,0.4956835,0.9536411,1.766705,0,4,1,0,-0.8130635,1,1,0,0
"3552","P1",10,"01.12.2019","Yes","Gil Vicente","Sp Lisbon",3,1,7,9,4,2,14,13,4,2,0,0,4.13,3.4,1.88,2.15,1.69,3,0,0.2266795,0.275349,0.4979715,0.9553875,1.769264,2,-2,2,3,-0.813876,1,2,0,0
"3553","P1",10,"02.12.2019","Yes","Sp Braga","Rio Ave",2,0,12,9,4,2,20,12,2,2,0,0,1.56,4.12,5.43,1.69,2.14,3,0,0.600264,0.2272844,0.1724515,2.028077,0.7446391,2,3,2,3,1.283437,8,0,0,0
"3554","P1",10,"02.12.2019","Yes","Porto","Pacos Ferreira",2,0,8,5,6,4,18,13,2,3,0,0,1.18,6.64,14.84,1.55,2.39,3,0,0.7954022,0.1413516,0.06324626,2.527558,0.3310904,2,3,2,3,2.196468,5,-1,0,0
"3555","P1",10,"06.12.2019","Yes","Boavista","Benfica",1,4,9,11,5,6,17,10,4,4,0,0,6.26,3.82,1.55,2.06,1.75,0,3,0.1497577,0.2454144,0.6048279,0.6946875,2.059898,-3,-2,-1,-3,-1.36521,7,0,0,0
"3556","P1",10,"07.12.2019","Yes","Maritimo","Santa Clara",2,2,12,6,7,2,12,19,3,4,0,0,2.5,3.04,2.96,2.46,1.53,1,1,0.3749583,0.3083539,0.3166878,1.433229,1.258417,0,6,5,0,0.1748117,-7,-1,0,0
"3557","P1",10,"07.12.2019","Yes","Famalicao","Tondela",2,3,27,8,10,5,16,18,2,7,0,0,1.96,3.53,3.67,1.82,1.98,0,3,0.478629,0.2657544,0.2556166,1.701641,1.032604,-1,19,5,-3,0.6690373,-2,-5,0,0
"3558","P1",10,"07.12.2019","Yes","Aves","Sp Braga",1,0,6,13,1,2,24,17,5,5,0,0,6.3,4.42,1.47,1.7,2.12,3,0,0.1490079,0.2123868,0.6386053,0.6594105,2.128203,1,-7,-1,3,-1.468792,7,0,0,0
"3559","P1",10,"08.12.2019","Yes","Guimaraes","Portimonense",2,0,10,13,5,2,15,9,1,1,0,0,1.52,4.24,5.78,1.67,2.17,3,0,0.6167257,0.2210904,0.1621839,2.071268,0.7076421,2,-3,3,3,1.363625,6,0,0,0
"3560","P1",10,"08.12.2019","Yes","Pacos Ferreira","Setubal",2,3,21,9,4,4,24,16,4,5,0,0,2.01,3.11,4.05,2.68,1.46,0,3,0.466723,0.3016441,0.2316329,1.701813,0.9965428,-1,12,0,-3,0.7052703,8,-1,0,0
"3561","P1",10,"08.12.2019","Yes","Sp Lisbon","Moreirense",1,0,28,9,9,1,16,11,3,4,0,1,1.34,4.87,8.7,1.65,2.2,3,0,0.6997034,0.1925262,0.1077704,2.291636,0.5158374,1,19,8,3,1.775799,5,-1,-1,0
"3562","P1",10,"08.12.2019","Yes","Belenenses","Porto",1,1,5,16,3,7,21,18,7,2,0,0,9.99,5.23,1.29,1.66,2.18,1,1,0.09385864,0.1792826,0.7268588,0.4608585,2.359859,0,-11,-4,0,-1.899,3,5,0,0
"3563","P1",10,"09.12.2019","Yes","Rio Ave","Gil Vicente",1,0,9,8,2,4,20,18,3,2,1,0,1.66,3.78,4.94,1.9,1.89,3,0,0.5633213,0.2473845,0.1892942,1.937348,0.8152671,1,1,-2,3,1.122081,2,1,1,0
"3564","P1",10,"13.12.2019","Yes","Portimonense","Rio Ave",1,1,16,9,6,2,18,14,4,3,1,0,2.79,3.32,2.47,1.94,1.86,1,1,0.3367098,0.282958,0.3803322,1.293088,1.423955,0,7,4,0,-0.130867,4,1,1,0
"3565","P1",10,"14.12.2019","Yes","Maritimo","Boavista",1,0,9,11,3,1,19,26,2,1,0,1,2.77,2.99,2.7,2.51,1.51,3,0,0.3387135,0.3137915,0.347495,1.329932,1.356276,1,-2,2,3,-0.02634439,-7,1,-1,0
"3566","P1",10,"14.12.2019","Yes","Benfica","Famalicao",4,0,17,8,6,4,7,7,0,2,0,0,1.2,6.83,11.64,1.34,3.15,3,0,0.7819903,0.1373921,0.08061756,2.483363,0.3792448,4,9,2,3,2.104118,0,-2,0,0
"3567","P1",10,"14.12.2019","Yes","Setubal","Aves",1,0,11,11,2,5,19,18,4,3,0,0,2.03,3.15,3.91,2.42,1.54,3,0,0.4621871,0.2978539,0.239959,1.684415,1.017731,1,0,-3,3,0.6666842,1,1,0,0
"3568","P1",10,"15.12.2019","Yes","Moreirense","Belenenses",2,1,13,8,7,2,18,15,1,5,0,1,2.04,3.34,3.63,2.08,1.73,3,0,0.4602437,0.2811069,0.2586494,1.661838,1.057055,1,5,5,3,0.6047831,3,-4,-1,0
"3569","P1",10,"15.12.2019","Yes","Gil Vicente","Guimaraes",2,2,6,16,4,7,15,17,4,1,0,0,3.55,3.34,2.06,2.06,1.75,1,1,0.2641188,0.2807251,0.4551562,1.073081,1.646194,0,-10,-3,0,-0.5731121,-2,3,0,0
"3570","P1",10,"15.12.2019","Yes","Sp Braga","Pacos Ferreira",0,1,23,3,5,1,14,22,1,5,0,0,1.41,4.43,7.54,1.76,2.04,0,3,0.6643251,0.2114443,0.1242306,2.20442,0.584136,-1,20,4,-3,1.620284,-8,-4,0,0
"3571","P1",10,"16.12.2019","Yes","Santa Clara","Sp Lisbon",0,4,12,19,3,7,12,6,1,1,0,0,3.8,3.4,1.96,2.08,1.73,0,3,0.2465226,0.2755253,0.4779521,1.015093,1.709381,-4,-7,-4,-3,-0.6942883,6,0,0,0
"3572","P1",10,"16.12.2019","Yes","Porto","Tondela",3,0,12,2,5,0,16,9,0,0,0,0,1.17,7.04,14.56,1.5,2.5,3,0,0.8022139,0.1333225,0.06446362,2.539964,0.3267133,3,10,5,3,2.213251,7,0,0,0
"3573","P1",10,"04.01.2020","Yes","Aves","Santa Clara",0,1,10,3,4,3,16,10,4,2,0,0,2.7,3.16,2.62,2.2,1.65,0,3,0.3466247,0.2961667,0.3572086,1.336041,1.367793,-1,7,1,-3,-0.03175188,6,2,0,0
"3574","P1",10,"04.01.2020","Yes","Boavista","Portimonense",1,1,5,6,2,5,16,15,1,2,0,0,2.17,3.15,3.46,2.38,1.56,1,1,0.4317684,0.2974404,0.2707912,1.592746,1.109814,0,-1,-3,0,0.4829317,1,-1,0,0
"3575","P1",10,"04.01.2020","Yes","Belenenses","Sp Braga",1,7,3,18,2,15,11,13,4,1,1,0,6.52,4.13,1.49,1.89,1.9,0,3,0.1437911,0.227002,0.6292069,0.6583754,2.114623,-6,-15,-13,-3,-1.456247,-2,3,1,0
"3576","P1",10,"04.01.2020","Yes","Guimaraes","Benfica",0,1,11,4,5,3,12,15,4,3,1,0,4.33,4.02,1.71,1.81,1.99,0,3,0.2169537,0.233684,0.5493623,0.8845451,1.881771,-1,7,2,-3,-0.9972258,-3,1,1,0
"3577","P1",10,"05.01.2020","Yes","Pacos Ferreira","Moreirense",1,0,6,5,3,1,20,16,4,4,0,0,2.14,3.12,3.57,2.32,1.59,3,0,0.4375722,0.3001296,0.2622982,1.612846,1.087024,1,1,2,3,0.525822,4,0,0,0
"3578","P1",10,"05.01.2020","Yes","Rio Ave","Maritimo",0,1,6,6,3,3,11,25,1,5,0,0,1.53,4,6.09,1.93,1.86,0,3,0.6120957,0.2341266,0.1537777,2.070414,0.6954598,-1,0,0,-3,1.374954,-14,-4,0,0
"3579","P1",10,"05.01.2020","Yes","Tondela","Gil Vicente",1,1,7,10,1,9,19,21,2,2,0,0,2.3,3.12,3.2,2.44,1.54,1,1,0.4071778,0.3001631,0.2926591,1.521697,1.17814,0,-3,-8,0,0.3435563,-2,0,0,0
"3580","P1",10,"05.01.2020","Yes","Sp Lisbon","Porto",1,2,11,9,2,7,21,16,5,5,0,0,3.26,3.42,2.13,1.9,1.88,0,3,0.2870484,0.2736193,0.4393323,1.134765,1.591616,-1,2,-5,-3,-0.4568517,5,0,0,0
"3581","P1",10,"05.01.2020","Yes","Famalicao","Setubal",3,0,13,4,7,2,24,13,2,1,0,0,1.82,3.58,4.18,1.97,1.82,3,0,0.5144598,0.261541,0.2239992,1.80492,0.9335387,3,9,5,3,0.8713816,11,1,0,0
"3582","P1",10,"10.01.2020","Yes","Benfica","Aves",2,1,28,6,11,3,12,11,4,2,0,0,1.09,9.62,25.98,1.36,3.03,3,0,0.8656053,0.09807794,0.03631677,2.694894,0.2070283,1,22,8,3,2.487866,1,2,0,0
"3583","P1",10,"10.01.2020","Yes","Santa Clara","Rio Ave",0,1,8,5,4,3,12,22,2,3,0,0,2.84,3.17,2.51,2.1,1.72,0,3,0.3303194,0.2959328,0.3737478,1.286891,1.417176,-1,3,1,-3,-0.1302853,-10,-1,0,0
"3584","P1",10,"10.01.2020","Yes","Moreirense","Porto",2,4,8,14,5,6,11,11,2,4,0,1,9.78,5.18,1.3,1.74,2.07,0,3,0.09605126,0.1813477,0.722601,0.4695015,2.349151,-2,-6,-1,-3,-1.879649,0,-2,-1,0
"3585","P1",10,"11.01.2020","Yes","Portimonense","Pacos Ferreira",0,0,8,2,4,0,18,21,2,3,0,0,2.16,3.22,3.42,2.36,1.57,1,1,0.434332,0.2913531,0.2743149,1.594349,1.114298,0,6,4,0,0.4800511,-3,-1,0,0
"3586","P1",10,"11.01.2020","Yes","Boavista","Famalicao",0,1,9,8,3,5,17,25,5,4,1,1,2.26,3.33,3.07,2.02,1.78,0,3,0.414107,0.2810456,0.3048475,1.523366,1.195588,-1,1,-2,-3,0.3277785,-8,1,0,0
"3587","P1",10,"11.01.2020","Yes","Setubal","Sp Lisbon",1,3,10,9,2,5,7,13,3,3,0,0,12.07,5.54,1.24,1.73,2.07,0,3,0.07744391,0.1687271,0.753829,0.4010588,2.430214,-2,1,-3,-3,-2.029155,-6,0,0,0
"3588","P1",10,"12.01.2020","Yes","Gil Vicente","Belenenses",2,0,9,4,7,2,16,20,0,0,0,0,1.79,3.42,4.63,2.27,1.62,3,0,0.52356,0.274027,0.202413,1.844707,0.8812661,2,5,5,3,0.9634408,-4,0,0,0
"3589","P1",10,"12.01.2020","Yes","Maritimo","Guimaraes",0,0,4,15,1,9,19,16,1,2,0,0,4.29,3.65,1.78,1.94,1.85,1,1,0.2180809,0.2563197,0.5255994,0.9105623,1.833118,0,-11,-8,0,-0.9225556,3,-1,0,0
"3590","P1",10,"12.01.2020","Yes","Sp Braga","Tondela",2,1,17,6,6,2,10,10,4,3,0,0,1.24,5.67,11.74,1.71,2.11,3,0,0.7551064,0.1651379,0.0797557,2.430457,0.404405,1,11,4,3,2.026052,0,1,0,0
"3591","P1",10,"17.01.2020","Yes","Porto","Sp Braga",1,2,7,2,3,1,21,14,5,6,0,0,1.62,3.87,5.35,1.82,1.98,0,3,0.5809197,0.2431757,0.1759046,1.985935,0.7708896,-1,5,2,-3,1.215045,7,-1,0,0
"3592","P1",10,"17.01.2020","Yes","Sp Lisbon","Benfica",0,2,10,9,6,4,17,11,4,4,0,0,3.56,3.57,1.99,1.83,1.97,0,3,0.264121,0.2633812,0.4724979,1.055744,1.680875,-2,1,2,-3,-0.6251306,6,0,0,0
"3593","P1",10,"18.01.2020","Yes","Aves","Portimonense",3,0,12,9,7,1,12,12,3,3,0,0,2.83,3.17,2.5,2.17,1.67,3,0,0.3306064,0.2951471,0.3742465,1.286966,1.417887,3,3,6,3,-0.1309201,0,0,0,0
"3594","P1",10,"18.01.2020","Yes","Guimaraes","Santa Clara",1,0,15,3,5,1,15,21,4,5,0,0,1.34,4.88,8.69,1.8,1.99,3,0,0.6998927,0.1921837,0.1079236,2.291862,0.5159545,1,12,4,3,1.775907,-6,-1,0,0
"3595","P1",10,"18.01.2020","Yes","Tondela","Moreirense",1,1,16,5,4,1,11,21,1,3,0,0,2.15,3.25,3.38,2.2,1.65,1,1,0.4352305,0.2879217,0.2768478,1.593613,1.118465,0,11,3,0,0.4751481,-10,-2,0,0
"3596","P1",10,"18.01.2020","Yes","Belenenses","Setubal",0,1,10,7,1,4,16,19,2,5,0,0,2.28,3.07,3.3,2.41,1.55,0,3,0.4109172,0.3051763,0.2839065,1.537928,1.156896,-1,3,-3,-3,0.3810323,-3,-3,0,0
"3597","P1",10,"19.01.2020","Yes","Pacos Ferreira","Gil Vicente",0,0,8,8,5,3,16,13,1,1,0,0,2.43,3,3.07,2.62,1.47,1,1,0.384389,0.3113551,0.3042558,1.464522,1.224123,0,0,2,0,0.2403997,3,0,0,0
"3598","P1",10,"19.01.2020","Yes","Famalicao","Maritimo",1,1,17,4,6,2,20,14,2,5,0,0,1.67,3.93,4.68,1.81,1.97,1,1,0.5612384,0.2384906,0.200271,1.922206,0.8393035,0,13,4,0,1.082902,6,-3,0,0
"3599","P1",10,"19.01.2020","Yes","Rio Ave","Boavista",2,0,3,6,2,2,15,21,1,4,0,0,1.77,3.55,4.53,2.16,1.68,3,0,0.529291,0.2639,0.206809,1.851773,0.8843271,2,-3,0,3,0.9674457,-6,-3,0,0
"3600","P1",10,"26.01.2020","Yes","Belenenses","Portimonense",2,1,9,13,4,6,13,13,1,2,0,0,2.53,3.14,2.83,2.11,1.71,3,0,0.370408,0.2984498,0.3311422,1.409674,1.291876,1,-4,-2,3,0.1177976,0,-1,0,0
"3601","P1",10,"26.01.2020","Yes","Famalicao","Santa Clara",0,1,11,5,1,2,14,14,2,4,0,0,1.66,3.81,4.95,1.8,2,0,3,0.5646371,0.2460099,0.189353,1.939921,0.814069,-1,6,-1,-3,1.125852,0,-2,0,0
"3602","P1",10,"26.01.2020","Yes","Tondela","Setubal",0,3,12,5,6,4,17,16,1,2,0,0,2.1,3.08,3.75,2.37,1.56,0,3,0.4460665,0.3041363,0.2497972,1.642336,1.053528,-3,7,2,-3,0.5888078,1,-1,0,0
"3603","P1",10,"26.01.2020","Yes","Pacos Ferreira","Benfica",0,2,6,11,2,6,17,16,3,2,0,0,8.68,4.81,1.34,1.72,2.09,0,3,0.1077332,0.1944126,0.6978542,0.5176123,2.287975,-2,-5,-4,-3,-1.770363,1,1,0,0
"3604","P1",10,"26.01.2020","Yes","Aves","Boavista",0,1,3,9,2,3,15,24,4,5,0,0,2.48,3.08,2.93,2.44,1.53,0,3,0.3771292,0.3036625,0.3192083,1.43505,1.261287,-1,-6,-1,-3,0.1737626,-9,-1,0,0
"3605","P1",10,"27.01.2020","Yes","Guimaraes","Rio Ave",1,2,14,5,7,3,14,18,0,4,0,0,1.65,3.72,5.14,1.93,1.85,0,3,0.5667135,0.2513649,0.1819216,1.951505,0.7971298,-1,9,4,-3,1.154376,-4,-4,0,0
"3606","P1",10,"27.01.2020","Yes","Sp Lisbon","Maritimo",1,0,14,4,5,2,14,14,2,3,0,0,1.35,4.83,8.35,1.67,2.16,3,0,0.693876,0.1939405,0.1121835,2.275568,0.5304911,1,10,3,3,1.745077,0,-1,0,0
"3607","P1",10,"28.01.2020","Yes","Porto","Gil Vicente",2,1,6,6,2,2,24,24,2,3,0,1,1.24,5.79,12.15,1.69,2.16,3,0,0.7597514,0.1627102,0.07753842,2.441964,0.3953254,1,0,0,3,2.046639,0,-1,-1,0
"3608","P1",10,"29.01.2020","Yes","Moreirense","Sp Braga",1,2,6,11,4,6,14,15,3,3,0,1,5.57,4.19,1.54,1.85,1.93,0,3,0.1681735,0.2235624,0.608264,0.728083,2.048355,-1,-5,-2,-3,-1.320271,-1,0,-1,0
"3609","P1",10,"31.01.2020","Yes","Benfica","Belenenses",3,2,12,15,6,5,8,11,2,4,0,0,1.09,9.65,24.4,1.31,3.34,3,0,0.8638372,0.09757332,0.03858945,2.689085,0.2133417,1,-3,1,3,2.475743,-3,-2,0,0
"3610","P1",10,"31.01.2020","Yes","Rio Ave","Famalicao",2,2,7,17,3,7,13,20,4,3,0,0,1.94,3.52,3.78,1.83,1.95,1,1,0.4844107,0.2669764,0.2486129,1.720209,1.012815,0,-10,-4,0,0.7073934,-7,1,0,0
"3611","P1",10,"01.02.2020","Yes","Portimonense","Tondela",0,1,11,9,4,2,18,13,3,3,0,0,2.03,3.33,3.66,2.15,1.68,0,3,0.4620529,0.2816719,0.2562752,1.667831,1.050498,-1,2,2,-3,0.617333,5,0,0,0
"3612","P1",10,"01.02.2020","Yes","Setubal","Porto",0,4,7,20,2,6,13,11,1,2,0,0,9.23,4.67,1.34,1.79,2.01,0,3,0.1013736,0.2003593,0.6982671,0.50448,2.295161,-4,-13,-4,-3,-1.790681,2,-1,0,0
"3613","P1",10,"01.02.2020","Yes","Santa Clara","Pacos Ferreira",2,1,10,7,4,2,12,16,2,4,0,0,2.16,3.12,3.5,2.38,1.55,3,0,0.4330034,0.2997716,0.267225,1.598782,1.101447,1,3,2,3,0.4973354,-4,-2,0,0
"3614","P1",10,"02.02.2020","Yes","Gil Vicente","Moreirense",1,5,9,10,5,6,6,19,1,2,0,0,1.8,3.46,4.44,2.26,1.61,0,3,0.5193088,0.2701606,0.2105306,1.828087,0.9017524,-4,-1,-1,-3,0.9263346,-13,-1,0,0
"3615","P1",10,"02.02.2020","Yes","Maritimo","Aves",1,2,11,9,4,2,19,13,2,3,0,0,1.99,3.27,3.85,2.36,1.57,0,3,0.4704895,0.2863224,0.2431881,1.697791,1.015887,-1,2,2,-3,0.6819043,6,-1,0,0
"3616","P1",10,"02.02.2020","Yes","Sp Braga","Sp Lisbon",1,0,13,15,8,9,15,14,4,7,0,0,1.79,3.71,4.18,1.81,1.97,3,0,0.5233658,0.2525134,0.2241208,1.822611,0.9248757,1,-2,-1,3,0.8977351,1,-3,0,0
"3617","P1",10,"02.02.2020","Yes","Boavista","Guimaraes",2,0,9,18,5,8,21,14,5,2,0,0,4.31,3.52,1.82,2.23,1.63,3,0,0.2177433,0.2666118,0.5156449,0.9198417,1.813546,2,-9,-3,3,-0.8937047,7,3,0,0
"3618","P1",10,"07.02.2020","Yes","Pacos Ferreira","Boavista",0,1,20,7,5,3,16,20,2,4,0,0,2.57,2.75,3.2,3.03,1.37,0,3,0.3652741,0.3413652,0.2933607,1.437187,1.221447,-1,13,2,-3,0.21574,-4,-2,0,0
"3619","P1",10,"08.02.2020","Yes","Belenenses","Santa Clara",0,2,13,9,1,3,10,23,0,2,0,0,2.47,3.11,2.92,2.25,1.62,0,3,0.3787732,0.3008263,0.3204006,1.437146,1.262028,-2,4,-2,-3,0.1751177,-13,-2,0,0
"3620","P1",10,"08.02.2020","Yes","Famalicao","Guimaraes",0,7,6,19,3,10,11,14,2,3,1,0,3.04,3.4,2.25,1.81,1.98,0,3,0.3081447,0.2755176,0.4163377,1.199952,1.524531,-7,-13,-7,-3,-0.3245791,-3,-1,1,0
"3621","P1",10,"08.02.2020","Yes","Sp Braga","Gil Vicente",2,2,10,13,7,7,8,18,2,4,1,0,1.34,4.81,8.78,1.76,2.04,1,1,0.6987115,0.1946514,0.1066371,2.290786,0.5145626,0,-3,0,0,1.776223,-10,-2,1,0
"3622","P1",10,"08.02.2020","Yes","Porto","Benfica",3,2,17,9,4,3,12,19,4,6,0,0,2.44,3.23,2.87,2.1,1.71,3,0,0.3837899,0.2899218,0.3262883,1.441292,1.268787,1,8,1,3,0.1725049,-7,-2,0,0
"3623","P1",10,"09.02.2020","Yes","Moreirense","Setubal",1,1,19,8,6,1,16,21,2,4,0,0,2.12,3.08,3.7,2.37,1.56,1,1,0.4422265,0.3043897,0.2533838,1.631069,1.064541,0,11,5,0,0.566528,-5,-2,0,0
"3624","P1",10,"09.02.2020","Yes","Tondela","Maritimo",0,0,10,10,1,5,23,28,1,3,0,0,2.3,3.03,3.31,2.36,1.57,1,1,0.4075079,0.3093295,0.2831626,1.531853,1.158817,0,0,-4,0,0.373036,-5,-2,0,0
"3625","P1",10,"09.02.2020","Yes","Sp Lisbon","Portimonense",2,1,20,10,4,3,9,18,1,1,0,0,1.44,4.5,6.54,1.7,2.13,3,0,0.6492733,0.2077675,0.1429593,2.155587,0.6366452,1,10,1,3,1.518942,-9,0,0,0
"3626","P1",10,"09.02.2020","Yes","Aves","Rio Ave",0,4,7,12,2,6,15,17,5,1,1,0,3.21,3.21,2.24,2.09,1.72,0,3,0.2912874,0.2912874,0.4174252,1.16515,1.543563,-4,-5,-4,-3,-0.3784135,-2,4,1,0
"3627","P1",10,"14.02.2020","Yes","Setubal","Gil Vicente",1,2,7,7,2,3,18,17,1,3,0,0,2.72,2.89,2.83,2.57,1.49,0,3,0.3445535,0.3242856,0.3311609,1.357946,1.317768,-1,0,-1,-3,0.04017761,1,-2,0,0
"3628","P1",10,"15.02.2020","Yes","Portimonense","Moreirense",1,1,12,9,3,2,20,18,1,1,0,0,2.12,3.21,3.53,2.16,1.68,1,1,0.4422816,0.2920988,0.2656196,1.618944,1.088957,0,3,1,0,0.5299862,2,0,0,0
"3629","P1",10,"15.02.2020","Yes","Santa Clara","Tondela",1,0,16,6,3,1,17,14,1,2,0,0,2.13,3.12,3.62,2.38,1.57,3,0,0.4403172,0.3006012,0.2590817,1.621553,1.077846,1,10,2,3,0.5437066,3,-1,0,0
"3630","P1",10,"15.02.2020","Yes","Benfica","Sp Braga",0,1,10,12,3,7,21,16,2,5,0,0,1.6,3.91,5.36,1.66,2.19,0,3,0.5855779,0.2396227,0.1747994,1.996356,0.7640208,-1,-2,-4,-3,1.232336,5,-3,0,0
"3631","P1",10,"15.02.2020","Yes","Rio Ave","Sp Lisbon",1,1,15,7,6,2,16,14,3,3,0,1,2.48,3.25,2.79,1.93,1.85,1,1,0.3770788,0.2877401,0.3351811,1.418976,1.293283,0,8,4,0,0.1256929,2,0,-1,0
"3632","P1",10,"16.02.2020","Yes","Boavista","Belenenses",1,2,19,11,4,4,16,13,1,2,0,1,1.83,3.28,4.66,2.43,1.54,0,3,0.5126547,0.2860238,0.2013215,1.823988,0.8899883,-1,8,0,-3,0.9339997,3,-1,-1,0
"3633","P1",10,"16.02.2020","Yes","Maritimo","Pacos Ferreira",3,0,8,16,5,3,16,17,2,3,0,0,2.29,2.99,3.37,2.55,1.49,3,0,0.4089291,0.3131932,0.2778777,1.539981,1.146826,3,-8,2,3,0.3931544,-1,-1,0,0
"3634","P1",10,"16.02.2020","Yes","Guimaraes","Porto",1,2,13,8,3,1,14,17,0,2,0,0,3.77,3.51,1.93,1.99,1.8,0,3,0.2482966,0.2666889,0.4850145,1.011579,1.721733,-1,5,2,-3,-0.7101539,-3,-2,0,0
"3635","P1",10,"16.02.2020","Yes","Famalicao","Aves",1,1,17,12,7,4,20,10,6,1,1,0,1.55,4.08,5.59,1.76,2.05,1,1,0.6034337,0.2292457,0.1673206,2.039547,0.7312075,0,5,3,0,1.308339,10,5,1,0
"3636","P1",10,"21.02.2020","Yes","Aves","Guimaraes",0,2,8,9,2,4,18,21,2,1,0,0,6.9,4.42,1.44,1.76,2.05,0,3,0.1360035,0.2123131,0.6516834,0.6203236,2.167363,-2,-1,-2,-3,-1.54704,-3,1,0,0
"3637","P1",10,"22.02.2020","Yes","Tondela","Rio Ave",1,2,7,9,4,3,9,14,0,0,0,0,3.9,3.34,1.95,2.15,1.68,0,3,0.2399425,0.2801724,0.4798851,1,1.719828,-1,-2,1,-3,-0.7198276,-5,0,0,0
"3638","P1",10,"22.02.2020","Yes","Belenenses","Maritimo",1,0,9,18,3,1,18,15,4,4,0,0,2.31,3.12,3.18,2.2,1.65,3,0,0.4053835,0.3001397,0.2944767,1.51629,1.18357,1,-9,2,3,0.3327205,3,0,0,0
"3639","P1",10,"23.02.2020","Yes","Moreirense","Santa Clara",2,1,9,11,4,4,18,20,1,3,0,1,2.41,3.12,3,2.24,1.63,3,0,0.3882335,0.2998855,0.3118809,1.464586,1.235528,1,-2,0,3,0.2290578,-2,-2,-1,0
"3640","P1",10,"23.02.2020","Yes","Pacos Ferreira","Famalicao",2,1,9,11,4,5,23,13,5,3,1,1,2.89,3.16,2.45,2.17,1.67,3,0,0.3231907,0.2955763,0.3812331,1.265148,1.439275,1,-2,-1,3,-0.1741272,10,2,0,0
"3641","P1",10,"23.02.2020","Yes","Sp Lisbon","Boavista",2,0,7,9,4,4,10,18,2,2,0,0,1.53,3.9,6.21,1.95,1.83,3,0,0.6102456,0.239404,0.1503504,2.070141,0.6904551,2,-2,0,3,1.379686,-8,0,0,0
"3642","P1",10,"23.02.2020","Yes","Sp Braga","Setubal",3,1,23,6,7,4,15,11,3,4,0,0,1.3,4.95,10.21,1.77,2.03,3,0,0.7194491,0.1889462,0.09160468,2.347293,0.4637603,2,17,3,3,1.883533,4,-1,0,0
"3643","P1",10,"23.02.2020","Yes","Porto","Portimonense",1,0,24,6,4,0,13,18,2,5,0,0,1.17,6.78,14.94,1.5,2.52,3,0,0.7994374,0.137956,0.06260655,2.536268,0.3257757,1,18,4,3,2.210493,-5,-3,0,0
"3644","P1",10,"24.02.2020","Yes","Gil Vicente","Benfica",0,1,16,10,7,4,20,17,1,1,0,0,7,4.01,1.48,1.93,1.85,0,3,0.1337727,0.2335185,0.6327088,0.6348366,2.131645,-1,6,3,-3,-1.496808,3,0,0,0
"3645","P1",10,"28.02.2020","Yes","Portimonense","Setubal",0,0,15,12,5,4,15,11,3,2,0,0,1.79,3.41,4.72,2.3,1.6,1,1,0.5251649,0.275673,0.1991621,1.851168,0.8731593,0,3,1,0,0.9780083,4,1,0,0
"3646","P1",10,"29.02.2020","Yes","Rio Ave","Belenenses",0,0,10,5,2,0,13,19,3,5,0,0,1.44,4.37,6.78,1.78,2.01,1,1,0.6485468,0.2137088,0.1377444,2.159349,0.6269421,0,5,2,0,1.532407,-6,-2,0,0
"3647","P1",10,"29.02.2020","Yes","Boavista","Gil Vicente",0,1,15,9,2,4,19,18,2,2,0,0,2.26,3.01,3.41,2.54,1.5,0,3,0.4143211,0.3110849,0.274594,1.554048,1.134867,-1,6,-2,-3,0.4191811,1,0,0,0
"3648","P1",10,"01.03.2020","Yes","Aves","Pacos Ferreira",1,3,10,10,3,4,11,23,2,1,0,0,2.59,3.11,2.77,2.28,1.61,0,3,0.3612958,0.3008862,0.3378181,1.384773,1.31434,-2,0,-1,-3,0.07043311,-12,1,0,0
"3649","P1",10,"01.03.2020","Yes","Maritimo","Sp Braga",1,2,12,18,3,6,14,17,4,3,0,0,4.83,3.84,1.67,1.88,1.9,0,3,0.1941737,0.2442341,0.5615922,0.8267552,1.929011,-1,-6,-3,-3,-1.102255,-3,1,0,0
"3650","P1",10,"01.03.2020","Yes","Guimaraes","Tondela",2,0,12,9,5,2,19,16,1,2,0,0,1.31,5.06,9.42,1.73,2.07,3,0,0.7153285,0.1851937,0.09947774,2.331179,0.483627,2,3,3,3,1.847552,3,-1,0,0
"3651","P1",10,"02.03.2020","Yes","Santa Clara","Porto",0,2,11,7,1,2,17,15,2,3,0,0,6.55,4.17,1.48,1.77,2.02,0,3,0.1429303,0.2245068,0.632563,0.6532975,2.122196,-2,4,-1,-3,-1.468898,2,-1,0,0
"3652","P1",10,"02.03.2020","Yes","Benfica","Moreirense",1,1,26,7,9,1,13,15,1,3,0,0,1.17,6.95,14.07,1.46,2.62,1,1,0.7990405,0.1345147,0.06644473,2.531636,0.3338489,0,19,8,0,2.197787,-2,-2,0,0
"3653","P1",10,"03.03.2020","Yes","Famalicao","Sp Lisbon",3,1,13,13,3,3,18,18,3,3,0,0,2.96,3.47,2.29,1.76,2.04,3,0,0.3179041,0.2711805,0.4109154,1.224893,1.503927,2,0,0,3,-0.2790338,0,0,0,0
"3654","P1",10,"06.03.2020","Yes","Sp Braga","Portimonense",3,1,19,13,9,5,17,20,0,3,0,0,1.35,4.9,8.35,1.64,2.25,3,0,0.6958037,0.191701,0.1124952,2.279112,0.5291867,2,6,4,3,1.749926,-3,-3,0,0
"3655","P1",10,"07.03.2020","Yes","Tondela","Boavista",1,1,11,10,4,6,11,25,0,2,0,0,2.53,2.99,2.95,2.52,1.5,1,1,0.3698524,0.3129521,0.3171955,1.422509,1.264539,0,1,-2,0,0.1579709,-14,-2,0,0
"3656","P1",10,"07.03.2020","Yes","Setubal","Benfica",1,1,3,15,2,6,13,12,4,3,0,0,8.74,4.57,1.36,1.86,1.92,1,1,0.1070785,0.2047847,0.6881368,0.5260202,2.269195,0,-12,-4,0,-1.743175,1,1,0,0
"3657","P1",10,"07.03.2020","Yes","Porto","Rio Ave",1,1,23,6,5,3,11,9,1,4,0,0,1.33,4.84,8.94,1.78,2.02,1,1,0.7024628,0.1930321,0.1045051,2.30042,0.5065474,0,17,2,0,1.793873,2,-3,0,0
"3658","P1",10,"08.03.2020","Yes","Belenenses","Famalicao",0,0,11,18,2,3,12,11,1,3,0,0,2.72,3.45,2.43,1.81,1.98,1,1,0.3439088,0.2711397,0.3849515,1.302866,1.425994,0,-7,-1,0,-0.1231279,1,-2,0,0
"3659","P1",10,"08.03.2020","Yes","Moreirense","Maritimo",2,0,15,13,4,3,12,16,0,4,0,0,2.16,3.19,3.43,2.31,1.59,3,0,0.4334909,0.2935236,0.2729855,1.593996,1.11248,2,2,1,3,0.4815161,-4,-4,0,0
"3660","P1",10,"08.03.2020","Yes","Gil Vicente","Santa Clara",1,1,9,4,3,2,21,15,1,0,0,0,2.04,3.18,3.82,2.4,1.55,1,1,0.4596558,0.2948735,0.2454706,1.673841,1.031285,0,5,1,0,0.6425555,6,1,0,0
"3661","P1",10,"08.03.2020","Yes","Sp Lisbon","Aves",2,0,22,3,5,3,16,7,1,2,0,2,1.26,5.6,10.71,1.59,2.3,3,0,0.7447974,0.1675794,0.08762322,2.401972,0.4304491,2,19,2,3,1.971522,9,-1,-2,0
"3662","P1",10,"08.03.2020","Yes","Pacos Ferreira","Guimaraes",1,2,12,13,5,4,15,13,2,2,0,0,5.15,3.68,1.66,1.97,1.81,0,3,0.1817565,0.2543603,0.5638832,0.7996299,1.94601,-1,-1,1,-3,-1.14638,2,0,0,0
"3663","P1",10,"03.06.2020","No","Portimonense","Gil Vicente",1,0,6,6,2,2,20,15,0,2,0,0,2.5,3.04,2.94,2.36,1.58,3,0,0.3741523,0.307691,0.3181567,1.430148,1.262161,1,0,0,3,0.1679867,5,-2,0,0
"3664","P1",10,"03.06.2020","No","Famalicao","Porto",2,1,7,16,2,6,20,15,4,1,0,0,6.95,4.54,1.42,1.7,2.13,3,0,0.1346764,0.2061677,0.6591559,0.610197,2.183635,1,-9,-4,3,-1.573438,5,3,0,0
"3665","P1",10,"04.06.2020","No","Maritimo","Setubal",1,1,20,12,4,3,22,22,3,1,0,0,2.22,3.09,3.4,2.41,1.55,1,1,0.421694,0.3029646,0.2753414,1.568047,1.128989,0,8,1,0,0.4390579,0,2,0,0
"3666","P1",10,"04.06.2020","No","Benfica","Tondela",0,0,26,4,5,0,11,12,1,0,0,0,1.16,6.99,16.45,1.58,2.33,1,1,0.8087552,0.134214,0.05703076,2.56048,0.3053063,0,22,5,0,2.255173,-1,1,0,0
"3667","P1",10,"04.06.2020","No","Guimaraes","Sp Lisbon",2,2,13,17,3,5,23,21,4,2,1,0,2.42,3.28,2.86,1.99,1.81,1,1,0.3870031,0.2855328,0.3274641,1.446542,1.267925,0,-4,-2,0,0.1786168,2,2,1,0
"3668","P1",10,"05.06.2020","No","Santa Clara","Sp Braga",3,2,15,11,7,2,16,17,5,2,0,1,5.68,4.02,1.55,1.81,1.98,3,0,0.1645427,0.2324881,0.6029692,0.7261161,2.041396,1,4,5,3,-1.31528,-1,3,-1,0
"3669","P1",10,"05.06.2020","No","Aves","Belenenses",0,2,10,11,2,4,17,15,5,2,0,0,2.86,3.18,2.47,2.21,1.65,0,3,0.3270896,0.294175,0.3787354,1.275444,1.430381,-2,-1,-2,-3,-0.1549372,2,3,0,0
"3670","P1",10,"06.06.2020","No","Boavista","Moreirense",0,1,26,5,9,3,21,24,4,6,1,0,2.45,3.01,3.02,2.47,1.52,0,3,0.3809217,0.3100525,0.3090258,1.452817,1.23713,-1,21,6,-3,0.2156874,-3,-2,1,0
"3671","P1",10,"07.06.2020","No","Rio Ave","Pacos Ferreira",2,3,23,9,8,6,13,20,4,5,1,1,1.63,3.68,5.37,2.1,1.71,0,3,0.5725826,0.2536167,0.1738007,1.971364,0.7750188,-1,14,2,-3,1.196346,-7,-1,0,0
"3672","P1",10,"09.06.2020","No","Gil Vicente","Famalicao",1,3,6,7,2,3,18,19,2,3,0,0,2.81,3.18,2.55,2.04,1.77,0,3,0.3349401,0.2959691,0.3690908,1.300789,1.403242,-2,-1,-1,-3,-0.1024523,-1,-1,0,0
"3673","P1",10,"10.06.2020","No","Setubal","Santa Clara",2,2,6,8,4,3,21,14,6,1,0,0,2.89,3.03,2.55,2.32,1.6,1,1,0.3239256,0.3089587,0.3671157,1.280736,1.410306,0,-2,1,0,-0.1295702,7,5,0,0
"3674","P1",10,"10.06.2020","No","Portimonense","Benfica",2,2,10,11,4,4,18,17,5,3,0,0,7.77,4.4,1.41,1.69,2.15,1,1,0.1208233,0.213363,0.6658137,0.575833,2.210804,0,-1,0,0,-1.634971,1,2,0,0
"3675","P1",10,"10.06.2020","No","Porto","Maritimo",1,0,15,10,8,1,15,13,4,3,0,0,1.16,7,15.8,1.55,2.42,3,0,0.8070165,0.1337342,0.05924931,2.554784,0.3114821,1,5,7,3,2.243302,2,1,0,0
"3676","P1",10,"11.06.2020","No","Belenenses","Guimaraes",1,1,7,17,2,6,16,14,2,1,0,0,4.67,3.6,1.74,1.9,1.88,1,1,0.2007576,0.2604273,0.5388151,0.8627002,1.876872,0,-10,-4,0,-1.014172,2,1,0,0
"3677","P1",10,"11.06.2020","No","Tondela","Aves",2,0,6,12,4,1,21,17,3,2,0,1,1.82,3.44,4.37,2.25,1.63,3,0,0.5139946,0.271939,0.2140664,1.813923,0.9141382,2,-6,3,3,0.8997846,4,1,-1,0
"3678","P1",10,"12.06.2020","No","Moreirense","Rio Ave",0,1,7,14,1,2,14,17,0,0,0,0,2.96,3.33,2.32,1.94,1.84,0,3,0.3159806,0.2808717,0.4031477,1.228814,1.490315,-1,-7,-1,-3,-0.2615012,-3,0,0,0
"3679","P1",10,"12.06.2020","No","Sp Lisbon","Pacos Ferreira",1,0,6,11,2,5,24,18,2,2,0,0,1.34,4.82,8.52,1.74,2.06,3,0,0.6967256,0.1936955,0.1095789,2.283872,0.5224322,1,-5,-3,3,1.76144,6,0,0,0
"3680","P1",10,"13.06.2020","No","Sp Braga","Boavista",0,1,9,7,3,3,22,16,2,3,0,0,1.4,4.42,7.87,1.91,1.87,0,3,0.6690607,0.2119197,0.1190197,2.219102,0.5689787,-1,2,0,-3,1.650123,6,-1,0,0
"3681","P1",10,"15.06.2020","No","Maritimo","Gil Vicente",2,1,15,6,9,2,17,13,2,0,0,0,2.46,2.95,3.14,2.37,1.58,3,0,0.3820676,0.3186055,0.2993269,1.464808,1.216586,1,9,7,3,0.2482223,4,2,0,0
"3682","P1",10,"16.06.2020","No","Santa Clara","Portimonense",1,1,9,8,5,2,17,14,2,4,1,0,2.39,3.14,3.02,2.21,1.65,1,1,0.3917671,0.2981921,0.3100408,1.473493,1.228315,0,1,3,0,0.2451787,3,-2,1,0
"3683","P1",10,"16.06.2020","No","Aves","Porto",0,0,5,24,0,8,21,20,6,3,0,0,14.62,6.69,1.18,1.46,2.66,1,1,0.06420471,0.1403098,0.7954855,0.332924,2.526766,0,-19,-8,0,-2.193842,1,3,0,0
"3684","P1",10,"17.06.2020","No","Pacos Ferreira","Belenenses",2,1,16,4,3,1,24,15,5,3,0,0,2.24,3.12,3.33,2.33,1.59,3,0,0.4183013,0.3003189,0.2813798,1.555223,1.144458,1,12,2,3,0.4107643,9,2,0,0
"3685","P1",10,"17.06.2020","No","Rio Ave","Benfica",1,2,5,16,1,4,16,21,3,2,3,0,5.39,3.76,1.62,1.83,1.96,0,3,0.1735909,0.2488444,0.5775647,0.769617,1.981539,-1,-11,-3,-3,-1.211922,-5,1,3,0
"3686","P1",10,"18.06.2020","No","Boavista","Setubal",3,1,9,15,6,6,17,18,4,2,0,0,2.06,3.05,3.92,2.55,1.49,3,0,0.4543554,0.3068761,0.2387684,1.669942,1.023181,2,-6,0,3,0.6467611,-1,2,0,0
"3687","P1",10,"18.06.2020","No","Sp Lisbon","Tondela",2,0,8,7,2,3,16,20,0,3,0,0,1.41,4.37,7.62,1.87,1.92,3,0,0.6632646,0.2140053,0.1227301,2.203799,0.5821955,2,1,-1,3,1.621604,-4,-3,0,0
"3688","P1",10,"19.06.2020","No","Guimaraes","Moreirense",1,1,13,11,4,4,15,11,3,0,1,0,1.52,4.04,6.06,1.85,1.94,1,1,0.6146045,0.2312373,0.1541582,2.075051,0.693712,0,2,0,0,1.381339,4,3,1,0
"3689","P1",10,"19.06.2020","No","Famalicao","Sp Braga",0,0,7,14,2,0,19,12,3,1,1,0,3.48,3.52,2.01,1.82,1.96,1,1,0.2688187,0.2657639,0.4654174,1.07222,1.662016,0,-7,2,0,-0.5897962,7,2,1,0
"3690","P1",10,"21.06.2020","No","Gil Vicente","Aves",3,0,17,10,9,1,23,18,1,3,0,0,1.57,3.78,5.93,2.13,1.7,3,0,0.5952029,0.2472139,0.1575832,2.032823,0.7199636,3,7,8,3,1.312859,5,-2,0,0
"3691","P1",10,"22.06.2020","No","Portimonense","Maritimo",3,2,11,11,5,5,25,13,5,1,0,0,2.13,3.18,3.5,2.31,1.59,3,0,0.4389078,0.2939854,0.2671068,1.610709,1.095306,1,0,0,3,0.5154032,12,4,0,0
"3692","P1",10,"23.06.2020","No","Setubal","Rio Ave",1,2,8,17,3,7,14,10,2,0,1,0,4.17,3.24,1.94,2.3,1.61,0,3,0.2254018,0.2901005,0.4844977,0.9663059,1.743594,-1,-9,-4,-3,-0.7772877,4,2,1,0
"3693","P1",10,"23.06.2020","No","Benfica","Santa Clara",3,4,15,8,8,6,15,13,2,1,0,0,1.27,5.63,10.56,1.67,2.2,0,3,0.743029,0.1676105,0.0893605,2.396698,0.435692,-1,7,2,-3,1.961006,2,1,0,0
"3694","P1",10,"23.06.2020","No","Porto","Boavista",4,0,12,6,7,2,17,19,2,3,0,0,1.27,5.35,11.13,1.84,1.96,3,0,0.7399245,0.1756456,0.08442984,2.395419,0.4289352,4,6,5,3,1.966484,-2,-1,0,0
"3695","P1",10,"24.06.2020","No","Tondela","Pacos Ferreira",1,3,12,14,4,5,20,22,3,4,0,0,2.67,2.94,2.83,2.5,1.51,0,3,0.3506771,0.3184721,0.3308508,1.370503,1.311025,-2,-2,-1,-3,0.0594788,-2,-1,0,0
"3696","P1",10,"24.06.2020","No","Moreirense","Famalicao",1,1,11,16,4,6,17,21,3,3,0,0,2.84,3.31,2.42,1.86,1.92,1,1,0.3298632,0.2830246,0.3871122,1.272614,1.444361,0,-5,-2,0,-0.171747,-4,0,0,0
"3697","P1",10,"25.06.2020","No","Sp Braga","Guimaraes",3,2,14,15,3,4,11,12,2,2,0,0,2.06,3.45,3.43,1.87,1.91,3,0,0.4550244,0.2716957,0.2732799,1.636769,1.091536,1,-1,-1,3,0.5452333,-1,0,0,0
"3698","P1",10,"26.06.2020","No","Belenenses","Sp Lisbon",1,3,11,10,3,7,25,10,4,1,0,0,5.44,3.69,1.65,2.16,1.69,0,3,0.1732735,0.2554492,0.5712773,0.7752696,1.969281,-2,1,-4,-3,-1.194012,15,3,0,0
"3699","P1",10,"28.06.2020","No","Boavista","Santa Clara",1,0,12,10,2,4,17,25,3,2,0,0,2.57,2.9,2.97,2.71,1.45,3,0,0.3634346,0.3220782,0.3144872,1.412382,1.26554,1,2,-2,3,0.1468423,-8,1,0,0
"3700","P1",10,"29.06.2020","No","Aves","Moreirense",0,1,14,7,3,2,20,26,2,1,0,0,4.46,3.29,1.85,2.29,1.6,0,3,0.2098005,0.2844103,0.5057892,0.9138117,1.801778,-1,7,1,-3,-0.8879662,-6,1,0,0
"3701","P1",10,"29.06.2020","No","Maritimo","Benfica",2,0,6,20,2,7,18,19,3,1,0,0,6.95,4.19,1.46,1.8,1.99,3,0,0.1347893,0.2235766,0.6416341,0.6279445,2.148479,2,-14,-5,3,-1.520534,-1,2,0,0
"3702","P1",10,"29.06.2020","No","Pacos Ferreira","Porto",0,1,11,5,3,3,19,18,3,3,0,0,8.28,4.23,1.4,1.96,1.83,0,3,0.1127176,0.2206386,0.6666438,0.5587913,2.22057,-1,6,0,-3,-1.661779,1,0,0,0
"3703","P1",10,"30.06.2020","No","Famalicao","Portimonense",0,1,13,12,5,4,12,25,4,2,0,0,2.11,3.42,3.38,1.93,1.87,0,3,0.4461857,0.2752783,0.278536,1.613835,1.110886,-1,1,1,-3,0.5029489,-13,2,0,0
"3704","P1",10,"30.06.2020","No","Guimaraes","Setubal",2,0,18,5,5,1,10,9,0,1,0,3,1.41,4.42,8.01,1.91,1.88,3,0,0.6688809,0.213376,0.1177431,2.220019,0.5666053,2,13,4,3,1.653413,1,-1,-3,0
"3705","P1",10,"30.06.2020","No","Rio Ave","Sp Braga",4,3,13,11,8,6,16,23,2,2,0,1,3.14,3.28,2.28,1.99,1.82,3,0,0.2998941,0.2870938,0.4130121,1.186776,1.52613,1,2,2,3,-0.3393539,-7,0,-1,0
"3706","P1",10,"01.07.2020","No","Belenenses","Tondela",1,1,11,11,3,4,19,15,3,5,0,1,2.62,3,2.84,2.41,1.55,1,1,0.3576706,0.3123657,0.3299637,1.385377,1.302257,0,0,-1,0,0.08312063,4,-2,-1,0
"3707","P1",10,"01.07.2020","No","Sp Lisbon","Gil Vicente",2,1,12,8,4,3,23,14,0,2,0,0,1.53,3.94,6.31,2,1.8,3,0,0.6131971,0.2381197,0.1486833,2.077711,0.6841695,1,4,1,3,1.393541,9,-2,0,0
"3708","P1",10,"03.07.2020","No","Santa Clara","Maritimo",0,1,13,13,4,7,17,24,2,2,0,0,2.34,3.03,3.28,2.31,1.61,0,3,0.4023025,0.310689,0.2870085,1.517596,1.171714,-1,0,-3,-3,0.345882,-7,0,0,0
"3709","P1",10,"04.07.2020","No","Setubal","Pacos Ferreira",2,3,7,21,3,8,10,16,1,2,0,0,3.59,3.01,2.19,2.52,1.51,0,3,0.260963,0.3112483,0.4277887,1.094137,1.594614,-1,-14,-5,-3,-0.500477,-6,-1,0,0
"3710","P1",10,"04.07.2020","No","Portimonense","Guimaraes",0,1,13,9,3,3,21,13,1,1,0,0,3.41,3.22,2.15,2.18,1.67,0,3,0.2743445,0.2905325,0.4351231,1.113566,1.595902,-1,4,0,-3,-0.4823358,8,0,0,0
"3711","P1",10,"04.07.2020","No","Benfica","Boavista",3,1,15,6,9,3,13,15,1,2,0,0,1.27,5.34,10.71,1.78,2.02,3,0,0.737241,0.1753364,0.08742261,2.387059,0.4376042,2,9,6,3,1.949455,-2,-1,0,0
"3712","P1",10,"04.07.2020","No","Sp Braga","Aves",4,0,14,6,9,1,13,13,1,1,0,0,1.19,6.82,13.16,1.61,2.29,3,0,0.7905686,0.1379438,0.07148759,2.50965,0.3524066,4,8,8,3,2.157243,0,0,0,0
"3713","P1",10,"05.07.2020","No","Gil Vicente","Rio Ave",1,0,13,5,4,1,0,0,0,0,0,0,3.83,3.25,2.01,2.3,1.6,3,0,0.2448619,0.2885604,0.4665777,1.023146,1.688293,1,8,3,3,-0.6651473,0,0,0,0
"3714","P1",10,"05.07.2020","No","Tondela","Famalicao",0,1,11,10,2,3,6,16,3,5,0,1,3.32,3.23,2.19,2.18,1.67,0,3,0.2821793,0.2900419,0.4277787,1.13658,1.573378,-1,1,-1,-3,-0.4367982,-10,-2,-1,0
"3715","P1",10,"05.07.2020","No","Porto","Belenenses",5,0,17,10,7,1,18,14,2,3,0,0,1.19,6.5,13.6,1.65,2.22,3,0,0.787044,0.1440896,0.06886635,2.505222,0.3506887,5,7,6,3,2.154533,4,-1,0,0
"3716","P1",10,"06.07.2020","No","Moreirense","Sp Lisbon",0,0,9,14,0,2,16,19,3,4,1,0,4.6,3.45,1.79,2.08,1.73,1,1,0.2039499,0.2719332,0.524117,0.8837828,1.844284,0,-5,-2,0,-0.9605013,-3,-1,1,0
"3717","P1",10,"08.07.2020","No","Boavista","Maritimo",0,1,11,11,1,6,22,17,3,1,2,0,2.6,3.05,2.8,2.38,1.56,0,3,0.3595789,0.3065263,0.3338947,1.385263,1.308211,-1,0,-5,-3,0.07705263,5,2,2,0
"3718","P1",10,"08.07.2020","No","Aves","Setubal",1,0,7,14,4,3,20,17,5,4,1,1,4,3.37,1.92,2.14,1.69,3,0,0.2341768,0.2779547,0.4878684,0.9804853,1.74156,1,-7,1,3,-0.7610748,3,1,0,0
"3719","P1",10,"09.07.2020","No","Rio Ave","Portimonense",2,1,7,8,2,2,12,21,1,2,0,0,1.85,3.48,4.15,2.05,1.75,3,0,0.5057165,0.2688436,0.2254399,1.785993,0.9451633,1,-1,0,3,0.8408299,-9,-1,0,0
"3720","P1",10,"09.07.2020","No","Tondela","Porto",1,3,9,13,2,4,15,17,3,4,0,0,9.53,4.8,1.33,1.79,2.02,0,3,0.09851411,0.1955916,0.7058943,0.4911339,2.313275,-2,-4,-2,-3,-1.822141,-2,-1,0,0
"3721","P1",10,"09.07.2020","No","Famalicao","Benfica",1,1,12,20,6,9,12,16,2,3,0,0,5.37,4.02,1.58,1.74,2.06,1,1,0.1743814,0.2329424,0.5926762,0.7560867,2.010971,0,-8,-3,0,-1.254884,-4,-1,0,0
"3722","P1",10,"10.07.2020","No","Guimaraes","Gil Vicente",1,2,12,10,1,4,16,13,2,0,0,0,1.61,3.81,5.44,1.99,1.79,0,3,0.5818933,0.2458919,0.1722148,1.991572,0.7625362,-1,2,-3,-3,1.229036,3,2,0,0
"3723","P1",10,"10.07.2020","No","Sp Lisbon","Santa Clara",1,0,12,4,1,0,12,15,4,2,0,0,1.63,3.65,5.51,2.15,1.68,3,0,0.5739207,0.2562988,0.1697805,1.978061,0.7656404,1,8,1,3,1.21242,-3,2,0,0
"3724","P1",10,"10.07.2020","No","Pacos Ferreira","Sp Braga",1,5,7,8,3,8,16,12,5,3,0,0,3.99,3.5,1.88,1.92,1.86,0,3,0.2346129,0.2674587,0.4979284,0.9712974,1.761244,-4,-1,-5,-3,-0.7899466,4,2,0,0
"3725","P1",10,"11.07.2020","No","Belenenses","Moreirense",0,1,10,16,0,7,20,21,4,2,0,0,2.44,3.17,2.91,2.15,1.69,0,3,0.3834056,0.2951134,0.321481,1.44533,1.259556,-1,-6,-7,-3,0.1857738,-1,2,0,0
"3726","P1",10,"13.07.2020","No","Maritimo","Rio Ave",0,0,16,9,3,2,19,20,0,2,0,0,3.8,3.29,2.01,2.11,1.72,1,1,0.2471844,0.2855018,0.4673138,1.027055,1.687443,0,7,1,0,-0.6603882,-1,-2,0,0
"3727","P1",10,"13.07.2020","No","Setubal","Famalicao",1,2,8,11,1,3,15,14,4,4,0,0,3.25,3.31,2.19,1.98,1.82,0,3,0.2885261,0.283296,0.428178,1.148874,1.56783,-1,-3,-2,-3,-0.4189557,1,0,0,0
"3728","P1",10,"14.07.2020","No","Santa Clara","Aves",3,0,12,9,4,3,13,19,0,1,0,0,1.64,3.84,5.12,1.98,1.84,3,0,0.5722802,0.2444113,0.1833085,1.961252,0.7943368,3,3,1,3,1.166915,-6,-1,0,0
"3729","P1",10,"14.07.2020","No","Portimonense","Boavista",2,1,15,16,6,5,18,22,1,5,0,1,1.64,3.71,5.32,2.27,1.62,3,0,0.5713244,0.2525531,0.1761225,1.966526,0.7809207,1,-1,1,3,1.185605,-4,-4,-1,0
"3730","P1",10,"14.07.2020","No","Benfica","Guimaraes",2,0,12,12,5,3,23,12,2,0,0,0,1.6,3.96,5.26,1.83,1.96,3,0,0.5854037,0.2365267,0.1780696,1.992738,0.7707354,2,0,2,3,1.222002,11,2,0,0
"3731","P1",10,"14.07.2020","No","Gil Vicente","Tondela",3,2,11,15,6,7,13,19,2,4,0,0,2.4,3.1,3.01,2.33,1.59,3,0,0.3888727,0.3010627,0.3100646,1.467681,1.231257,1,-4,-1,3,0.2364243,-6,-2,0,0
"3732","P1",10,"15.07.2020","No","Moreirense","Pacos Ferreira",1,1,12,6,3,2,16,13,2,5,0,0,2.6,3.07,2.78,2.27,1.62,1,1,0.3594333,0.3044061,0.3361606,1.382706,1.312888,0,6,1,0,0.06981798,3,-3,0,0
"3733","P1",10,"15.07.2020","No","Sp Braga","Belenenses",1,1,32,7,7,1,17,17,2,2,0,0,1.26,5.6,10.23,1.58,2.33,1,1,0.7417478,0.1668933,0.09135896,2.392137,0.4409701,0,25,6,0,1.951166,0,0,0,0
"3734","P1",10,"15.07.2020","No","Porto","Sp Lisbon",2,0,8,8,4,2,16,20,4,2,0,0,1.75,3.68,4.49,1.78,2.02,3,0,0.5361072,0.2549423,0.2089505,1.863264,0.8817937,2,0,2,3,0.9814702,-4,2,0,0
"3735","P1",10,"18.07.2020","No","Rio Ave","Santa Clara",2,2,18,11,6,7,23,15,3,2,0,0,1.51,4.01,6.31,1.93,1.85,1,1,0.618865,0.2330389,0.1480961,2.089634,0.6773271,0,7,-1,0,1.412307,8,1,0,0
"3736","P1",10,"18.07.2020","No","Famalicao","Boavista",2,2,13,13,6,5,13,20,2,3,0,0,1.54,3.91,6.15,2.08,1.74,1,1,0.6081732,0.2395363,0.1522905,2.064056,0.6964078,0,0,1,0,1.367648,-7,-1,0,0
"3737","P1",10,"19.07.2020","No","Belenenses","Gil Vicente",1,0,7,8,2,3,18,23,4,4,0,0,2.33,3.17,3.1,2.31,1.59,3,0,0.4021509,0.2955873,0.3022618,1.50204,1.202373,1,-1,-1,3,0.2996673,-5,0,0,0
"3738","P1",10,"19.07.2020","No","Guimaraes","Maritimo",1,0,10,7,4,2,24,14,2,4,0,0,1.65,3.84,4.98,1.8,1.99,3,0,0.567855,0.2440002,0.1881447,1.947565,0.8084344,1,3,2,3,1.139131,10,-2,0,0
"3739","P1",10,"20.07.2020","No","Pacos Ferreira","Portimonense",2,1,10,9,2,3,14,22,2,3,0,0,2.86,3.01,2.6,2.1,1.72,3,0,0.327851,0.3115129,0.3606361,1.295066,1.393421,1,1,-1,3,-0.0983553,-8,-1,0,0
"3740","P1",10,"20.07.2020","No","Tondela","Sp Braga",1,0,8,7,2,1,22,18,5,0,1,0,5.18,4.07,1.6,1.67,2.19,3,0,0.1814807,0.2309755,0.5875438,0.7754176,1.993607,1,1,1,3,-1.218189,4,5,1,0
"3741","P1",10,"20.07.2020","No","Porto","Moreirense",6,1,14,8,9,4,13,10,1,1,0,0,1.35,4.96,8.3,1.63,2.25,3,0,0.6969476,0.1896934,0.113359,2.280536,0.5297703,5,6,5,3,1.750766,3,0,0,0
"3742","P1",10,"21.07.2020","No","Sp Lisbon","Setubal",0,0,13,3,3,1,15,18,1,3,0,0,1.39,4.53,7.88,1.96,1.83,1,1,0.6742001,0.2068738,0.1189262,2.229474,0.5636522,0,10,2,0,1.665822,-3,-2,0,0
"3743","P1",10,"21.07.2020","No","Aves","Benfica",0,4,8,21,2,11,12,22,1,0,0,0,12.4,6.18,1.22,1.49,2.57,0,3,0.0759278,0.152347,0.7717252,0.3801304,2.467523,-4,-13,-9,-3,-2.087392,-10,1,0,0
"3744","P1",10,"24.07.2020","No","Santa Clara","Guimaraes",2,2,7,10,3,4,21,12,4,3,1,0,3.11,3.38,2.22,1.71,2.12,1,1,0.3011124,0.277059,0.4218286,1.180396,1.542545,0,-3,-1,0,-0.3621487,9,1,1,0
"3745","P1",10,"24.07.2020","No","Gil Vicente","Pacos Ferreira",3,3,13,13,5,7,22,20,3,2,0,0,2.46,3.19,2.86,2.05,1.76,1,1,0.3800403,0.2930718,0.3268878,1.433193,1.273735,0,0,-2,0,0.1594575,2,1,0,0
"3746","P1",10,"25.07.2020","No","Boavista","Rio Ave",0,2,10,7,2,4,18,18,3,2,0,0,4.52,3.83,1.7,1.82,1.97,0,3,0.2066551,0.2438854,0.5494595,0.8638507,1.892264,-2,3,-2,-3,-1.028413,0,1,0,0
"3747","P1",10,"25.07.2020","No","Maritimo","Famalicao",3,3,8,17,5,5,19,17,5,3,2,2,3.74,3.51,1.93,1.93,1.85,1,1,0.2497907,0.2661588,0.4840505,1.015531,1.71831,0,-9,0,0,-0.7027791,2,2,0,0
"3748","P1",10,"25.07.2020","No","Benfica","Sp Lisbon",2,1,17,12,4,5,21,14,4,3,0,0,1.92,3.5,3.8,1.83,1.96,3,0,0.4868941,0.2670962,0.2460097,1.727779,1.005125,1,5,-1,3,0.7226534,7,1,0,0
"3749","P1",10,"25.07.2020","No","Sp Braga","Porto",2,1,11,10,5,5,16,13,6,3,0,0,2.72,3.57,2.36,1.63,2.21,3,0,0.3431182,0.2614234,0.3954583,1.290778,1.447798,1,1,0,3,-0.1570202,3,3,0,0
"3750","P1",10,"26.07.2020","No","Moreirense","Tondela",1,2,10,14,5,6,19,18,3,2,0,0,3.16,2.65,2.64,2.45,1.52,0,3,0.2950355,0.3518159,0.3531486,1.236922,1.411262,-1,-4,-1,-3,-0.1743392,1,1,0,0
"3751","P1",10,"26.07.2020","No","Portimonense","Aves",2,0,13,10,5,3,19,20,2,3,0,0,1.15,6.78,18.55,1.69,2.13,3,0,0.8119446,0.1377192,0.05033619,2.573553,0.2887278,2,3,2,3,2.284825,-1,-1,0,0
"3752","P1",10,"26.07.2020","No","Setubal","Belenenses",2,0,11,8,4,2,15,9,3,1,0,0,1.63,3.76,5.27,1.89,1.89,3,0,0.5737865,0.2487425,0.177471,1.970102,0.7811554,2,3,2,3,1.188947,6,2,0,0
